LSOA11CD,Parameter,Unit,2021,2022,2023,2024,2025,2026,2027,2028,2029,2030,2031,2032,2033,2034,2035,2036,2037,2038,2039,2040,2041,2042,2043,2044,2045,2046,2047,2048,2049,2050
E01000001,EV motorcycles,Number,0,1,1,2,3,4,5,6,8,9,10,11,12,13,14,15,16,16,17,17,17,17,18,18,18,18,18,18,18,18
E01000002,EV motorcycles,Number,0,1,1,2,3,4,5,6,7,8,9,10,11,12,13,13,14,14,15,15,15,16,16,16,16,16,16,16,16,16
E01000003,EV motorcycles,Number,0,1,1,2,3,4,6,7,8,10,11,12,14,15,16,17,17,18,18,19,19,19,20,20,20,20,20,20,20,20
E01000005,EV motorcycles,Number,0,0,1,1,2,3,3,4,5,6,7,7,8,9,9,10,10,11,11,11,12,12,12,12,12,12,12,12,12,12
E01000006,EV motorcycles,Number,0,1,1,2,3,4,5,6,8,9,10,11,12,13,14,15,16,16,17,17,17,17,18,18,18,18,18,18,18,18
E01000007,EV motorcycles,Number,0,0,1,1,1,2,2,3,3,4,4,5,5,6,6,7,7,7,7,8,8,8,8,8,8,8,8,8,8,8
E01000008,EV motorcycles,Number,0,0,1,1,2,2,3,4,4,5,6,6,7,7,8,8,9,9,9,9,10,10,10,10,10,10,10,10,10,10
E01000009,EV motorcycles,Number,0,1,1,2,4,5,6,8,9,11,12,14,15,16,17,18,19,20,20,21,21,21,22,22,22,22,22,22,22,22
E01000010,EV motorcycles,Number,0,0,1,1,2,2,3,4,5,5,6,7,8,8,9,9,10,10,10,10,11,11,11,11,11,11,11,11,11,11
E01000011,EV motorcycles,Number,0,0,0,1,1,2,2,2,3,3,4,4,5,5,6,6,6,6,6,7,7,7,7,7,7,7,7,7,7,7
E01000012,EV motorcycles,Number,0,1,1,2,3,4,5,6,8,9,10,11,12,13,14,15,16,16,17,17,17,17,18,18,18,18,18,18,18,18
E01000013,EV motorcycles,Number,0,1,1,2,3,4,5,6,7,8,10,11,12,13,13,14,15,15,16,16,16,16,17,17,17,17,17,17,17,17
E01000014,EV motorcycles,Number,0,1,2,3,4,6,7,9,11,12,14,16,17,18,20,21,22,22,23,24,24,24,24,25,25,25,25,25,25,25
E01000015,EV motorcycles,Number,0,1,1,2,3,4,5,6,7,8,10,11,12,13,13,14,15,15,16,16,16,16,17,17,17,17,17,17,17,17
E01000016,EV motorcycles,Number,0,1,1,2,3,4,5,7,8,9,11,12,13,14,15,16,17,17,18,18,18,18,19,19,19,19,19,19,19,19
E01000017,EV motorcycles,Number,0,1,1,2,2,3,4,5,6,7,8,9,10,10,11,12,12,13,13,13,13,14,14,14,14,14,14,14,14,14
E01000018,EV motorcycles,Number,0,1,1,2,3,4,5,6,8,9,10,11,12,13,14,15,16,16,17,17,17,17,18,18,18,18,18,18,18,18
E01000019,EV motorcycles,Number,0,1,1,2,2,3,4,5,6,7,8,9,10,10,11,12,12,13,13,13,13,14,14,14,14,14,14,14,14,14
E01000020,EV motorcycles,Number,0,1,1,2,4,5,6,7,9,10,12,13,14,16,17,17,18,19,19,20,20,20,21,21,21,21,21,21,21,21
E01000021,EV motorcycles,Number,0,1,2,3,4,5,7,8,10,11,13,14,16,17,18,19,20,21,21,22,22,22,23,23,23,23,23,23,23,23
E01000022,EV motorcycles,Number,1,1,2,4,6,9,11,13,16,19,21,24,26,28,30,32,33,34,35,36,36,37,37,37,38,38,38,38,38,38
E01000023,EV motorcycles,Number,0,1,1,2,4,5,6,7,9,10,12,13,14,16,17,17,18,19,19,20,20,20,21,21,21,21,21,21,21,21
E01000024,EV motorcycles,Number,0,1,1,2,3,4,5,6,8,9,10,11,12,13,14,15,16,16,17,17,17,17,18,18,18,18,18,18,18,18
E01000025,EV motorcycles,Number,0,1,1,2,3,4,5,6,7,8,9,10,11,12,13,13,14,14,15,15,15,16,16,16,16,16,16,16,16,16
E01000027,EV motorcycles,Number,0,1,1,2,3,4,5,6,7,8,9,10,11,12,13,13,14,14,15,15,15,16,16,16,16,16,16,16,16,16
E01000028,EV motorcycles,Number,0,0,1,1,2,2,3,3,4,4,5,6,6,7,7,7,8,8,8,8,9,9,9,9,9,9,9,9,9,9
E01000029,EV motorcycles,Number,0,0,1,1,2,3,3,4,5,6,7,7,8,9,9,10,10,11,11,11,12,12,12,12,12,12,12,12,12,12
E01000030,EV motorcycles,Number,0,1,2,3,5,6,8,10,12,14,16,17,19,21,22,23,24,25,26,26,27,27,27,28,28,28,28,28,28,28
E01000031,EV motorcycles,Number,0,1,2,3,4,6,7,9,11,12,14,16,17,18,20,21,22,22,23,24,24,24,24,25,25,25,25,25,25,25
E01000032,EV motorcycles,Number,0,1,1,2,4,5,6,8,9,11,12,14,15,16,17,18,19,20,20,21,21,21,22,22,22,22,22,22,22,22
E01000033,EV motorcycles,Number,0,1,1,2,3,4,5,6,8,9,10,11,12,13,14,15,16,16,17,17,17,17,18,18,18,18,18,18,18,18
E01000034,EV motorcycles,Number,0,1,1,2,3,4,5,6,7,8,9,10,11,12,13,13,14,14,15,15,15,16,16,16,16,16,16,16,16,16
E01000035,EV motorcycles,Number,0,0,1,1,2,2,3,3,4,4,5,6,6,7,7,7,8,8,8,8,9,9,9,9,9,9,9,9,9,9
E01000036,EV motorcycles,Number,0,0,1,1,2,2,3,3,4,4,5,6,6,7,7,7,8,8,8,8,9,9,9,9,9,9,9,9,9,9
E01000037,EV motorcycles,Number,0,1,2,3,4,5,7,9,10,12,13,15,16,18,19,20,21,22,22,23,23,23,23,24,24,24,24,24,24,24
E01000038,EV motorcycles,Number,0,1,1,2,4,5,6,8,9,11,12,14,15,16,17,18,19,20,20,21,21,21,22,22,22,22,22,22,22,22
E01000039,EV motorcycles,Number,0,1,2,3,5,6,8,10,11,13,15,17,18,20,21,22,23,24,25,25,26,26,26,27,27,27,27,27,27,27
E01000040,EV motorcycles,Number,0,0,1,1,2,3,4,5,5,6,7,8,9,10,10,11,11,12,12,12,12,13,13,13,13,13,13,13,13,13
E01000041,EV motorcycles,Number,0,1,2,3,4,5,7,8,10,11,13,14,16,17,18,19,20,21,21,22,22,22,23,23,23,23,23,23,23,23
E01000042,EV motorcycles,Number,0,1,1,2,2,3,4,5,6,7,8,9,10,10,11,12,12,13,13,13,13,14,14,14,14,14,14,14,14,14
E01000043,EV motorcycles,Number,0,1,2,3,4,6,8,9,11,13,15,16,18,19,20,22,23,23,24,25,25,25,25,26,26,26,26,26,26,26
E01000044,EV motorcycles,Number,0,0,1,1,2,2,3,3,4,4,5,6,6,7,7,7,8,8,8,8,9,9,9,9,9,9,9,9,9,9
E01000045,EV motorcycles,Number,0,1,2,3,4,6,7,9,11,12,14,16,17,18,20,21,22,22,23,24,24,24,24,25,25,25,25,25,25,25
E01000046,EV motorcycles,Number,0,1,1,2,3,4,5,7,8,9,11,12,13,14,15,16,17,17,18,18,18,18,19,19,19,19,19,19,19,19
E01000048,EV motorcycles,Number,0,0,0,0,0,0,0,0,0,0,0,0,0,0,0,0,0,0,0,0,0,0,0,0,0,0,0,0,0,0
E01000049,EV motorcycles,Number,0,0,1,1,2,2,3,4,4,5,6,6,7,7,8,8,9,9,9,9,10,10,10,10,10,10,10,10,10,10
E01000050,EV motorcycles,Number,0,0,1,1,1,2,2,3,3,4,4,5,5,6,6,7,7,7,7,8,8,8,8,8,8,8,8,8,8,8
E01000051,EV motorcycles,Number,0,0,1,1,1,2,2,3,3,4,4,5,5,6,6,7,7,7,7,8,8,8,8,8,8,8,8,8,8,8
E01000052,EV motorcycles,Number,0,1,2,3,4,5,7,9,10,12,13,15,16,18,19,20,21,22,22,23,23,23,23,24,24,24,24,24,24,24
E01000053,EV motorcycles,Number,0,1,1,2,3,4,5,6,7,8,9,10,11,12,13,13,14,14,15,15,15,16,16,16,16,16,16,16,16,16
E01000054,EV motorcycles,Number,0,1,1,2,3,4,5,6,8,9,10,11,12,13,14,15,16,16,17,17,17,17,18,18,18,18,18,18,18,18
E01000055,EV motorcycles,Number,0,1,2,3,5,6,8,10,11,13,15,17,18,20,21,22,23,24,25,25,26,26,26,27,27,27,27,27,27,27
E01000056,EV motorcycles,Number,0,0,1,1,2,2,3,4,4,5,6,6,7,7,8,8,9,9,9,9,10,10,10,10,10,10,10,10,10,10
E01000057,EV motorcycles,Number,0,1,1,2,3,3,4,5,6,7,8,9,10,11,12,12,13,13,14,14,14,15,15,15,15,15,15,15,15,15
E01000058,EV motorcycles,Number,0,1,1,2,3,4,5,6,8,9,10,11,12,13,14,15,16,16,17,17,17,17,18,18,18,18,18,18,18,18
E01000059,EV motorcycles,Number,0,1,1,2,4,5,6,7,9,10,12,13,14,16,17,17,18,19,19,20,20,20,21,21,21,21,21,21,21,21
E01000060,EV motorcycles,Number,1,1,3,4,7,9,11,14,16,19,22,24,27,29,31,32,34,35,36,37,37,38,38,38,39,39,39,39,39,39
E01000061,EV motorcycles,Number,0,0,1,1,2,2,3,4,4,5,6,6,7,7,8,8,9,9,9,9,10,10,10,10,10,10,10,10,10,10
E01000062,EV motorcycles,Number,0,1,2,3,4,6,8,9,11,13,15,16,18,19,20,22,23,23,24,25,25,25,25,26,26,26,26,26,26,26
E01000063,EV motorcycles,Number,0,0,1,1,2,3,4,5,5,6,7,8,9,10,10,11,11,12,12,12,12,13,13,13,13,13,13,13,13,13
E01000064,EV motorcycles,Number,0,1,1,2,3,4,5,6,8,9,10,11,12,13,14,15,16,16,17,17,17,17,18,18,18,18,18,18,18,18
E01000065,EV motorcycles,Number,0,1,1,2,3,4,6,7,8,10,11,12,14,15,16,17,17,18,18,19,19,19,20,20,20,20,20,20,20,20
E01000066,EV motorcycles,Number,0,1,2,3,4,6,7,9,11,12,14,16,17,18,20,21,22,22,23,24,24,24,24,25,25,25,25,25,25,25
E01000067,EV motorcycles,Number,0,0,1,1,2,2,3,3,4,4,5,6,6,7,7,7,8,8,8,8,9,9,9,9,9,9,9,9,9,9
E01000068,EV motorcycles,Number,0,1,1,2,3,4,5,6,7,8,10,11,12,13,13,14,15,15,16,16,16,16,17,17,17,17,17,17,17,17
E01000069,EV motorcycles,Number,0,0,0,1,1,1,2,2,3,3,3,4,4,4,5,5,5,5,6,6,6,6,6,6,6,6,6,6,6,6
E01000070,EV motorcycles,Number,0,0,1,1,2,2,3,4,5,5,6,7,8,8,9,9,10,10,10,10,11,11,11,11,11,11,11,11,11,11
E01000071,EV motorcycles,Number,0,0,1,1,2,3,4,5,5,6,7,8,9,10,10,11,11,12,12,12,12,13,13,13,13,13,13,13,13,13
E01000072,EV motorcycles,Number,0,1,1,2,3,4,5,6,7,8,9,10,11,12,13,13,14,14,15,15,15,16,16,16,16,16,16,16,16,16
E01000073,EV motorcycles,Number,0,1,2,3,4,5,7,9,10,12,13,15,16,18,19,20,21,22,22,23,23,23,23,24,24,24,24,24,24,24
E01000074,EV motorcycles,Number,0,0,1,1,2,2,3,4,5,5,6,7,8,8,9,9,10,10,10,10,11,11,11,11,11,11,11,11,11,11
E01000075,EV motorcycles,Number,0,1,2,3,4,5,7,9,10,12,13,15,16,18,19,20,21,22,22,23,23,23,23,24,24,24,24,24,24,24
E01000076,EV motorcycles,Number,0,1,1,2,3,3,4,5,6,7,8,9,10,11,12,12,13,13,14,14,14,15,15,15,15,15,15,15,15,15
E01000077,EV motorcycles,Number,0,1,2,3,4,5,7,9,10,12,13,15,16,18,19,20,21,22,22,23,23,23,23,24,24,24,24,24,24,24
E01000078,EV motorcycles,Number,0,1,1,2,3,4,5,6,8,9,10,11,12,13,14,15,16,16,17,17,17,17,18,18,18,18,18,18,18,18
E01000079,EV motorcycles,Number,0,0,1,1,2,3,3,4,5,6,7,7,8,9,9,10,10,11,11,11,12,12,12,12,12,12,12,12,12,12
E01000080,EV motorcycles,Number,0,1,1,2,2,3,4,5,6,7,8,9,10,10,11,12,12,13,13,13,13,14,14,14,14,14,14,14,14,14
E01000081,EV motorcycles,Number,0,1,2,3,4,6,8,9,11,13,15,16,18,19,20,22,23,23,24,25,25,25,25,26,26,26,26,26,26,26
E01000082,EV motorcycles,Number,0,0,1,1,2,3,4,5,5,6,7,8,9,10,10,11,11,12,12,12,12,13,13,13,13,13,13,13,13,13
E01000083,EV motorcycles,Number,0,1,1,2,3,4,6,7,8,10,11,12,14,15,16,17,17,18,18,19,19,19,20,20,20,20,20,20,20,20
E01000084,EV motorcycles,Number,0,0,1,1,2,2,3,4,5,5,6,7,8,8,9,9,10,10,10,10,11,11,11,11,11,11,11,11,11,11
E01000085,EV motorcycles,Number,0,0,1,1,2,2,3,4,5,5,6,7,8,8,9,9,10,10,10,10,11,11,11,11,11,11,11,11,11,11
E01000086,EV motorcycles,Number,0,1,1,2,3,3,4,5,6,7,8,9,10,11,12,12,13,13,14,14,14,15,15,15,15,15,15,15,15,15
E01000087,EV motorcycles,Number,0,0,1,1,2,3,3,4,5,6,7,7,8,9,9,10,10,11,11,11,12,12,12,12,12,12,12,12,12,12
E01000088,EV motorcycles,Number,0,0,1,1,2,3,4,5,5,6,7,8,9,10,10,11,11,12,12,12,12,13,13,13,13,13,13,13,13,13
E01000089,EV motorcycles,Number,0,1,1,2,4,5,6,8,9,11,12,14,15,16,17,18,19,20,20,21,21,21,22,22,22,22,22,22,22,22
E01000090,EV motorcycles,Number,0,0,1,1,2,2,3,4,5,5,6,7,8,8,9,9,10,10,10,10,11,11,11,11,11,11,11,11,11,11
E01000091,EV motorcycles,Number,0,0,1,1,2,2,3,4,5,5,6,7,8,8,9,9,10,10,10,10,11,11,11,11,11,11,11,11,11,11
E01000092,EV motorcycles,Number,1,2,3,6,9,12,15,18,22,26,29,32,36,38,41,43,45,47,48,49,50,50,51,51,51,52,52,52,52,52
E01000093,EV motorcycles,Number,0,0,1,1,1,2,2,3,3,4,4,5,5,6,6,7,7,7,7,8,8,8,8,8,8,8,8,8,8,8
E01000094,EV motorcycles,Number,0,1,1,2,3,4,6,7,8,10,11,12,14,15,16,17,17,18,18,19,19,19,20,20,20,20,20,20,20,20
E01000095,EV motorcycles,Number,0,1,2,3,5,6,8,10,12,14,16,17,19,21,22,23,24,25,26,26,27,27,27,28,28,28,28,28,28,28
E01000096,EV motorcycles,Number,0,1,1,2,3,3,4,5,6,7,8,9,10,11,12,12,13,13,14,14,14,15,15,15,15,15,15,15,15,15
E01000097,EV motorcycles,Number,0,1,2,3,5,6,8,10,12,14,16,17,19,21,22,23,24,25,26,26,27,27,27,28,28,28,28,28,28,28
E01000098,EV motorcycles,Number,0,1,1,2,3,3,4,5,6,7,8,9,10,11,12,12,13,13,14,14,14,15,15,15,15,15,15,15,15,15
E01000099,EV motorcycles,Number,1,1,3,4,7,9,11,14,16,19,22,24,27,29,31,32,34,35,36,37,37,38,38,38,39,39,39,39,39,39
E01000100,EV motorcycles,Number,0,1,1,2,3,4,5,7,8,9,11,12,13,14,15,16,17,17,18,18,18,18,19,19,19,19,19,19,19,19
E01000101,EV motorcycles,Number,0,1,1,2,3,4,6,7,8,10,11,12,14,15,16,17,17,18,18,19,19,19,20,20,20,20,20,20,20,20
E01000102,EV motorcycles,Number,0,1,1,2,3,4,5,6,7,8,10,11,12,13,13,14,15,15,16,16,16,16,17,17,17,17,17,17,17,17
E01000103,EV motorcycles,Number,0,1,1,2,3,4,5,6,7,8,10,11,12,13,13,14,15,15,16,16,16,16,17,17,17,17,17,17,17,17
E01000104,EV motorcycles,Number,0,0,1,1,2,3,4,5,5,6,7,8,9,10,10,11,11,12,12,12,12,13,13,13,13,13,13,13,13,13
E01000105,EV motorcycles,Number,0,1,1,2,4,5,6,7,9,10,12,13,14,16,17,17,18,19,19,20,20,20,21,21,21,21,21,21,21,21
E01000106,EV motorcycles,Number,0,1,1,2,3,4,5,6,7,8,10,11,12,13,13,14,15,15,16,16,16,16,17,17,17,17,17,17,17,17
E01000107,EV motorcycles,Number,0,1,2,3,4,5,7,8,10,11,13,14,16,17,18,19,20,21,21,22,22,22,23,23,23,23,23,23,23,23
E01000108,EV motorcycles,Number,0,1,1,2,3,4,5,6,7,8,10,11,12,13,13,14,15,15,16,16,16,16,17,17,17,17,17,17,17,17
E01000109,EV motorcycles,Number,0,1,1,2,2,3,4,5,6,7,8,9,10,10,11,12,12,13,13,13,13,14,14,14,14,14,14,14,14,14
E01000110,EV motorcycles,Number,0,1,1,2,3,4,6,7,8,10,11,12,14,15,16,17,17,18,18,19,19,19,20,20,20,20,20,20,20,20
E01000111,EV motorcycles,Number,0,0,1,1,2,2,3,4,4,5,6,6,7,7,8,8,9,9,9,9,10,10,10,10,10,10,10,10,10,10
E01000112,EV motorcycles,Number,0,1,1,2,3,3,4,5,6,7,8,9,10,11,12,12,13,13,14,14,14,15,15,15,15,15,15,15,15,15
E01000113,EV motorcycles,Number,0,0,1,1,1,2,2,3,3,4,4,5,5,6,6,7,7,7,7,8,8,8,8,8,8,8,8,8,8,8
E01000114,EV motorcycles,Number,0,1,1,2,4,5,6,8,9,11,12,14,15,16,17,18,19,20,20,21,21,21,22,22,22,22,22,22,22,22
E01000115,EV motorcycles,Number,0,0,1,1,1,2,2,3,3,4,4,5,5,6,6,7,7,7,7,8,8,8,8,8,8,8,8,8,8,8
E01000116,EV motorcycles,Number,0,1,1,2,4,5,6,7,9,10,12,13,14,16,17,17,18,19,19,20,20,20,21,21,21,21,21,21,21,21
E01000117,EV motorcycles,Number,0,1,1,2,3,4,5,6,8,9,10,11,12,13,14,15,16,16,17,17,17,17,18,18,18,18,18,18,18,18
E01000118,EV motorcycles,Number,1,1,2,4,6,9,11,13,16,19,21,24,26,28,30,32,33,34,35,36,36,37,37,37,38,38,38,38,38,38
E01000119,EV motorcycles,Number,0,1,1,2,3,4,5,6,7,8,9,10,11,12,13,13,14,14,15,15,15,16,16,16,16,16,16,16,16,16
E01000120,EV motorcycles,Number,0,1,1,2,3,4,5,6,7,8,10,11,12,13,13,14,15,15,16,16,16,16,17,17,17,17,17,17,17,17
E01000121,EV motorcycles,Number,0,1,1,2,3,4,5,6,7,8,9,10,11,12,13,13,14,14,15,15,15,16,16,16,16,16,16,16,16,16
E01000122,EV motorcycles,Number,0,1,2,3,4,6,8,9,11,13,15,16,18,19,20,22,23,23,24,25,25,25,25,26,26,26,26,26,26,26
E01000123,EV motorcycles,Number,0,1,2,3,4,6,8,9,11,13,15,16,18,19,20,22,23,23,24,25,25,25,25,26,26,26,26,26,26,26
E01000124,EV motorcycles,Number,0,1,2,3,5,7,8,10,12,14,16,18,20,21,23,24,25,26,27,27,28,28,28,29,29,29,29,29,29,29
E01000125,EV motorcycles,Number,0,1,1,2,3,4,6,7,8,10,11,12,14,15,16,17,17,18,18,19,19,19,20,20,20,20,20,20,20,20
E01000126,EV motorcycles,Number,0,1,2,3,5,7,9,11,13,15,17,19,21,23,24,26,27,28,29,29,30,30,30,31,31,31,31,31,31,31
E01000127,EV motorcycles,Number,0,1,1,2,3,4,6,7,8,10,11,12,14,15,16,17,17,18,18,19,19,19,20,20,20,20,20,20,20,20
E01000128,EV motorcycles,Number,0,1,2,3,4,5,7,8,10,11,13,14,16,17,18,19,20,21,21,22,22,22,23,23,23,23,23,23,23,23
E01000129,EV motorcycles,Number,0,1,1,2,2,3,4,5,6,7,8,9,10,10,11,12,12,13,13,13,13,14,14,14,14,14,14,14,14,14
E01000130,EV motorcycles,Number,0,1,1,2,3,4,5,7,8,9,11,12,13,14,15,16,17,17,18,18,18,18,19,19,19,19,19,19,19,19
E01000131,EV motorcycles,Number,0,1,2,4,6,8,10,12,14,17,19,21,23,25,27,28,30,31,31,32,33,33,33,33,34,34,34,34,34,34
E01000132,EV motorcycles,Number,0,1,1,2,3,3,4,5,6,7,8,9,10,11,12,12,13,13,14,14,14,15,15,15,15,15,15,15,15,15
E01000133,EV motorcycles,Number,0,1,1,2,3,4,5,7,8,9,11,12,13,14,15,16,17,17,18,18,18,18,19,19,19,19,19,19,19,19
E01000134,EV motorcycles,Number,0,1,1,2,3,4,6,7,8,10,11,12,14,15,16,17,17,18,18,19,19,19,20,20,20,20,20,20,20,20
E01000135,EV motorcycles,Number,0,1,1,2,2,3,4,5,6,7,8,9,10,10,11,12,12,13,13,13,13,14,14,14,14,14,14,14,14,14
E01000136,EV motorcycles,Number,0,1,1,2,3,4,5,7,8,9,11,12,13,14,15,16,17,17,18,18,18,18,19,19,19,19,19,19,19,19
E01000137,EV motorcycles,Number,0,1,2,3,5,7,9,11,13,15,17,19,21,23,24,26,27,28,29,29,30,30,30,31,31,31,31,31,31,31
E01000138,EV motorcycles,Number,1,1,2,4,6,8,10,12,15,17,20,22,24,26,28,29,30,31,32,33,34,34,34,34,35,35,35,35,35,35
E01000139,EV motorcycles,Number,0,1,2,3,4,6,8,9,11,13,15,16,18,19,20,22,23,23,24,25,25,25,25,26,26,26,26,26,26,26
E01000140,EV motorcycles,Number,1,1,2,4,6,8,10,13,15,18,20,22,25,27,28,30,31,32,33,34,35,35,35,35,36,36,36,36,36,36
E01000141,EV motorcycles,Number,1,1,2,4,6,8,10,13,15,18,20,22,25,27,28,30,31,32,33,34,35,35,35,35,36,36,36,36,36,36
E01000142,EV motorcycles,Number,1,2,3,5,7,10,13,16,19,22,25,27,30,33,35,37,38,40,41,42,42,43,43,43,44,44,44,44,44,44
E01000143,EV motorcycles,Number,0,1,1,2,3,4,5,6,8,9,10,11,12,13,14,15,16,16,17,17,17,17,18,18,18,18,18,18,18,18
E01000144,EV motorcycles,Number,0,1,2,4,5,7,9,11,14,16,18,20,22,24,25,27,28,29,30,30,31,31,31,32,32,32,32,32,32,32
E01000145,EV motorcycles,Number,0,1,1,2,3,4,5,6,8,9,10,11,12,13,14,15,16,16,17,17,17,17,18,18,18,18,18,18,18,18
E01000146,EV motorcycles,Number,0,1,1,2,3,4,6,7,8,10,11,12,14,15,16,17,17,18,18,19,19,19,20,20,20,20,20,20,20,20
E01000147,EV motorcycles,Number,0,1,1,2,4,5,6,7,9,10,12,13,14,16,17,17,18,19,19,20,20,20,21,21,21,21,21,21,21,21
E01000148,EV motorcycles,Number,1,2,3,5,8,11,14,17,21,24,27,31,33,36,39,41,43,44,45,46,47,48,48,48,48,49,49,49,49,49
E01000150,EV motorcycles,Number,0,1,2,3,5,7,9,11,13,15,17,19,21,22,24,25,26,27,28,28,29,29,29,30,30,30,30,30,30,30
E01000151,EV motorcycles,Number,0,1,1,2,4,5,6,7,9,10,12,13,14,16,17,17,18,19,19,20,20,20,21,21,21,21,21,21,21,21
E01000152,EV motorcycles,Number,0,1,1,2,4,5,6,8,9,11,12,14,15,16,17,18,19,20,20,21,21,21,22,22,22,22,22,22,22,22
E01000153,EV motorcycles,Number,0,1,1,2,4,5,6,7,9,10,12,13,14,16,17,17,18,19,19,20,20,20,21,21,21,21,21,21,21,21
E01000154,EV motorcycles,Number,0,1,1,2,3,4,5,6,7,8,10,11,12,13,13,14,15,15,16,16,16,16,17,17,17,17,17,17,17,17
E01000155,EV motorcycles,Number,1,2,3,6,9,12,15,18,22,26,29,32,36,38,41,43,45,47,48,49,50,50,51,51,51,52,52,52,52,52
E01000156,EV motorcycles,Number,0,1,2,3,4,6,8,9,11,13,15,16,18,19,20,22,23,23,24,25,25,25,25,26,26,26,26,26,26,26
E01000157,EV motorcycles,Number,0,1,2,3,4,6,7,9,11,12,14,16,17,18,20,21,22,22,23,24,24,24,24,25,25,25,25,25,25,25
E01000158,EV motorcycles,Number,0,0,1,1,2,3,3,4,5,6,7,7,8,9,9,10,10,11,11,11,12,12,12,12,12,12,12,12,12,12
E01000159,EV motorcycles,Number,0,1,1,2,4,5,6,8,9,11,12,14,15,16,17,18,19,20,20,21,21,21,22,22,22,22,22,22,22,22
E01000160,EV motorcycles,Number,1,2,3,6,9,12,15,18,22,26,29,32,36,38,41,43,45,47,48,49,50,50,51,51,51,52,52,52,52,52
E01000161,EV motorcycles,Number,0,1,1,2,4,5,6,8,9,11,12,14,15,16,17,18,19,20,20,21,21,21,22,22,22,22,22,22,22,22
E01000162,EV motorcycles,Number,0,1,1,2,3,3,4,5,6,7,8,9,10,11,12,12,13,13,14,14,14,15,15,15,15,15,15,15,15,15
E01000163,EV motorcycles,Number,0,1,2,3,5,6,8,10,12,14,16,17,19,21,22,23,24,25,26,26,27,27,27,28,28,28,28,28,28,28
E01000164,EV motorcycles,Number,0,1,2,3,5,6,8,10,12,14,16,17,19,21,22,23,24,25,26,26,27,27,27,28,28,28,28,28,28,28
E01000165,EV motorcycles,Number,0,1,1,2,3,3,4,5,6,7,8,9,10,11,12,12,13,13,14,14,14,15,15,15,15,15,15,15,15,15
E01000166,EV motorcycles,Number,0,1,2,3,4,6,7,9,11,12,14,16,17,18,20,21,22,22,23,24,24,24,24,25,25,25,25,25,25,25
E01000167,EV motorcycles,Number,0,1,1,2,4,5,6,8,9,11,12,14,15,16,17,18,19,20,20,21,21,21,22,22,22,22,22,22,22,22
E01000168,EV motorcycles,Number,0,1,1,2,3,4,5,6,8,9,10,11,12,13,14,15,16,16,17,17,17,17,18,18,18,18,18,18,18,18
E01000169,EV motorcycles,Number,0,1,1,2,3,4,5,6,7,8,10,11,12,13,13,14,15,15,16,16,16,16,17,17,17,17,17,17,17,17
E01000170,EV motorcycles,Number,0,1,2,3,5,7,8,10,12,14,16,18,20,21,23,24,25,26,27,27,28,28,28,29,29,29,29,29,29,29
E01000171,EV motorcycles,Number,1,2,4,7,10,13,17,21,25,29,33,37,40,44,47,49,51,53,55,56,57,57,58,58,58,59,59,59,59,59
E01000172,EV motorcycles,Number,0,0,1,1,2,2,3,4,4,5,6,6,7,7,8,8,9,9,9,9,10,10,10,10,10,10,10,10,10,10
E01000173,EV motorcycles,Number,0,1,2,3,5,7,9,11,13,15,17,19,21,22,24,25,26,27,28,28,29,29,29,30,30,30,30,30,30,30
E01000174,EV motorcycles,Number,0,1,1,2,3,4,5,6,8,9,10,11,12,13,14,15,16,16,17,17,17,17,18,18,18,18,18,18,18,18
E01000175,EV motorcycles,Number,0,1,1,2,4,5,6,8,9,11,12,14,15,16,17,18,19,20,20,21,21,21,22,22,22,22,22,22,22,22
E01000176,EV motorcycles,Number,0,1,1,2,4,5,6,7,9,10,12,13,14,16,17,17,18,19,19,20,20,20,21,21,21,21,21,21,21,21
E01000177,EV motorcycles,Number,0,1,2,3,5,7,9,11,13,15,17,19,21,23,24,26,27,28,29,29,30,30,30,31,31,31,31,31,31,31
E01000178,EV motorcycles,Number,0,1,1,2,3,4,5,6,8,9,10,11,12,13,14,15,16,16,17,17,17,17,18,18,18,18,18,18,18,18
E01000179,EV motorcycles,Number,0,1,2,3,4,5,7,8,10,11,13,14,16,17,18,19,20,21,21,22,22,22,23,23,23,23,23,23,23,23
E01000180,EV motorcycles,Number,0,1,2,4,6,8,10,12,14,17,19,21,23,25,27,28,30,31,31,32,33,33,33,33,34,34,34,34,34,34
E01000181,EV motorcycles,Number,0,1,2,4,6,7,10,12,14,16,18,21,23,24,26,27,29,30,31,31,32,32,32,33,33,33,33,33,33,33
E01000182,EV motorcycles,Number,0,1,2,3,5,6,8,10,12,14,16,17,19,21,22,23,24,25,26,26,27,27,27,28,28,28,28,28,28,28
E01000183,EV motorcycles,Number,0,1,1,2,3,4,5,6,7,8,9,10,11,12,13,13,14,14,15,15,15,16,16,16,16,16,16,16,16,16
E01000184,EV motorcycles,Number,0,1,2,3,4,6,8,9,11,13,15,16,18,19,20,22,23,23,24,25,25,25,25,26,26,26,26,26,26,26
E01000185,EV motorcycles,Number,0,1,1,2,3,4,5,6,7,8,9,10,11,12,13,13,14,14,15,15,15,16,16,16,16,16,16,16,16,16
E01000186,EV motorcycles,Number,0,0,1,1,2,2,3,3,4,4,5,6,6,7,7,7,8,8,8,8,9,9,9,9,9,9,9,9,9,9
E01000187,EV motorcycles,Number,0,0,1,1,2,2,3,4,5,5,6,7,8,8,9,9,10,10,10,10,11,11,11,11,11,11,11,11,11,11
E01000188,EV motorcycles,Number,0,0,0,1,1,1,2,2,3,3,3,4,4,4,5,5,5,5,6,6,6,6,6,6,6,6,6,6,6,6
E01000189,EV motorcycles,Number,0,1,1,2,4,5,6,7,9,10,12,13,14,16,17,17,18,19,19,20,20,20,21,21,21,21,21,21,21,21
E01000190,EV motorcycles,Number,0,0,1,1,2,2,3,4,5,5,6,7,8,8,9,9,10,10,10,10,11,11,11,11,11,11,11,11,11,11
E01000191,EV motorcycles,Number,0,0,1,1,2,2,3,4,4,5,6,6,7,7,8,8,9,9,9,9,10,10,10,10,10,10,10,10,10,10
E01000192,EV motorcycles,Number,0,1,1,2,4,5,6,8,9,11,12,14,15,16,17,18,19,20,20,21,21,21,22,22,22,22,22,22,22,22
E01000193,EV motorcycles,Number,0,1,1,2,2,3,4,5,6,7,8,9,10,10,11,12,12,13,13,13,13,14,14,14,14,14,14,14,14,14
E01000194,EV motorcycles,Number,0,1,1,2,3,3,4,5,6,7,8,9,10,11,12,12,13,13,14,14,14,15,15,15,15,15,15,15,15,15
E01000195,EV motorcycles,Number,0,1,1,2,3,4,5,6,8,9,10,11,12,13,14,15,16,16,17,17,17,17,18,18,18,18,18,18,18,18
E01000196,EV motorcycles,Number,0,1,2,3,5,6,8,10,12,14,16,17,19,21,22,23,24,25,26,26,27,27,27,28,28,28,28,28,28,28
E01000197,EV motorcycles,Number,0,1,2,3,5,7,9,11,13,15,17,19,21,23,24,26,27,28,29,29,30,30,30,31,31,31,31,31,31,31
E01000198,EV motorcycles,Number,0,1,2,3,5,7,8,10,12,14,16,18,20,21,23,24,25,26,27,27,28,28,28,29,29,29,29,29,29,29
E01000199,EV motorcycles,Number,0,1,1,2,3,4,5,6,7,8,9,10,11,12,13,13,14,14,15,15,15,16,16,16,16,16,16,16,16,16
E01000200,EV motorcycles,Number,0,0,1,1,2,3,4,5,5,6,7,8,9,10,10,11,11,12,12,12,12,13,13,13,13,13,13,13,13,13
E01000201,EV motorcycles,Number,0,1,1,2,3,3,4,5,6,7,8,9,10,11,12,12,13,13,14,14,14,15,15,15,15,15,15,15,15,15
E01000202,EV motorcycles,Number,0,1,1,2,3,4,5,6,8,9,10,11,12,13,14,15,16,16,17,17,17,17,18,18,18,18,18,18,18,18
E01000203,EV motorcycles,Number,1,2,3,5,8,10,13,16,19,22,25,28,31,33,35,37,39,40,42,42,43,44,44,44,45,45,45,45,45,45
E01000204,EV motorcycles,Number,1,1,2,4,6,8,10,12,15,17,20,22,24,26,28,29,30,31,32,33,34,34,34,34,35,35,35,35,35,35
E01000205,EV motorcycles,Number,0,1,1,2,2,3,4,5,6,7,8,9,10,10,11,12,12,13,13,13,13,14,14,14,14,14,14,14,14,14
E01000206,EV motorcycles,Number,0,0,1,1,2,3,3,4,5,6,7,7,8,9,9,10,10,11,11,11,12,12,12,12,12,12,12,12,12,12
E01000207,EV motorcycles,Number,0,0,1,1,2,2,3,4,4,5,6,6,7,7,8,8,9,9,9,9,10,10,10,10,10,10,10,10,10,10
E01000208,EV motorcycles,Number,0,0,1,1,2,3,3,4,5,6,7,7,8,9,9,10,10,11,11,11,12,12,12,12,12,12,12,12,12,12
E01000209,EV motorcycles,Number,0,0,1,1,2,2,3,4,4,5,6,6,7,7,8,8,9,9,9,9,10,10,10,10,10,10,10,10,10,10
E01000210,EV motorcycles,Number,0,0,1,1,2,2,3,4,5,5,6,7,8,8,9,9,10,10,10,10,11,11,11,11,11,11,11,11,11,11
E01000211,EV motorcycles,Number,0,1,2,3,5,7,9,11,13,15,17,19,21,22,24,25,26,27,28,28,29,29,29,30,30,30,30,30,30,30
E01000212,EV motorcycles,Number,0,1,1,2,4,5,6,7,9,10,12,13,14,16,17,17,18,19,19,20,20,20,21,21,21,21,21,21,21,21
E01000213,EV motorcycles,Number,0,1,1,2,3,4,5,6,7,8,9,10,11,12,13,13,14,14,15,15,15,16,16,16,16,16,16,16,16,16
E01000214,EV motorcycles,Number,0,1,1,2,4,5,6,7,9,10,12,13,14,16,17,17,18,19,19,20,20,20,21,21,21,21,21,21,21,21
E01000215,EV motorcycles,Number,0,0,1,1,2,2,3,4,4,5,6,6,7,7,8,8,9,9,9,9,10,10,10,10,10,10,10,10,10,10
E01000216,EV motorcycles,Number,0,0,1,1,2,2,3,4,5,5,6,7,8,8,9,9,10,10,10,10,11,11,11,11,11,11,11,11,11,11
E01000217,EV motorcycles,Number,0,1,1,2,3,3,4,5,6,7,8,9,10,11,12,12,13,13,14,14,14,15,15,15,15,15,15,15,15,15
E01000218,EV motorcycles,Number,0,1,1,2,3,4,5,6,8,9,10,11,12,13,14,15,16,16,17,17,17,17,18,18,18,18,18,18,18,18
E01000219,EV motorcycles,Number,0,1,1,2,3,4,5,6,7,8,10,11,12,13,13,14,15,15,16,16,16,16,17,17,17,17,17,17,17,17
E01000220,EV motorcycles,Number,0,1,1,2,3,4,6,7,8,10,11,12,14,15,16,17,17,18,18,19,19,19,20,20,20,20,20,20,20,20
E01000221,EV motorcycles,Number,0,0,1,1,2,2,3,3,4,4,5,6,6,7,7,7,8,8,8,8,9,9,9,9,9,9,9,9,9,9
E01000222,EV motorcycles,Number,1,1,3,4,7,9,11,14,16,19,22,24,27,29,31,32,34,35,36,37,37,38,38,38,39,39,39,39,39,39
E01000223,EV motorcycles,Number,0,1,2,3,4,5,7,9,10,12,13,15,16,18,19,20,21,22,22,23,23,23,23,24,24,24,24,24,24,24
E01000224,EV motorcycles,Number,0,1,2,3,4,5,7,8,10,11,13,14,16,17,18,19,20,21,21,22,22,22,23,23,23,23,23,23,23,23
E01000225,EV motorcycles,Number,0,1,1,2,3,4,5,6,7,8,9,10,11,12,13,13,14,14,15,15,15,16,16,16,16,16,16,16,16,16
E01000226,EV motorcycles,Number,0,1,2,3,4,5,7,9,10,12,13,15,16,18,19,20,21,22,22,23,23,23,23,24,24,24,24,24,24,24
E01000227,EV motorcycles,Number,0,1,1,2,3,4,5,7,8,9,11,12,13,14,15,16,17,17,18,18,18,18,19,19,19,19,19,19,19,19
E01000228,EV motorcycles,Number,0,0,1,1,2,3,3,4,5,6,7,7,8,9,9,10,10,11,11,11,12,12,12,12,12,12,12,12,12,12
E01000229,EV motorcycles,Number,0,1,2,3,4,6,7,9,11,12,14,16,17,18,20,21,22,22,23,24,24,24,24,25,25,25,25,25,25,25
E01000230,EV motorcycles,Number,0,1,1,2,3,4,5,6,7,8,10,11,12,13,13,14,15,15,16,16,16,16,17,17,17,17,17,17,17,17
E01000231,EV motorcycles,Number,0,1,1,2,3,4,5,6,8,9,10,11,12,13,14,15,16,16,17,17,17,17,18,18,18,18,18,18,18,18
E01000232,EV motorcycles,Number,0,0,1,1,2,3,4,5,5,6,7,8,9,10,10,11,11,12,12,12,12,13,13,13,13,13,13,13,13,13
E01000233,EV motorcycles,Number,0,1,2,3,4,5,7,9,10,12,13,15,16,18,19,20,21,22,22,23,23,23,23,24,24,24,24,24,24,24
E01000234,EV motorcycles,Number,0,1,1,2,2,3,4,5,6,7,8,9,10,10,11,12,12,13,13,13,13,14,14,14,14,14,14,14,14,14
E01000235,EV motorcycles,Number,0,1,1,2,4,5,6,7,9,10,12,13,14,16,17,17,18,19,19,20,20,20,21,21,21,21,21,21,21,21
E01000236,EV motorcycles,Number,0,1,1,2,3,4,5,6,7,8,9,10,11,12,13,13,14,14,15,15,15,16,16,16,16,16,16,16,16,16
E01000237,EV motorcycles,Number,0,1,2,3,4,5,7,9,10,12,13,15,16,18,19,20,21,22,22,23,23,23,23,24,24,24,24,24,24,24
E01000238,EV motorcycles,Number,0,1,2,3,5,6,8,10,11,13,15,17,18,20,21,22,23,24,25,25,26,26,26,27,27,27,27,27,27,27
E01000239,EV motorcycles,Number,0,1,2,3,4,5,7,9,10,12,13,15,16,18,19,20,21,22,22,23,23,23,23,24,24,24,24,24,24,24
E01000240,EV motorcycles,Number,0,1,2,3,4,6,7,9,11,12,14,16,17,18,20,21,22,22,23,24,24,24,24,25,25,25,25,25,25,25
E01000241,EV motorcycles,Number,0,1,2,3,4,6,8,9,11,13,15,16,18,19,20,22,23,23,24,25,25,25,25,26,26,26,26,26,26,26
E01000242,EV motorcycles,Number,0,0,1,1,2,2,3,4,4,5,6,6,7,7,8,8,9,9,9,9,10,10,10,10,10,10,10,10,10,10
E01000243,EV motorcycles,Number,0,1,2,3,4,6,7,9,11,12,14,16,17,18,20,21,22,22,23,24,24,24,24,25,25,25,25,25,25,25
E01000244,EV motorcycles,Number,0,1,1,2,3,4,5,6,8,9,10,11,12,13,14,15,16,16,17,17,17,17,18,18,18,18,18,18,18,18
E01000245,EV motorcycles,Number,0,1,2,3,5,7,9,11,13,15,17,19,21,22,24,25,26,27,28,28,29,29,29,30,30,30,30,30,30,30
E01000246,EV motorcycles,Number,0,1,2,3,5,6,8,10,12,14,16,17,19,21,22,23,24,25,26,26,27,27,27,28,28,28,28,28,28,28
E01000247,EV motorcycles,Number,0,1,1,2,4,5,6,7,9,10,12,13,14,16,17,17,18,19,19,20,20,20,21,21,21,21,21,21,21,21
E01000248,EV motorcycles,Number,0,0,1,1,2,2,3,4,5,5,6,7,8,8,9,9,10,10,10,10,11,11,11,11,11,11,11,11,11,11
E01000249,EV motorcycles,Number,0,1,1,2,3,4,6,7,8,10,11,12,14,15,16,17,17,18,18,19,19,19,20,20,20,20,20,20,20,20
E01000250,EV motorcycles,Number,0,1,2,4,5,7,9,11,14,16,18,20,22,24,25,27,28,29,30,30,31,31,31,32,32,32,32,32,32,32
E01000251,EV motorcycles,Number,1,1,3,4,7,9,11,14,16,19,22,24,27,29,31,32,34,35,36,37,37,38,38,38,39,39,39,39,39,39
E01000252,EV motorcycles,Number,0,1,1,2,2,3,4,5,6,7,8,9,10,10,11,12,12,13,13,13,13,14,14,14,14,14,14,14,14,14
E01000253,EV motorcycles,Number,0,0,1,1,2,2,3,4,4,5,6,6,7,7,8,8,9,9,9,9,10,10,10,10,10,10,10,10,10,10
E01000254,EV motorcycles,Number,0,1,2,4,6,8,10,12,14,17,19,21,23,25,27,28,30,31,31,32,33,33,33,33,34,34,34,34,34,34
E01000255,EV motorcycles,Number,0,1,2,3,5,6,8,10,11,13,15,17,18,20,21,22,23,24,25,25,26,26,26,27,27,27,27,27,27,27
E01000256,EV motorcycles,Number,1,1,3,5,7,9,12,15,17,20,23,26,28,30,32,34,36,37,38,39,39,40,40,40,41,41,41,41,41,41
E01000257,EV motorcycles,Number,0,1,1,2,4,5,6,7,9,10,12,13,14,16,17,17,18,19,19,20,20,20,21,21,21,21,21,21,21,21
E01000258,EV motorcycles,Number,0,1,1,2,4,5,6,8,9,11,12,14,15,16,17,18,19,20,20,21,21,21,22,22,22,22,22,22,22,22
E01000259,EV motorcycles,Number,0,1,2,4,5,7,9,11,14,16,18,20,22,24,25,27,28,29,30,30,31,31,31,32,32,32,32,32,32,32
E01000260,EV motorcycles,Number,1,1,3,4,7,9,11,14,16,19,22,24,27,29,31,32,34,35,36,37,37,38,38,38,39,39,39,39,39,39
E01000261,EV motorcycles,Number,0,0,1,1,2,3,3,4,5,6,7,7,8,9,9,10,10,11,11,11,12,12,12,12,12,12,12,12,12,12
E01000262,EV motorcycles,Number,1,2,4,6,9,13,16,20,24,28,31,35,38,41,44,47,49,50,52,53,54,54,55,55,55,56,56,56,56,56
E01000263,EV motorcycles,Number,0,0,1,1,2,3,4,5,5,6,7,8,9,10,10,11,11,12,12,12,12,13,13,13,13,13,13,13,13,13
E01000264,EV motorcycles,Number,0,1,2,3,4,5,7,9,10,12,13,15,16,18,19,20,21,22,22,23,23,23,23,24,24,24,24,24,24,24
E01000265,EV motorcycles,Number,0,1,1,2,3,4,5,7,8,9,11,12,13,14,15,16,17,17,18,18,18,18,19,19,19,19,19,19,19,19
E01000266,EV motorcycles,Number,0,0,1,1,2,2,3,4,4,5,6,6,7,7,8,8,9,9,9,9,10,10,10,10,10,10,10,10,10,10
E01000267,EV motorcycles,Number,0,1,1,2,3,4,5,6,8,9,10,11,12,13,14,15,16,16,17,17,17,17,18,18,18,18,18,18,18,18
E01000268,EV motorcycles,Number,1,3,5,8,12,16,20,25,30,34,39,44,48,52,55,58,61,63,65,66,67,68,69,69,69,70,70,70,70,70
E01000269,EV motorcycles,Number,0,0,0,1,1,2,2,2,3,3,4,4,5,5,6,6,6,6,6,7,7,7,7,7,7,7,7,7,7,7
E01000270,EV motorcycles,Number,0,1,2,3,4,5,7,8,10,11,13,14,16,17,18,19,20,21,21,22,22,22,23,23,23,23,23,23,23,23
E01000271,EV motorcycles,Number,0,1,1,2,2,3,4,5,6,7,8,9,10,10,11,12,12,13,13,13,13,14,14,14,14,14,14,14,14,14
E01000272,EV motorcycles,Number,0,0,1,1,2,3,3,4,5,6,7,7,8,9,9,10,10,11,11,11,12,12,12,12,12,12,12,12,12,12
E01000273,EV motorcycles,Number,0,1,1,2,4,5,6,8,9,11,12,14,15,16,17,18,19,20,20,21,21,21,22,22,22,22,22,22,22,22
E01000274,EV motorcycles,Number,0,1,1,2,3,4,6,7,8,10,11,12,14,15,16,17,17,18,18,19,19,19,20,20,20,20,20,20,20,20
E01000275,EV motorcycles,Number,0,0,1,1,2,2,3,3,4,4,5,6,6,7,7,7,8,8,8,8,9,9,9,9,9,9,9,9,9,9
E01000276,EV motorcycles,Number,0,1,1,2,3,3,4,5,6,7,8,9,10,11,12,12,13,13,14,14,14,15,15,15,15,15,15,15,15,15
E01000277,EV motorcycles,Number,0,0,0,0,0,0,0,0,0,0,0,0,0,0,0,0,0,0,0,0,0,0,0,0,0,0,0,0,0,0
E01000278,EV motorcycles,Number,0,1,1,2,3,4,5,6,7,8,9,10,11,12,13,13,14,14,15,15,15,16,16,16,16,16,16,16,16,16
E01000279,EV motorcycles,Number,0,0,1,1,2,3,4,5,5,6,7,8,9,10,10,11,11,12,12,12,12,13,13,13,13,13,13,13,13,13
E01000280,EV motorcycles,Number,0,1,1,2,3,4,5,6,8,9,10,11,12,13,14,15,16,16,17,17,17,17,18,18,18,18,18,18,18,18
E01000281,EV motorcycles,Number,0,1,1,2,3,4,5,6,7,8,10,11,12,13,13,14,15,15,16,16,16,16,17,17,17,17,17,17,17,17
E01000282,EV motorcycles,Number,0,0,1,1,2,3,3,4,5,6,7,7,8,9,9,10,10,11,11,11,12,12,12,12,12,12,12,12,12,12
E01000283,EV motorcycles,Number,0,0,1,1,1,2,2,3,3,4,4,5,5,6,6,7,7,7,7,8,8,8,8,8,8,8,8,8,8,8
E01000284,EV motorcycles,Number,0,1,2,3,4,6,7,9,11,12,14,16,17,18,20,21,22,22,23,24,24,24,24,25,25,25,25,25,25,25
E01000285,EV motorcycles,Number,0,1,2,3,4,5,7,8,10,11,13,14,16,17,18,19,20,21,21,22,22,22,23,23,23,23,23,23,23,23
E01000286,EV motorcycles,Number,0,1,2,3,4,6,8,9,11,13,15,16,18,19,20,22,23,23,24,25,25,25,25,26,26,26,26,26,26,26
E01000287,EV motorcycles,Number,0,1,2,3,4,5,7,8,10,11,13,14,16,17,18,19,20,21,21,22,22,22,23,23,23,23,23,23,23,23
E01000288,EV motorcycles,Number,0,1,2,3,5,6,8,10,11,13,15,17,18,20,21,22,23,24,25,25,26,26,26,27,27,27,27,27,27,27
E01000289,EV motorcycles,Number,0,0,1,1,2,3,3,4,5,6,7,7,8,9,9,10,10,11,11,11,12,12,12,12,12,12,12,12,12,12
E01000290,EV motorcycles,Number,0,1,2,3,4,5,7,8,10,11,13,14,16,17,18,19,20,21,21,22,22,22,23,23,23,23,23,23,23,23
E01000291,EV motorcycles,Number,0,0,1,1,2,3,4,5,5,6,7,8,9,10,10,11,11,12,12,12,12,13,13,13,13,13,13,13,13,13
E01000292,EV motorcycles,Number,0,1,1,2,4,5,6,7,9,10,12,13,14,16,17,17,18,19,19,20,20,20,21,21,21,21,21,21,21,21
E01000293,EV motorcycles,Number,0,1,2,3,4,5,7,8,10,11,13,14,16,17,18,19,20,21,21,22,22,22,23,23,23,23,23,23,23,23
E01000294,EV motorcycles,Number,0,1,1,2,3,4,5,6,7,8,10,11,12,13,13,14,15,15,16,16,16,16,17,17,17,17,17,17,17,17
E01000295,EV motorcycles,Number,0,1,1,2,3,4,5,7,8,9,11,12,13,14,15,16,17,17,18,18,18,18,19,19,19,19,19,19,19,19
E01000296,EV motorcycles,Number,0,1,1,2,3,4,6,7,8,10,11,12,14,15,16,17,17,18,18,19,19,19,20,20,20,20,20,20,20,20
E01000297,EV motorcycles,Number,0,1,1,2,3,4,5,6,7,8,9,10,11,12,13,13,14,14,15,15,15,16,16,16,16,16,16,16,16,16
E01000298,EV motorcycles,Number,0,1,1,2,3,4,6,7,8,10,11,12,14,15,16,17,17,18,18,19,19,19,20,20,20,20,20,20,20,20
E01000299,EV motorcycles,Number,1,1,2,4,6,8,11,13,16,18,21,23,25,27,29,31,32,33,34,35,35,36,36,36,37,37,37,37,37,37
E01000300,EV motorcycles,Number,0,0,1,1,2,3,3,4,5,6,7,7,8,9,9,10,10,11,11,11,12,12,12,12,12,12,12,12,12,12
E01000301,EV motorcycles,Number,0,1,1,2,2,3,4,5,6,7,8,9,10,10,11,12,12,13,13,13,13,14,14,14,14,14,14,14,14,14
E01000302,EV motorcycles,Number,0,1,2,3,4,6,7,9,11,12,14,16,17,18,20,21,22,22,23,24,24,24,24,25,25,25,25,25,25,25
E01000303,EV motorcycles,Number,0,1,1,2,3,3,4,5,6,7,8,9,10,11,12,12,13,13,14,14,14,15,15,15,15,15,15,15,15,15
E01000304,EV motorcycles,Number,0,1,1,2,2,3,4,5,6,7,8,9,10,10,11,12,12,13,13,13,13,14,14,14,14,14,14,14,14,14
E01000305,EV motorcycles,Number,0,1,2,3,4,5,7,9,10,12,13,15,16,18,19,20,21,22,22,23,23,23,23,24,24,24,24,24,24,24
E01000306,EV motorcycles,Number,0,1,2,3,5,6,8,10,12,14,16,17,19,21,22,23,24,25,26,26,27,27,27,28,28,28,28,28,28,28
E01000307,EV motorcycles,Number,0,1,1,2,3,4,5,6,8,9,10,11,12,13,14,15,16,16,17,17,17,17,18,18,18,18,18,18,18,18
E01000308,EV motorcycles,Number,0,1,1,2,4,5,6,8,9,11,12,14,15,16,17,18,19,20,20,21,21,21,22,22,22,22,22,22,22,22
E01000309,EV motorcycles,Number,0,1,2,3,4,5,7,9,10,12,13,15,16,18,19,20,21,22,22,23,23,23,23,24,24,24,24,24,24,24
E01000310,EV motorcycles,Number,1,2,3,5,8,11,14,17,20,24,27,30,33,35,38,40,42,43,44,45,46,47,47,47,48,48,48,48,48,48
E01000311,EV motorcycles,Number,0,1,1,2,4,5,6,7,9,10,12,13,14,16,17,17,18,19,19,20,20,20,21,21,21,21,21,21,21,21
E01000312,EV motorcycles,Number,0,1,1,2,3,4,5,6,7,8,9,10,11,12,13,13,14,14,15,15,15,16,16,16,16,16,16,16,16,16
E01000313,EV motorcycles,Number,0,1,1,2,4,5,6,8,9,11,12,14,15,16,17,18,19,20,20,21,21,21,22,22,22,22,22,22,22,22
E01000314,EV motorcycles,Number,0,1,2,3,5,6,8,10,11,13,15,17,18,20,21,22,23,24,25,25,26,26,26,27,27,27,27,27,27,27
E01000315,EV motorcycles,Number,0,1,1,2,3,4,5,6,8,9,10,11,12,13,14,15,16,16,17,17,17,17,18,18,18,18,18,18,18,18
E01000316,EV motorcycles,Number,0,1,1,2,3,4,5,7,8,9,11,12,13,14,15,16,17,17,18,18,18,18,19,19,19,19,19,19,19,19
E01000317,EV motorcycles,Number,0,1,1,2,3,4,5,6,7,8,10,11,12,13,13,14,15,15,16,16,16,16,17,17,17,17,17,17,17,17
E01000318,EV motorcycles,Number,0,0,1,1,2,2,3,4,4,5,6,6,7,7,8,8,9,9,9,9,10,10,10,10,10,10,10,10,10,10
E01000319,EV motorcycles,Number,0,1,2,3,4,6,8,9,11,13,15,16,18,19,20,22,23,23,24,25,25,25,25,26,26,26,26,26,26,26
E01000320,EV motorcycles,Number,1,1,2,4,6,8,10,13,15,18,20,22,25,27,28,30,31,32,33,34,35,35,35,35,36,36,36,36,36,36
E01000321,EV motorcycles,Number,0,1,1,2,3,4,5,6,8,9,10,11,12,13,14,15,16,16,17,17,17,17,18,18,18,18,18,18,18,18
E01000322,EV motorcycles,Number,0,1,1,2,3,4,6,7,8,10,11,12,14,15,16,17,17,18,18,19,19,19,20,20,20,20,20,20,20,20
E01000323,EV motorcycles,Number,1,1,2,4,6,8,11,13,16,18,21,23,25,27,29,31,32,33,34,35,35,36,36,36,37,37,37,37,37,37
E01000324,EV motorcycles,Number,0,1,2,3,4,6,7,9,11,12,14,16,17,18,20,21,22,22,23,24,24,24,24,25,25,25,25,25,25,25
E01000325,EV motorcycles,Number,0,1,2,4,5,7,9,11,14,16,18,20,22,24,25,27,28,29,30,30,31,31,31,32,32,32,32,32,32,32
E01000326,EV motorcycles,Number,0,1,2,3,4,6,7,9,11,12,14,16,17,18,20,21,22,22,23,24,24,24,24,25,25,25,25,25,25,25
E01000327,EV motorcycles,Number,0,1,1,2,3,4,5,7,8,9,11,12,13,14,15,16,17,17,18,18,18,18,19,19,19,19,19,19,19,19
E01000328,EV motorcycles,Number,0,1,2,4,6,7,10,12,14,16,18,21,23,24,26,27,29,30,31,31,32,32,32,33,33,33,33,33,33,33
E01000329,EV motorcycles,Number,0,1,2,3,4,5,7,8,10,11,13,14,16,17,18,19,20,21,21,22,22,22,23,23,23,23,23,23,23,23
E01000330,EV motorcycles,Number,0,1,2,3,4,5,7,9,10,12,13,15,16,18,19,20,21,22,22,23,23,23,23,24,24,24,24,24,24,24
E01000331,EV motorcycles,Number,0,1,2,4,6,8,10,12,14,17,19,21,23,25,27,28,30,31,31,32,33,33,33,33,34,34,34,34,34,34
E01000332,EV motorcycles,Number,0,1,2,3,4,6,7,9,11,12,14,16,17,18,20,21,22,22,23,24,24,24,24,25,25,25,25,25,25,25
E01000333,EV motorcycles,Number,0,1,1,2,4,5,6,8,9,11,12,14,15,16,17,18,19,20,20,21,21,21,22,22,22,22,22,22,22,22
E01000334,EV motorcycles,Number,0,1,2,3,5,6,8,10,11,13,15,17,18,20,21,22,23,24,25,25,26,26,26,27,27,27,27,27,27,27
E01000335,EV motorcycles,Number,0,1,2,3,5,7,8,10,12,14,16,18,20,21,23,24,25,26,27,27,28,28,28,29,29,29,29,29,29,29
E01000336,EV motorcycles,Number,0,1,1,2,3,3,4,5,6,7,8,9,10,11,12,12,13,13,14,14,14,15,15,15,15,15,15,15,15,15
E01000337,EV motorcycles,Number,0,1,2,3,5,7,8,10,12,14,16,18,20,21,23,24,25,26,27,27,28,28,28,29,29,29,29,29,29,29
E01000338,EV motorcycles,Number,0,1,1,2,3,4,5,7,8,9,11,12,13,14,15,16,17,17,18,18,18,18,19,19,19,19,19,19,19,19
E01000339,EV motorcycles,Number,1,2,3,5,8,11,14,17,20,23,26,29,32,35,37,39,41,42,43,44,45,46,46,46,47,47,47,47,47,47
E01000340,EV motorcycles,Number,0,1,2,3,4,6,8,9,11,13,15,16,18,19,20,22,23,23,24,25,25,25,25,26,26,26,26,26,26,26
E01000341,EV motorcycles,Number,1,2,3,5,8,11,14,17,20,23,26,29,32,35,37,39,41,42,43,44,45,46,46,46,47,47,47,47,47,47
E01000342,EV motorcycles,Number,0,1,2,3,4,6,7,9,11,12,14,16,17,18,20,21,22,22,23,24,24,24,24,25,25,25,25,25,25,25
E01000343,EV motorcycles,Number,0,1,2,4,5,7,9,11,14,16,18,20,22,24,25,27,28,29,30,30,31,31,31,32,32,32,32,32,32,32
E01000344,EV motorcycles,Number,0,1,1,2,4,5,6,8,9,11,12,14,15,16,17,18,19,20,20,21,21,21,22,22,22,22,22,22,22,22
E01000345,EV motorcycles,Number,0,1,2,3,4,5,7,9,10,12,13,15,16,18,19,20,21,22,22,23,23,23,23,24,24,24,24,24,24,24
E01000346,EV motorcycles,Number,1,1,2,4,6,8,10,13,15,18,20,22,25,27,28,30,31,32,33,34,35,35,35,35,36,36,36,36,36,36
E01000347,EV motorcycles,Number,0,1,2,3,4,5,7,9,10,12,13,15,16,18,19,20,21,22,22,23,23,23,23,24,24,24,24,24,24,24
E01000348,EV motorcycles,Number,0,1,2,3,5,7,9,11,13,15,17,19,21,23,24,26,27,28,29,29,30,30,30,31,31,31,31,31,31,31
E01000349,EV motorcycles,Number,0,1,1,2,3,4,5,6,8,9,10,11,12,13,14,15,16,16,17,17,17,17,18,18,18,18,18,18,18,18
E01000350,EV motorcycles,Number,0,1,2,3,4,6,8,9,11,13,15,16,18,19,20,22,23,23,24,25,25,25,25,26,26,26,26,26,26,26
E01000351,EV motorcycles,Number,1,2,3,5,8,10,13,16,19,22,25,28,31,33,35,37,39,40,42,42,43,44,44,44,45,45,45,45,45,45
E01000352,EV motorcycles,Number,0,1,2,4,5,7,9,11,14,16,18,20,22,24,25,27,28,29,30,30,31,31,31,32,32,32,32,32,32,32
E01000353,EV motorcycles,Number,1,1,3,4,7,9,12,14,17,20,22,25,27,30,32,33,35,36,37,38,38,39,39,39,40,40,40,40,40,40
E01000354,EV motorcycles,Number,0,1,1,2,3,4,6,7,8,10,11,12,14,15,16,17,17,18,18,19,19,19,20,20,20,20,20,20,20,20
E01000355,EV motorcycles,Number,0,1,1,2,4,5,6,7,9,10,12,13,14,16,17,17,18,19,19,20,20,20,21,21,21,21,21,21,21,21
E01000356,EV motorcycles,Number,0,1,1,2,4,5,6,7,9,10,12,13,14,16,17,17,18,19,19,20,20,20,21,21,21,21,21,21,21,21
E01000357,EV motorcycles,Number,0,1,1,2,4,5,6,8,9,11,12,14,15,16,17,18,19,20,20,21,21,21,22,22,22,22,22,22,22,22
E01000358,EV motorcycles,Number,1,1,2,4,6,8,10,12,15,17,20,22,24,26,28,29,30,31,32,33,34,34,34,34,35,35,35,35,35,35
E01000359,EV motorcycles,Number,0,1,1,2,4,5,6,7,9,10,12,13,14,16,17,17,18,19,19,20,20,20,21,21,21,21,21,21,21,21
E01000360,EV motorcycles,Number,0,1,2,4,5,7,9,11,14,16,18,20,22,24,25,27,28,29,30,30,31,31,31,32,32,32,32,32,32,32
E01000361,EV motorcycles,Number,1,1,3,4,7,9,12,14,17,20,22,25,27,30,32,33,35,36,37,38,38,39,39,39,40,40,40,40,40,40
E01000362,EV motorcycles,Number,0,1,2,3,5,6,8,10,11,13,15,17,18,20,21,22,23,24,25,25,26,26,26,27,27,27,27,27,27,27
E01000363,EV motorcycles,Number,1,1,2,4,6,8,11,13,16,18,21,23,25,27,29,31,32,33,34,35,35,36,36,36,37,37,37,37,37,37
E01000364,EV motorcycles,Number,1,1,2,4,6,9,11,13,16,19,21,24,26,28,30,32,33,34,35,36,36,37,37,37,38,38,38,38,38,38
E01000365,EV motorcycles,Number,0,1,1,2,4,5,6,8,9,11,12,14,15,16,17,18,19,20,20,21,21,21,22,22,22,22,22,22,22,22
E01000366,EV motorcycles,Number,0,0,1,1,2,2,3,4,5,5,6,7,8,8,9,9,10,10,10,10,11,11,11,11,11,11,11,11,11,11
E01000367,EV motorcycles,Number,0,1,2,3,5,7,8,10,12,14,16,18,20,21,23,24,25,26,27,27,28,28,28,29,29,29,29,29,29,29
E01000368,EV motorcycles,Number,0,1,1,2,3,4,5,6,7,8,10,11,12,13,13,14,15,15,16,16,16,16,17,17,17,17,17,17,17,17
E01000369,EV motorcycles,Number,1,1,3,5,7,9,12,15,17,20,23,26,28,30,32,34,36,37,38,39,39,40,40,40,41,41,41,41,41,41
E01000370,EV motorcycles,Number,1,1,2,4,6,9,11,13,16,19,21,24,26,28,30,32,33,34,35,36,36,37,37,37,38,38,38,38,38,38
E01000371,EV motorcycles,Number,0,1,2,3,4,5,7,8,10,11,13,14,16,17,18,19,20,21,21,22,22,22,23,23,23,23,23,23,23,23
E01000372,EV motorcycles,Number,1,1,2,4,6,8,10,12,15,17,20,22,24,26,28,29,30,31,32,33,34,34,34,34,35,35,35,35,35,35
E01000373,EV motorcycles,Number,0,0,0,0,0,0,0,0,0,0,0,0,0,0,0,0,0,0,0,0,0,0,0,0,0,0,0,0,0,0
E01000374,EV motorcycles,Number,0,1,2,3,5,6,8,10,12,14,16,17,19,21,22,23,24,25,26,26,27,27,27,28,28,28,28,28,28,28
E01000375,EV motorcycles,Number,1,2,3,5,8,11,14,17,21,24,27,31,33,36,39,41,43,44,45,46,47,48,48,48,48,49,49,49,49,49
E01000376,EV motorcycles,Number,0,1,2,3,5,7,9,11,13,15,17,19,21,23,24,26,27,28,29,29,30,30,30,31,31,31,31,31,31,31
E01000377,EV motorcycles,Number,1,1,2,4,6,8,10,13,15,18,20,22,25,27,28,30,31,32,33,34,35,35,35,35,36,36,36,36,36,36
E01000378,EV motorcycles,Number,1,1,2,4,6,9,11,13,16,19,21,24,26,28,30,32,33,34,35,36,36,37,37,37,38,38,38,38,38,38
E01000379,EV motorcycles,Number,0,1,1,2,4,5,6,8,9,11,12,14,15,16,17,18,19,20,20,21,21,21,22,22,22,22,22,22,22,22
E01000380,EV motorcycles,Number,0,1,2,3,5,6,8,10,12,14,16,17,19,21,22,23,24,25,26,26,27,27,27,28,28,28,28,28,28,28
E01000381,EV motorcycles,Number,1,2,3,5,8,10,13,16,19,22,25,28,31,33,35,37,39,40,42,42,43,44,44,44,45,45,45,45,45,45
E01000382,EV motorcycles,Number,1,1,2,4,6,8,11,13,16,18,21,23,25,27,29,31,32,33,34,35,35,36,36,36,37,37,37,37,37,37
E01000383,EV motorcycles,Number,1,2,4,7,10,13,17,21,25,30,34,37,41,44,47,50,52,54,55,57,58,58,59,59,59,60,60,60,60,60
E01000384,EV motorcycles,Number,0,1,2,3,4,5,7,9,10,12,13,15,16,18,19,20,21,22,22,23,23,23,23,24,24,24,24,24,24,24
E01000385,EV motorcycles,Number,1,1,2,4,6,8,10,12,15,17,20,22,24,26,28,29,30,31,32,33,34,34,34,34,35,35,35,35,35,35
E01000386,EV motorcycles,Number,0,1,1,2,2,3,4,5,6,7,8,9,10,10,11,12,12,13,13,13,13,14,14,14,14,14,14,14,14,14
E01000387,EV motorcycles,Number,0,1,2,4,6,8,10,12,14,17,19,21,23,25,27,28,30,31,31,32,33,33,33,33,34,34,34,34,34,34
E01000388,EV motorcycles,Number,0,1,2,3,4,6,7,9,11,12,14,16,17,18,20,21,22,22,23,24,24,24,24,25,25,25,25,25,25,25
E01000389,EV motorcycles,Number,0,1,2,3,4,6,7,9,11,12,14,16,17,18,20,21,22,22,23,24,24,24,24,25,25,25,25,25,25,25
E01000390,EV motorcycles,Number,0,1,2,3,4,6,7,9,11,12,14,16,17,18,20,21,22,22,23,24,24,24,24,25,25,25,25,25,25,25
E01000391,EV motorcycles,Number,0,1,1,2,4,5,6,7,9,10,12,13,14,16,17,17,18,19,19,20,20,20,21,21,21,21,21,21,21,21
E01000392,EV motorcycles,Number,0,1,2,4,6,7,10,12,14,16,18,21,23,24,26,27,29,30,31,31,32,32,32,33,33,33,33,33,33,33
E01000393,EV motorcycles,Number,0,1,1,2,3,4,6,7,8,10,11,12,14,15,16,17,17,18,18,19,19,19,20,20,20,20,20,20,20,20
E01000394,EV motorcycles,Number,0,1,2,3,5,7,9,11,13,15,17,19,21,22,24,25,26,27,28,28,29,29,29,30,30,30,30,30,30,30
E01000395,EV motorcycles,Number,0,1,1,2,4,5,6,7,9,10,12,13,14,16,17,17,18,19,19,20,20,20,21,21,21,21,21,21,21,21
E01000396,EV motorcycles,Number,0,1,1,2,4,5,6,7,9,10,12,13,14,16,17,17,18,19,19,20,20,20,21,21,21,21,21,21,21,21
E01000398,EV motorcycles,Number,0,1,2,3,5,7,9,11,13,15,17,19,21,23,24,26,27,28,29,29,30,30,30,31,31,31,31,31,31,31
E01000399,EV motorcycles,Number,1,1,2,4,6,8,10,12,15,17,20,22,24,26,28,29,30,31,32,33,34,34,34,34,35,35,35,35,35,35
E01000400,EV motorcycles,Number,0,1,2,3,4,6,8,9,11,13,15,16,18,19,20,22,23,23,24,25,25,25,25,26,26,26,26,26,26,26
E01000401,EV motorcycles,Number,0,1,2,3,5,6,8,10,12,14,16,17,19,21,22,23,24,25,26,26,27,27,27,28,28,28,28,28,28,28
E01000402,EV motorcycles,Number,0,1,1,2,3,4,5,7,8,9,11,12,13,14,15,16,17,17,18,18,18,18,19,19,19,19,19,19,19,19
E01000403,EV motorcycles,Number,0,0,1,1,2,3,4,5,5,6,7,8,9,10,10,11,11,12,12,12,12,13,13,13,13,13,13,13,13,13
E01000404,EV motorcycles,Number,0,0,1,1,2,3,3,4,5,6,7,7,8,9,9,10,10,11,11,11,12,12,12,12,12,12,12,12,12,12
E01000405,EV motorcycles,Number,0,0,1,1,2,2,3,4,5,5,6,7,8,8,9,9,10,10,10,10,11,11,11,11,11,11,11,11,11,11
E01000406,EV motorcycles,Number,0,1,1,2,3,4,6,7,8,10,11,12,14,15,16,17,17,18,18,19,19,19,20,20,20,20,20,20,20,20
E01000407,EV motorcycles,Number,0,1,2,3,5,6,8,10,11,13,15,17,18,20,21,22,23,24,25,25,26,26,26,27,27,27,27,27,27,27
E01000408,EV motorcycles,Number,0,1,1,2,4,5,6,8,9,11,12,14,15,16,17,18,19,20,20,21,21,21,22,22,22,22,22,22,22,22
E01000409,EV motorcycles,Number,0,1,2,3,4,6,7,9,11,12,14,16,17,18,20,21,22,22,23,24,24,24,24,25,25,25,25,25,25,25
E01000410,EV motorcycles,Number,1,2,3,5,8,11,14,17,20,23,26,29,32,35,37,39,41,42,43,44,45,46,46,46,47,47,47,47,47,47
E01000411,EV motorcycles,Number,0,1,1,2,4,5,6,8,9,11,12,14,15,16,17,18,19,20,20,21,21,21,22,22,22,22,22,22,22,22
E01000412,EV motorcycles,Number,1,2,3,5,7,9,12,15,18,21,24,26,29,31,33,35,36,38,39,40,40,41,41,41,42,42,42,42,42,42
E01000413,EV motorcycles,Number,0,1,2,3,4,5,7,8,10,11,13,14,16,17,18,19,20,21,21,22,22,22,23,23,23,23,23,23,23,23
E01000414,EV motorcycles,Number,0,1,2,4,6,7,10,12,14,16,18,21,23,24,26,27,29,30,31,31,32,32,32,33,33,33,33,33,33,33
E01000415,EV motorcycles,Number,0,1,2,4,6,7,10,12,14,16,18,21,23,24,26,27,29,30,31,31,32,32,32,33,33,33,33,33,33,33
E01000416,EV motorcycles,Number,0,1,1,2,3,4,5,6,7,8,10,11,12,13,13,14,15,15,16,16,16,16,17,17,17,17,17,17,17,17
E01000417,EV motorcycles,Number,0,1,2,3,5,6,8,10,11,13,15,17,18,20,21,22,23,24,25,25,26,26,26,27,27,27,27,27,27,27
E01000418,EV motorcycles,Number,0,1,1,2,3,4,5,6,8,9,10,11,12,13,14,15,16,16,17,17,17,17,18,18,18,18,18,18,18,18
E01000419,EV motorcycles,Number,0,1,2,4,6,8,10,12,14,17,19,21,23,25,27,28,30,31,31,32,33,33,33,33,34,34,34,34,34,34
E01000420,EV motorcycles,Number,0,1,2,4,5,7,9,11,14,16,18,20,22,24,25,27,28,29,30,30,31,31,31,32,32,32,32,32,32,32
E01000421,EV motorcycles,Number,0,1,2,3,4,5,7,8,10,11,13,14,16,17,18,19,20,21,21,22,22,22,23,23,23,23,23,23,23,23
E01000422,EV motorcycles,Number,0,0,1,1,2,2,3,3,4,4,5,6,6,7,7,7,8,8,8,8,9,9,9,9,9,9,9,9,9,9
E01000423,EV motorcycles,Number,0,1,2,3,4,6,7,9,11,12,14,16,17,18,20,21,22,22,23,24,24,24,24,25,25,25,25,25,25,25
E01000424,EV motorcycles,Number,0,1,2,3,5,6,8,10,11,13,15,17,18,20,21,22,23,24,25,25,26,26,26,27,27,27,27,27,27,27
E01000425,EV motorcycles,Number,1,1,2,4,6,8,11,13,16,18,21,23,25,27,29,31,32,33,34,35,35,36,36,36,37,37,37,37,37,37
E01000426,EV motorcycles,Number,0,1,1,2,4,5,6,7,9,10,12,13,14,16,17,17,18,19,19,20,20,20,21,21,21,21,21,21,21,21
E01000427,EV motorcycles,Number,1,1,3,5,7,9,12,15,17,20,23,26,28,30,32,34,36,37,38,39,39,40,40,40,41,41,41,41,41,41
E01000428,EV motorcycles,Number,0,1,1,2,2,3,4,5,6,7,8,9,10,10,11,12,12,13,13,13,13,14,14,14,14,14,14,14,14,14
E01000429,EV motorcycles,Number,0,1,1,2,3,3,4,5,6,7,8,9,10,11,12,12,13,13,14,14,14,15,15,15,15,15,15,15,15,15
E01000430,EV motorcycles,Number,0,1,1,2,3,4,5,6,8,9,10,11,12,13,14,15,16,16,17,17,17,17,18,18,18,18,18,18,18,18
E01000431,EV motorcycles,Number,0,1,1,2,3,4,5,6,7,8,10,11,12,13,13,14,15,15,16,16,16,16,17,17,17,17,17,17,17,17
E01000432,EV motorcycles,Number,0,1,2,4,6,8,10,12,14,17,19,21,23,25,27,28,30,31,31,32,33,33,33,33,34,34,34,34,34,34
E01000433,EV motorcycles,Number,0,1,1,2,3,4,5,7,8,9,11,12,13,14,15,16,17,17,18,18,18,18,19,19,19,19,19,19,19,19
E01000434,EV motorcycles,Number,0,1,1,2,4,5,6,7,9,10,12,13,14,16,17,17,18,19,19,20,20,20,21,21,21,21,21,21,21,21
E01000435,EV motorcycles,Number,0,1,1,2,4,5,6,7,9,10,12,13,14,16,17,17,18,19,19,20,20,20,21,21,21,21,21,21,21,21
E01000436,EV motorcycles,Number,0,1,2,4,6,8,10,12,14,17,19,21,23,25,27,28,30,31,31,32,33,33,33,33,34,34,34,34,34,34
E01000437,EV motorcycles,Number,0,1,1,2,3,4,6,7,8,10,11,12,14,15,16,17,17,18,18,19,19,19,20,20,20,20,20,20,20,20
E01000438,EV motorcycles,Number,1,1,2,4,6,8,10,13,15,18,20,22,25,27,28,30,31,32,33,34,35,35,35,35,36,36,36,36,36,36
E01000439,EV motorcycles,Number,0,1,1,2,3,4,5,6,7,8,9,10,11,12,13,13,14,14,15,15,15,16,16,16,16,16,16,16,16,16
E01000440,EV motorcycles,Number,1,1,3,5,7,9,12,15,17,20,23,26,28,30,32,34,36,37,38,39,39,40,40,40,41,41,41,41,41,41
E01000441,EV motorcycles,Number,0,1,2,3,5,7,9,11,13,15,17,19,21,23,24,26,27,28,29,29,30,30,30,31,31,31,31,31,31,31
E01000442,EV motorcycles,Number,1,2,3,5,8,11,14,17,20,23,26,29,32,35,37,39,41,42,43,44,45,46,46,46,47,47,47,47,47,47
E01000443,EV motorcycles,Number,0,1,1,2,3,3,4,5,6,7,8,9,10,11,12,12,13,13,14,14,14,15,15,15,15,15,15,15,15,15
E01000444,EV motorcycles,Number,0,1,2,3,5,7,9,11,13,15,17,19,21,23,24,26,27,28,29,29,30,30,30,31,31,31,31,31,31,31
E01000445,EV motorcycles,Number,0,1,2,3,5,7,9,11,13,15,17,19,21,23,24,26,27,28,29,29,30,30,30,31,31,31,31,31,31,31
E01000446,EV motorcycles,Number,1,2,3,5,8,10,13,16,19,23,26,29,31,34,36,38,40,41,43,43,44,45,45,45,46,46,46,46,46,46
E01000447,EV motorcycles,Number,0,1,2,3,5,7,9,11,13,15,17,19,21,23,24,26,27,28,29,29,30,30,30,31,31,31,31,31,31,31
E01000448,EV motorcycles,Number,0,1,1,2,4,5,6,7,9,10,12,13,14,16,17,17,18,19,19,20,20,20,21,21,21,21,21,21,21,21
E01000449,EV motorcycles,Number,0,1,1,2,3,4,6,7,8,10,11,12,14,15,16,17,17,18,18,19,19,19,20,20,20,20,20,20,20,20
E01000450,EV motorcycles,Number,0,1,2,3,4,5,7,8,10,11,13,14,16,17,18,19,20,21,21,22,22,22,23,23,23,23,23,23,23,23
E01000451,EV motorcycles,Number,0,1,1,2,4,5,6,7,9,10,12,13,14,16,17,17,18,19,19,20,20,20,21,21,21,21,21,21,21,21
E01000452,EV motorcycles,Number,0,1,1,2,3,4,5,6,8,9,10,11,12,13,14,15,16,16,17,17,17,17,18,18,18,18,18,18,18,18
E01000453,EV motorcycles,Number,0,1,2,3,5,6,8,10,11,13,15,17,18,20,21,22,23,24,25,25,26,26,26,27,27,27,27,27,27,27
E01000454,EV motorcycles,Number,0,1,1,2,4,5,6,7,9,10,12,13,14,16,17,17,18,19,19,20,20,20,21,21,21,21,21,21,21,21
E01000455,EV motorcycles,Number,0,1,2,4,6,8,10,12,14,17,19,21,23,25,27,28,30,31,31,32,33,33,33,33,34,34,34,34,34,34
E01000456,EV motorcycles,Number,0,1,2,4,5,7,9,11,14,16,18,20,22,24,25,27,28,29,30,30,31,31,31,32,32,32,32,32,32,32
E01000457,EV motorcycles,Number,0,1,2,3,5,7,9,11,13,15,17,19,21,23,24,26,27,28,29,29,30,30,30,31,31,31,31,31,31,31
E01000458,EV motorcycles,Number,0,0,1,1,2,2,3,3,4,4,5,6,6,7,7,7,8,8,8,8,9,9,9,9,9,9,9,9,9,9
E01000459,EV motorcycles,Number,1,1,2,4,6,8,10,13,15,18,20,22,25,27,28,30,31,32,33,34,35,35,35,35,36,36,36,36,36,36
E01000460,EV motorcycles,Number,0,1,2,3,4,6,7,9,11,12,14,16,17,18,20,21,22,22,23,24,24,24,24,25,25,25,25,25,25,25
E01000461,EV motorcycles,Number,0,1,1,2,4,5,6,7,9,10,12,13,14,16,17,17,18,19,19,20,20,20,21,21,21,21,21,21,21,21
E01000462,EV motorcycles,Number,1,4,7,11,17,23,29,36,43,50,57,63,70,75,80,85,89,92,94,96,98,99,100,100,101,101,102,102,102,102
E01000463,EV motorcycles,Number,0,1,1,2,4,5,6,7,9,10,12,13,14,16,17,17,18,19,19,20,20,20,21,21,21,21,21,21,21,21
E01000464,EV motorcycles,Number,0,0,1,1,2,3,3,4,5,6,7,7,8,9,9,10,10,11,11,11,12,12,12,12,12,12,12,12,12,12
E01000465,EV motorcycles,Number,0,0,1,1,1,2,2,3,3,4,4,5,5,6,6,7,7,7,7,8,8,8,8,8,8,8,8,8,8,8
E01000466,EV motorcycles,Number,0,1,1,2,3,3,4,5,6,7,8,9,10,11,12,12,13,13,14,14,14,15,15,15,15,15,15,15,15,15
E01000467,EV motorcycles,Number,0,0,1,1,2,3,3,4,5,6,7,7,8,9,9,10,10,11,11,11,12,12,12,12,12,12,12,12,12,12
E01000468,EV motorcycles,Number,0,1,1,2,3,4,6,7,8,10,11,12,14,15,16,17,17,18,18,19,19,19,20,20,20,20,20,20,20,20
E01000469,EV motorcycles,Number,0,1,2,3,4,5,7,9,10,12,13,15,16,18,19,20,21,22,22,23,23,23,23,24,24,24,24,24,24,24
E01000470,EV motorcycles,Number,0,0,0,1,1,1,1,2,2,2,3,3,3,4,4,4,4,4,5,5,5,5,5,5,5,5,5,5,5,5
E01000471,EV motorcycles,Number,0,1,1,2,4,5,6,7,9,10,12,13,14,16,17,17,18,19,19,20,20,20,21,21,21,21,21,21,21,21
E01000472,EV motorcycles,Number,1,1,3,4,7,9,11,14,16,19,22,24,27,29,31,32,34,35,36,37,37,38,38,38,39,39,39,39,39,39
E01000473,EV motorcycles,Number,3,7,12,20,30,41,53,65,77,90,102,113,124,134,143,151,158,164,168,172,175,177,178,179,180,181,182,182,182,182
E01000474,EV motorcycles,Number,0,0,1,1,2,3,3,4,5,6,7,7,8,9,9,10,10,11,11,11,12,12,12,12,12,12,12,12,12,12
E01000475,EV motorcycles,Number,0,1,2,3,5,6,8,10,12,14,16,18,19,21,22,23,24,25,26,27,27,27,28,28,28,28,28,28,28,28
E01000476,EV motorcycles,Number,0,1,1,2,4,5,6,7,9,10,12,13,14,16,17,17,18,19,19,20,20,20,21,21,21,21,21,21,21,21
E01000477,EV motorcycles,Number,0,1,2,4,5,7,9,11,14,16,18,20,22,24,25,27,28,29,30,30,31,31,31,32,32,32,32,32,32,32
E01000478,EV motorcycles,Number,1,2,3,6,9,12,15,18,22,26,29,32,36,38,41,43,45,47,48,49,50,50,51,51,51,52,52,52,52,52
E01000479,EV motorcycles,Number,0,1,1,2,4,5,6,8,9,11,12,14,15,16,17,18,19,20,20,21,21,21,22,22,22,22,22,22,22,22
E01000480,EV motorcycles,Number,0,1,1,2,3,4,6,7,8,10,11,12,14,15,16,17,17,18,18,19,19,19,20,20,20,20,20,20,20,20
E01000481,EV motorcycles,Number,0,1,1,2,3,4,5,7,8,9,11,12,13,14,15,16,17,17,18,18,18,18,19,19,19,19,19,19,19,19
E01000482,EV motorcycles,Number,1,1,3,4,7,9,12,14,17,20,22,25,27,30,32,33,35,36,37,38,38,39,39,39,40,40,40,40,40,40
E01000483,EV motorcycles,Number,0,1,2,4,6,7,10,12,14,16,18,21,23,24,26,27,29,30,31,31,32,32,32,33,33,33,33,33,33,33
E01000484,EV motorcycles,Number,0,0,1,1,2,3,4,5,5,6,7,8,9,10,10,11,11,12,12,12,12,13,13,13,13,13,13,13,13,13
E01000485,EV motorcycles,Number,0,0,1,1,2,2,3,4,4,5,6,6,7,7,8,8,9,9,9,9,10,10,10,10,10,10,10,10,10,10
E01000486,EV motorcycles,Number,0,1,1,2,4,5,6,8,9,11,12,14,15,16,17,18,19,20,20,21,21,21,22,22,22,22,22,22,22,22
E01000487,EV motorcycles,Number,0,1,2,3,4,5,7,9,10,12,13,15,16,18,19,20,21,22,22,23,23,23,23,24,24,24,24,24,24,24
E01000488,EV motorcycles,Number,1,2,3,5,7,10,12,15,18,21,24,27,29,32,34,36,37,39,40,41,41,42,42,42,43,43,43,43,43,43
E01000489,EV motorcycles,Number,1,1,3,4,7,9,11,14,16,19,22,24,27,29,31,32,34,35,36,37,37,38,38,38,39,39,39,39,39,39
E01000490,EV motorcycles,Number,0,1,2,3,4,5,7,9,10,12,13,15,16,18,19,20,21,22,22,23,23,23,23,24,24,24,24,24,24,24
E01000491,EV motorcycles,Number,1,1,2,4,6,9,11,13,16,19,21,24,26,28,30,32,33,34,35,36,36,37,37,37,38,38,38,38,38,38
E01000492,EV motorcycles,Number,1,2,3,5,8,10,13,16,19,22,25,28,31,33,35,37,39,40,42,42,43,44,44,44,45,45,45,45,45,45
E01000493,EV motorcycles,Number,1,2,3,5,7,10,13,16,19,22,25,27,30,33,35,37,38,40,41,42,42,43,43,43,44,44,44,44,44,44
E01000494,EV motorcycles,Number,0,1,2,4,6,8,10,12,14,17,19,21,23,25,27,28,30,31,31,32,33,33,33,33,34,34,34,34,34,34
E01000495,EV motorcycles,Number,0,1,1,2,3,3,4,5,6,7,8,9,10,11,12,12,13,13,14,14,14,15,15,15,15,15,15,15,15,15
E01000497,EV motorcycles,Number,1,1,3,4,7,9,12,14,17,20,22,25,27,30,32,33,35,36,37,38,38,39,39,39,40,40,40,40,40,40
E01000498,EV motorcycles,Number,0,1,2,3,4,5,7,9,10,12,13,15,16,18,19,20,21,22,22,23,23,23,23,24,24,24,24,24,24,24
E01000499,EV motorcycles,Number,1,2,4,6,10,13,16,20,24,28,32,35,39,42,45,47,50,51,53,54,55,55,56,56,56,57,57,57,57,57
E01000501,EV motorcycles,Number,0,1,2,3,5,7,9,11,13,15,17,19,21,23,24,26,27,28,29,29,30,30,30,31,31,31,31,31,31,31
E01000502,EV motorcycles,Number,0,1,2,4,6,7,10,12,14,16,18,21,23,24,26,27,29,30,31,31,32,32,32,33,33,33,33,33,33,33
E01000503,EV motorcycles,Number,0,1,2,3,5,7,9,11,13,15,17,19,21,22,24,25,26,27,28,28,29,29,29,30,30,30,30,30,30,30
E01000504,EV motorcycles,Number,1,1,3,5,7,9,12,15,17,20,23,26,28,30,32,34,36,37,38,39,39,40,40,40,41,41,41,41,41,41
E01000505,EV motorcycles,Number,0,1,2,3,5,6,8,10,12,14,16,17,19,21,22,23,24,25,26,26,27,27,27,28,28,28,28,28,28,28
E01000506,EV motorcycles,Number,1,3,5,9,13,18,23,28,34,39,45,50,55,59,63,67,70,72,74,76,77,78,78,79,79,79,80,80,80,80
E01000507,EV motorcycles,Number,1,2,3,5,8,10,13,16,19,23,26,29,31,34,36,38,40,41,43,43,44,45,45,45,46,46,46,46,46,46
E01000508,EV motorcycles,Number,1,2,4,6,9,12,16,20,23,27,31,34,38,41,43,46,48,49,51,52,53,53,54,54,54,55,55,55,55,55
E01000509,EV motorcycles,Number,0,1,2,3,4,5,7,8,10,11,13,14,16,17,18,19,20,21,21,22,22,22,23,23,23,23,23,23,23,23
E01000510,EV motorcycles,Number,1,1,2,4,6,8,10,12,15,17,20,22,24,26,28,29,30,31,32,33,34,34,34,34,35,35,35,35,35,35
E01000511,EV motorcycles,Number,1,1,2,4,6,8,10,13,15,18,20,22,25,27,28,30,31,32,33,34,35,35,35,35,36,36,36,36,36,36
E01000512,EV motorcycles,Number,0,1,2,3,5,7,8,10,12,14,16,18,20,21,23,24,25,26,27,27,28,28,28,29,29,29,29,29,29,29
E01000513,EV motorcycles,Number,0,1,1,2,4,5,6,7,9,10,12,13,14,16,17,17,18,19,19,20,20,20,21,21,21,21,21,21,21,21
E01000514,EV motorcycles,Number,0,1,1,2,3,4,5,6,7,8,9,10,11,12,13,13,14,14,15,15,15,16,16,16,16,16,16,16,16,16
E01000515,EV motorcycles,Number,0,1,2,3,5,7,8,10,12,14,16,18,20,21,23,24,25,26,27,27,28,28,28,29,29,29,29,29,29,29
E01000516,EV motorcycles,Number,0,1,2,3,4,5,7,9,10,12,13,15,16,18,19,20,21,22,22,23,23,23,23,24,24,24,24,24,24,24
E01000517,EV motorcycles,Number,0,0,0,1,1,2,2,2,3,3,4,4,5,5,6,6,6,6,6,7,7,7,7,7,7,7,7,7,7,7
E01000518,EV motorcycles,Number,0,1,1,2,3,3,4,5,6,7,8,9,10,11,12,12,13,13,14,14,14,15,15,15,15,15,15,15,15,15
E01000519,EV motorcycles,Number,0,1,1,2,3,4,5,6,7,8,10,11,12,13,13,14,15,15,16,16,16,16,17,17,17,17,17,17,17,17
E01000520,EV motorcycles,Number,0,1,2,3,5,7,9,11,13,15,17,19,21,23,24,26,27,28,29,29,30,30,30,31,31,31,31,31,31,31
E01000521,EV motorcycles,Number,1,2,3,5,7,10,13,16,19,22,25,27,30,33,35,37,38,40,41,42,42,43,43,43,44,44,44,44,44,44
E01000522,EV motorcycles,Number,1,1,3,4,7,9,11,14,16,19,22,24,27,29,31,32,34,35,36,37,37,38,38,38,39,39,39,39,39,39
E01000523,EV motorcycles,Number,1,3,5,8,12,16,21,25,30,35,40,44,49,52,56,59,62,64,66,67,68,69,70,70,70,71,71,71,71,71
E01000524,EV motorcycles,Number,1,3,5,8,13,17,22,27,32,37,42,47,51,55,59,62,65,67,69,71,72,73,73,74,74,74,75,75,75,75
E01000525,EV motorcycles,Number,1,1,2,4,6,8,10,13,15,18,20,22,25,27,28,30,31,32,33,34,35,35,35,35,36,36,36,36,36,36
E01000526,EV motorcycles,Number,0,1,2,3,5,7,8,10,12,14,16,18,20,21,23,24,25,26,27,27,28,28,28,29,29,29,29,29,29,29
E01000527,EV motorcycles,Number,1,2,4,7,10,13,17,21,25,30,34,37,41,44,47,50,52,54,55,57,58,58,59,59,59,60,60,60,60,60
E01000528,EV motorcycles,Number,0,1,2,3,5,7,8,10,12,14,16,18,20,21,23,24,25,26,27,27,28,28,28,29,29,29,29,29,29,29
E01000530,EV motorcycles,Number,1,2,3,5,8,11,14,17,20,23,26,29,32,35,37,39,41,42,43,44,45,46,46,46,47,47,47,47,47,47
E01000531,EV motorcycles,Number,1,2,4,7,10,13,17,21,25,29,33,37,40,44,47,49,51,53,55,56,57,57,58,58,58,59,59,59,59,59
E01000532,EV motorcycles,Number,0,1,1,2,3,4,5,6,8,9,10,11,12,13,14,15,16,16,17,17,17,17,18,18,18,18,18,18,18,18
E01000533,EV motorcycles,Number,1,4,7,11,17,22,29,36,42,49,56,62,68,74,79,83,87,90,92,94,96,97,98,99,99,99,100,100,100,100
E01000534,EV motorcycles,Number,1,2,3,5,8,10,13,16,19,22,25,28,31,33,35,37,39,40,42,42,43,44,44,44,45,45,45,45,45,45
E01000535,EV motorcycles,Number,1,2,3,6,9,12,15,19,22,26,30,33,36,39,42,44,46,48,49,50,51,51,52,52,52,53,53,53,53,53
E01000536,EV motorcycles,Number,0,0,1,1,2,2,3,4,4,5,6,6,7,7,8,8,9,9,9,9,10,10,10,10,10,10,10,10,10,10
E01000538,EV motorcycles,Number,0,0,1,1,2,2,3,4,5,5,6,7,8,8,9,9,10,10,10,10,11,11,11,11,11,11,11,11,11,11
E01000539,EV motorcycles,Number,0,0,0,1,1,2,2,2,3,3,4,4,5,5,6,6,6,6,6,7,7,7,7,7,7,7,7,7,7,7
E01000540,EV motorcycles,Number,0,1,1,2,3,3,4,5,6,7,8,9,10,11,12,12,13,13,14,14,14,15,15,15,15,15,15,15,15,15
E01000541,EV motorcycles,Number,0,1,1,2,3,4,5,6,8,9,10,11,12,13,14,15,16,16,17,17,17,17,18,18,18,18,18,18,18,18
E01000543,EV motorcycles,Number,0,1,1,2,3,4,5,7,8,9,11,12,13,14,15,16,17,17,18,18,18,18,19,19,19,19,19,19,19,19
E01000544,EV motorcycles,Number,0,1,2,3,5,7,9,11,13,15,17,19,21,23,24,26,27,28,29,29,30,30,30,31,31,31,31,31,31,31
E01000545,EV motorcycles,Number,0,1,2,3,4,6,8,9,11,13,15,16,18,19,20,22,23,23,24,25,25,25,25,26,26,26,26,26,26,26
E01000546,EV motorcycles,Number,1,1,2,4,6,8,10,13,15,18,20,22,25,27,28,30,31,32,33,34,35,35,35,35,36,36,36,36,36,36
E01000547,EV motorcycles,Number,0,1,2,3,4,6,7,9,11,12,14,16,17,18,20,21,22,22,23,24,24,24,24,25,25,25,25,25,25,25
E01000548,EV motorcycles,Number,0,1,1,2,3,4,5,7,8,9,11,12,13,14,15,16,17,17,18,18,18,18,19,19,19,19,19,19,19,19
E01000549,EV motorcycles,Number,0,1,1,2,3,4,5,7,8,9,11,12,13,14,15,16,17,17,18,18,18,18,19,19,19,19,19,19,19,19
E01000550,EV motorcycles,Number,0,1,1,2,4,5,6,8,9,11,12,14,15,16,17,18,19,20,20,21,21,21,22,22,22,22,22,22,22,22
E01000551,EV motorcycles,Number,0,1,2,3,4,5,7,9,10,12,13,15,16,18,19,20,21,22,22,23,23,23,23,24,24,24,24,24,24,24
E01000552,EV motorcycles,Number,0,0,1,1,2,2,3,4,4,5,6,6,7,7,8,8,9,9,9,9,10,10,10,10,10,10,10,10,10,10
E01000553,EV motorcycles,Number,1,1,3,4,7,9,11,14,16,19,22,24,27,29,31,32,34,35,36,37,37,38,38,38,39,39,39,39,39,39
E01000554,EV motorcycles,Number,1,1,3,5,7,9,12,15,17,20,23,26,28,30,32,34,36,37,38,39,39,40,40,40,41,41,41,41,41,41
E01000555,EV motorcycles,Number,0,1,2,4,6,7,10,12,14,16,18,21,23,24,26,27,29,30,31,31,32,32,32,33,33,33,33,33,33,33
E01000556,EV motorcycles,Number,1,1,2,4,6,9,11,13,16,19,21,24,26,28,30,32,33,34,35,36,36,37,37,37,38,38,38,38,38,38
E01000557,EV motorcycles,Number,1,2,3,6,9,11,15,18,22,25,29,32,35,38,40,42,44,46,47,48,49,49,50,50,50,51,51,51,51,51
E01000558,EV motorcycles,Number,0,1,1,2,3,4,5,6,7,8,9,10,11,12,13,13,14,14,15,15,15,16,16,16,16,16,16,16,16,16
E01000559,EV motorcycles,Number,1,1,2,4,6,8,10,13,15,18,20,22,25,27,28,30,31,32,33,34,35,35,35,35,36,36,36,36,36,36
E01000560,EV motorcycles,Number,0,1,2,4,6,7,10,12,14,16,18,21,23,24,26,27,29,30,31,31,32,32,32,33,33,33,33,33,33,33
E01000561,EV motorcycles,Number,0,1,1,2,4,5,6,8,9,11,12,14,15,16,17,18,19,20,20,21,21,21,22,22,22,22,22,22,22,22
E01000562,EV motorcycles,Number,0,0,1,1,2,2,3,3,4,4,5,6,6,7,7,7,8,8,8,8,9,9,9,9,9,9,9,9,9,9
E01000563,EV motorcycles,Number,0,1,1,2,3,4,5,7,8,9,11,12,13,14,15,16,17,17,18,18,18,18,19,19,19,19,19,19,19,19
E01000564,EV motorcycles,Number,0,1,2,4,6,7,10,12,14,16,18,21,23,24,26,27,29,30,31,31,32,32,32,33,33,33,33,33,33,33
E01000565,EV motorcycles,Number,0,1,1,2,3,3,4,5,6,7,8,9,10,11,12,12,13,13,14,14,14,15,15,15,15,15,15,15,15,15
E01000566,EV motorcycles,Number,0,1,2,4,6,7,10,12,14,16,18,21,23,24,26,27,29,30,31,31,32,32,32,33,33,33,33,33,33,33
E01000567,EV motorcycles,Number,0,1,1,2,3,3,4,5,6,7,8,9,10,11,12,12,13,13,14,14,14,15,15,15,15,15,15,15,15,15
E01000568,EV motorcycles,Number,0,1,1,2,3,4,5,6,8,9,10,11,12,13,14,15,16,16,17,17,17,17,18,18,18,18,18,18,18,18
E01000569,EV motorcycles,Number,0,1,2,3,4,5,7,8,10,11,13,14,16,17,18,19,20,21,21,22,22,22,23,23,23,23,23,23,23,23
E01000570,EV motorcycles,Number,0,1,2,3,5,6,8,10,11,13,15,17,18,20,21,22,23,24,25,25,26,26,26,27,27,27,27,27,27,27
E01000571,EV motorcycles,Number,0,1,2,3,5,7,9,11,13,15,17,19,21,23,24,26,27,28,29,29,30,30,30,31,31,31,31,31,31,31
E01000572,EV motorcycles,Number,0,0,1,1,2,2,3,3,4,4,5,6,6,7,7,7,8,8,8,8,9,9,9,9,9,9,9,9,9,9
E01000573,EV motorcycles,Number,0,1,1,2,3,4,6,7,8,10,11,12,14,15,16,17,17,18,18,19,19,19,20,20,20,20,20,20,20,20
E01000574,EV motorcycles,Number,0,1,2,3,5,6,8,10,12,14,16,17,19,21,22,23,24,25,26,26,27,27,27,28,28,28,28,28,28,28
E01000575,EV motorcycles,Number,0,1,1,2,3,4,5,6,7,8,10,11,12,13,13,14,15,15,16,16,16,16,17,17,17,17,17,17,17,17
E01000576,EV motorcycles,Number,0,1,1,2,4,5,6,7,9,10,12,13,14,16,17,17,18,19,19,20,20,20,21,21,21,21,21,21,21,21
E01000577,EV motorcycles,Number,1,3,6,10,15,20,25,31,37,43,49,55,60,65,69,73,76,79,81,83,84,85,86,87,87,87,88,88,88,88
E01000578,EV motorcycles,Number,1,1,2,4,6,8,10,13,15,18,20,22,25,27,28,30,31,32,33,34,35,35,35,35,36,36,36,36,36,36
E01000579,EV motorcycles,Number,0,1,2,3,5,6,8,10,11,13,15,17,18,20,21,22,23,24,25,25,26,26,26,27,27,27,27,27,27,27
E01000580,EV motorcycles,Number,0,1,2,4,6,7,10,12,14,16,18,21,23,24,26,27,29,30,31,31,32,32,32,33,33,33,33,33,33,33
E01000581,EV motorcycles,Number,0,1,2,4,6,7,10,12,14,16,18,21,23,24,26,27,29,30,31,31,32,32,32,33,33,33,33,33,33,33
E01000582,EV motorcycles,Number,1,1,2,4,6,9,11,13,16,19,21,24,26,28,30,32,33,34,35,36,36,37,37,37,38,38,38,38,38,38
E01000583,EV motorcycles,Number,0,1,2,4,6,8,10,12,14,17,19,21,23,25,27,28,30,31,31,32,33,33,33,33,34,34,34,34,34,34
E01000584,EV motorcycles,Number,1,1,3,5,7,9,12,15,17,20,23,26,28,30,32,34,36,37,38,39,39,40,40,40,41,41,41,41,41,41
E01000585,EV motorcycles,Number,0,1,2,3,5,7,9,11,13,15,17,19,21,23,24,26,27,28,29,29,30,30,30,31,31,31,31,31,31,31
E01000586,EV motorcycles,Number,1,3,5,8,12,16,21,25,30,35,40,44,49,52,56,59,62,64,66,67,68,69,70,70,70,71,71,71,71,71
E01000587,EV motorcycles,Number,0,1,1,2,3,4,5,7,8,9,11,12,13,14,15,16,17,17,18,18,18,18,19,19,19,19,19,19,19,19
E01000588,EV motorcycles,Number,1,2,3,5,8,11,14,17,20,23,26,29,32,35,37,39,41,42,43,44,45,46,46,46,47,47,47,47,47,47
E01000589,EV motorcycles,Number,0,1,2,3,4,6,7,9,11,12,14,16,17,18,20,21,22,22,23,24,24,24,24,25,25,25,25,25,25,25
E01000590,EV motorcycles,Number,0,1,1,2,4,5,6,8,9,11,12,14,15,16,17,18,19,20,20,21,21,21,22,22,22,22,22,22,22,22
E01000591,EV motorcycles,Number,0,1,2,3,4,5,7,9,10,12,13,15,16,18,19,20,21,22,22,23,23,23,23,24,24,24,24,24,24,24
E01000592,EV motorcycles,Number,0,1,1,2,3,4,5,6,8,9,10,11,12,13,14,15,16,16,17,17,17,17,18,18,18,18,18,18,18,18
E01000593,EV motorcycles,Number,0,1,1,2,3,4,5,7,8,9,11,12,13,14,15,16,17,17,18,18,18,18,19,19,19,19,19,19,19,19
E01000594,EV motorcycles,Number,0,0,1,1,2,2,3,4,4,5,6,6,7,7,8,8,9,9,9,9,10,10,10,10,10,10,10,10,10,10
E01000595,EV motorcycles,Number,0,1,2,3,5,6,8,10,12,14,16,17,19,21,22,23,24,25,26,26,27,27,27,28,28,28,28,28,28,28
E01000596,EV motorcycles,Number,0,1,1,2,3,4,6,7,8,10,11,12,14,15,16,17,17,18,18,19,19,19,20,20,20,20,20,20,20,20
E01000599,EV motorcycles,Number,0,1,1,2,4,5,6,8,9,11,12,14,15,16,17,18,19,20,20,21,21,21,22,22,22,22,22,22,22,22
E01000600,EV motorcycles,Number,4,10,18,30,46,61,79,97,115,134,153,170,187,202,215,227,237,245,252,258,262,265,267,269,270,271,273,273,273,273
E01000601,EV motorcycles,Number,0,1,1,2,4,5,6,7,9,10,12,13,14,16,17,17,18,19,19,20,20,20,21,21,21,21,21,21,21,21
E01000602,EV motorcycles,Number,0,1,2,3,5,6,8,10,11,13,15,17,18,20,21,22,23,24,25,25,26,26,26,27,27,27,27,27,27,27
E01000603,EV motorcycles,Number,0,1,2,3,5,7,9,11,13,15,17,19,21,22,24,25,26,27,28,28,29,29,29,30,30,30,30,30,30,30
E01000604,EV motorcycles,Number,0,1,2,3,5,6,8,10,11,13,15,17,18,20,21,22,23,24,25,25,26,26,26,27,27,27,27,27,27,27
E01000605,EV motorcycles,Number,0,0,1,1,2,2,3,4,5,5,6,7,8,8,9,9,10,10,10,10,11,11,11,11,11,11,11,11,11,11
E01000606,EV motorcycles,Number,0,1,2,3,4,6,7,9,11,12,14,16,17,18,20,21,22,22,23,24,24,24,24,25,25,25,25,25,25,25
E01000607,EV motorcycles,Number,1,2,4,6,10,13,17,21,25,29,32,36,40,43,46,48,50,52,54,55,56,56,57,57,57,58,58,58,58,58
E01000608,EV motorcycles,Number,1,2,4,7,11,15,19,23,27,32,36,40,44,48,51,54,56,58,60,61,62,63,64,64,64,65,65,65,65,65
E01000609,EV motorcycles,Number,0,1,2,3,4,5,7,9,10,12,13,15,16,18,19,20,21,22,22,23,23,23,23,24,24,24,24,24,24,24
E01000610,EV motorcycles,Number,1,2,3,5,8,10,13,16,19,22,25,28,31,33,35,37,39,40,42,42,43,44,44,44,45,45,45,45,45,45
E01000611,EV motorcycles,Number,1,1,2,4,6,8,10,13,15,18,20,22,25,27,28,30,31,32,33,34,35,35,35,35,36,36,36,36,36,36
E01000612,EV motorcycles,Number,1,3,5,8,12,16,21,26,30,35,40,45,49,53,57,60,63,65,67,68,69,70,70,71,71,71,72,72,72,72
E01000613,EV motorcycles,Number,0,1,2,3,4,5,7,8,10,11,13,14,16,17,18,19,20,21,21,22,22,22,23,23,23,23,23,23,23,23
E01000615,EV motorcycles,Number,0,1,1,2,4,5,6,7,9,10,12,13,14,16,17,17,18,19,19,20,20,20,21,21,21,21,21,21,21,21
E01000616,EV motorcycles,Number,0,1,2,3,4,5,7,8,10,11,13,14,16,17,18,19,20,21,21,22,22,22,23,23,23,23,23,23,23,23
E01000617,EV motorcycles,Number,1,2,3,5,8,10,13,16,19,23,26,29,31,34,36,38,40,41,43,43,44,45,45,45,46,46,46,46,46,46
E01000618,EV motorcycles,Number,0,1,2,3,5,7,9,11,13,15,17,19,21,22,24,25,26,27,28,28,29,29,29,30,30,30,30,30,30,30
E01000619,EV motorcycles,Number,0,1,2,4,5,7,9,11,14,16,18,20,22,24,25,27,28,29,30,30,31,31,31,32,32,32,32,32,32,32
E01000620,EV motorcycles,Number,1,1,3,5,7,9,12,15,17,20,23,26,28,30,32,34,36,37,38,39,39,40,40,40,41,41,41,41,41,41
E01000621,EV motorcycles,Number,0,1,2,4,6,8,10,12,14,17,19,21,23,25,27,28,30,31,31,32,33,33,33,33,34,34,34,34,34,34
E01000622,EV motorcycles,Number,1,1,3,5,7,9,12,15,17,20,23,26,28,30,32,34,36,37,38,39,39,40,40,40,41,41,41,41,41,41
E01000623,EV motorcycles,Number,0,1,2,3,4,5,7,9,10,12,13,15,16,18,19,20,21,22,22,23,23,23,23,24,24,24,24,24,24,24
E01000624,EV motorcycles,Number,0,1,2,3,4,6,8,9,11,13,15,16,18,19,20,22,23,23,24,25,25,25,25,26,26,26,26,26,26,26
E01000625,EV motorcycles,Number,0,1,2,3,5,7,9,11,13,15,17,19,21,22,24,25,26,27,28,28,29,29,29,30,30,30,30,30,30,30
E01000626,EV motorcycles,Number,0,1,2,3,5,6,8,10,12,14,16,17,19,21,22,23,24,25,26,26,27,27,27,28,28,28,28,28,28,28
E01000627,EV motorcycles,Number,1,2,4,7,10,13,17,21,25,30,34,37,41,44,47,50,52,54,55,57,58,58,59,59,59,60,60,60,60,60
E01000628,EV motorcycles,Number,1,1,2,4,6,8,10,12,15,17,20,22,24,26,28,29,30,31,32,33,34,34,34,34,35,35,35,35,35,35
E01000629,EV motorcycles,Number,0,1,2,3,4,6,8,9,11,13,15,16,18,19,20,22,23,23,24,25,25,25,25,26,26,26,26,26,26,26
E01000630,EV motorcycles,Number,0,1,2,3,4,5,7,8,10,11,13,14,16,17,18,19,20,21,21,22,22,22,23,23,23,23,23,23,23,23
E01000631,EV motorcycles,Number,0,1,2,3,5,7,9,11,13,15,17,19,21,23,24,26,27,28,29,29,30,30,30,31,31,31,31,31,31,31
E01000632,EV motorcycles,Number,0,1,2,3,5,7,8,10,12,14,16,18,20,21,23,24,25,26,27,27,28,28,28,29,29,29,29,29,29,29
E01000633,EV motorcycles,Number,0,1,2,3,5,7,9,11,13,15,17,19,21,22,24,25,26,27,28,28,29,29,29,30,30,30,30,30,30,30
E01000634,EV motorcycles,Number,0,1,2,3,5,7,8,10,12,14,16,18,20,21,23,24,25,26,27,27,28,28,28,29,29,29,29,29,29,29
E01000635,EV motorcycles,Number,0,1,2,4,6,8,10,12,14,17,19,21,23,25,27,28,30,31,31,32,33,33,33,33,34,34,34,34,34,34
E01000636,EV motorcycles,Number,1,2,3,6,8,11,14,18,21,25,28,31,34,37,39,42,43,45,46,47,48,49,49,49,49,50,50,50,50,50
E01000637,EV motorcycles,Number,0,1,2,3,5,7,9,11,13,15,17,19,21,22,24,25,26,27,28,28,29,29,29,30,30,30,30,30,30,30
E01000638,EV motorcycles,Number,1,2,3,6,9,11,15,18,22,25,29,32,35,38,40,42,44,46,47,48,49,49,50,50,50,51,51,51,51,51
E01000639,EV motorcycles,Number,1,2,3,5,8,11,14,17,20,23,26,29,32,35,37,39,41,42,43,44,45,46,46,46,47,47,47,47,47,47
E01000640,EV motorcycles,Number,1,2,4,7,11,14,18,22,27,31,35,39,43,47,50,52,55,57,58,59,60,61,62,62,62,63,63,63,63,63
E01000641,EV motorcycles,Number,1,2,3,5,8,10,13,16,19,22,25,28,31,33,35,37,39,40,42,42,43,44,44,44,45,45,45,45,45,45
E01000642,EV motorcycles,Number,1,2,4,6,9,12,16,20,23,27,31,34,38,41,43,46,48,49,51,52,53,53,54,54,54,55,55,55,55,55
E01000643,EV motorcycles,Number,1,1,2,4,6,8,10,13,15,18,20,22,25,27,28,30,31,32,33,34,35,35,35,35,36,36,36,36,36,36
E01000644,EV motorcycles,Number,1,1,2,4,6,8,10,12,15,17,20,22,24,26,28,29,30,31,32,33,34,34,34,34,35,35,35,35,35,35
E01000645,EV motorcycles,Number,0,1,2,3,4,6,7,9,11,12,14,16,17,18,20,21,22,22,23,24,24,24,24,25,25,25,25,25,25,25
E01000646,EV motorcycles,Number,0,1,2,3,5,7,8,10,12,14,16,18,20,21,23,24,25,26,27,27,28,28,28,29,29,29,29,29,29,29
E01000647,EV motorcycles,Number,0,0,1,1,2,2,3,4,4,5,6,6,7,7,8,8,9,9,9,9,10,10,10,10,10,10,10,10,10,10
E01000648,EV motorcycles,Number,0,1,2,3,4,5,7,9,10,12,13,15,16,18,19,20,21,22,22,23,23,23,23,24,24,24,24,24,24,24
E01000649,EV motorcycles,Number,0,1,2,4,5,7,9,11,14,16,18,20,22,24,25,27,28,29,30,30,31,31,31,32,32,32,32,32,32,32
E01000650,EV motorcycles,Number,0,1,1,2,4,5,6,8,9,11,12,14,15,16,17,18,19,20,20,21,21,21,22,22,22,22,22,22,22,22
E01000651,EV motorcycles,Number,0,1,1,2,2,3,4,5,6,7,8,9,10,10,11,12,12,13,13,13,13,14,14,14,14,14,14,14,14,14
E01000652,EV motorcycles,Number,0,1,1,2,3,4,5,6,7,8,9,10,11,12,13,13,14,14,15,15,15,16,16,16,16,16,16,16,16,16
E01000653,EV motorcycles,Number,0,1,2,3,5,6,8,10,12,14,16,17,19,21,22,23,24,25,26,26,27,27,27,28,28,28,28,28,28,28
E01000654,EV motorcycles,Number,1,2,3,5,8,11,14,17,20,24,27,30,33,35,38,40,42,43,44,45,46,47,47,47,48,48,48,48,48,48
E01000655,EV motorcycles,Number,1,2,3,5,8,10,13,16,19,22,25,28,31,33,35,37,39,40,42,42,43,44,44,44,45,45,45,45,45,45
E01000656,EV motorcycles,Number,1,2,4,7,11,15,19,23,28,32,37,41,45,49,52,55,57,59,61,62,63,64,65,65,65,66,66,66,66,66
E01000657,EV motorcycles,Number,1,2,3,5,8,10,13,16,19,23,26,29,31,34,36,38,40,41,43,43,44,45,45,45,46,46,46,46,46,46
E01000658,EV motorcycles,Number,1,2,4,7,10,14,18,22,26,30,35,39,42,46,49,52,54,56,57,59,59,60,61,61,61,62,62,62,62,62
E01000659,EV motorcycles,Number,1,2,3,5,7,10,13,16,19,22,25,27,30,33,35,37,38,40,41,42,42,43,43,43,44,44,44,44,44,44
E01000661,EV motorcycles,Number,1,1,2,4,6,9,11,13,16,19,21,24,26,28,30,32,33,34,35,36,36,37,37,37,38,38,38,38,38,38
E01000662,EV motorcycles,Number,1,1,2,4,6,9,11,13,16,19,21,24,26,28,30,32,33,34,35,36,36,37,37,37,38,38,38,38,38,38
E01000663,EV motorcycles,Number,1,1,2,4,6,8,10,13,15,18,20,22,25,27,28,30,31,32,33,34,35,35,35,35,36,36,36,36,36,36
E01000664,EV motorcycles,Number,0,1,2,3,4,5,7,8,10,11,13,14,16,17,18,19,20,21,21,22,22,22,23,23,23,23,23,23,23,23
E01000665,EV motorcycles,Number,0,1,2,3,5,7,9,11,13,15,17,19,21,23,24,26,27,28,29,29,30,30,30,31,31,31,31,31,31,31
E01000666,EV motorcycles,Number,1,2,3,6,9,12,15,18,22,26,29,32,36,38,41,43,45,47,48,49,50,50,51,51,51,52,52,52,52,52
E01000667,EV motorcycles,Number,0,1,2,3,5,7,9,11,13,15,17,19,21,23,24,26,27,28,29,29,30,30,30,31,31,31,31,31,31,31
E01000668,EV motorcycles,Number,0,1,2,4,6,8,10,12,14,17,19,21,23,25,27,28,30,31,31,32,33,33,33,33,34,34,34,34,34,34
E01000669,EV motorcycles,Number,1,2,3,5,8,11,14,17,20,24,27,30,33,35,38,40,42,43,44,45,46,47,47,47,48,48,48,48,48,48
E01000670,EV motorcycles,Number,0,1,2,3,4,6,8,9,11,13,15,16,18,19,20,22,23,23,24,25,25,25,25,26,26,26,26,26,26,26
E01000671,EV motorcycles,Number,1,2,3,5,7,10,13,16,19,22,25,27,30,33,35,37,38,40,41,42,42,43,43,43,44,44,44,44,44,44
E01000672,EV motorcycles,Number,0,1,2,4,6,7,10,12,14,16,18,21,23,24,26,27,29,30,31,31,32,32,32,33,33,33,33,33,33,33
E01000673,EV motorcycles,Number,0,1,1,2,4,5,6,8,9,11,12,14,15,16,17,18,19,20,20,21,21,21,22,22,22,22,22,22,22,22
E01000674,EV motorcycles,Number,0,1,2,3,5,6,8,10,11,13,15,17,18,20,21,22,23,24,25,25,26,26,26,27,27,27,27,27,27,27
E01000675,EV motorcycles,Number,1,2,4,7,11,15,19,24,28,33,37,42,46,50,53,56,58,60,62,63,64,65,66,66,66,67,67,67,67,67
E01000676,EV motorcycles,Number,1,1,3,4,7,9,11,14,16,19,22,24,27,29,31,32,34,35,36,37,37,38,38,38,39,39,39,39,39,39
E01000677,EV motorcycles,Number,0,1,1,2,4,5,6,7,9,10,12,13,14,16,17,17,18,19,19,20,20,20,21,21,21,21,21,21,21,21
E01000678,EV motorcycles,Number,0,1,1,2,3,4,5,6,8,9,10,11,12,13,14,15,16,16,17,17,17,17,18,18,18,18,18,18,18,18
E01000679,EV motorcycles,Number,0,1,2,3,5,7,8,10,12,14,16,18,20,21,23,24,25,26,27,27,28,28,28,29,29,29,29,29,29,29
E01000680,EV motorcycles,Number,1,2,4,7,10,13,17,21,25,29,33,37,40,44,47,49,51,53,55,56,57,57,58,58,58,59,59,59,59,59
E01000681,EV motorcycles,Number,0,1,1,2,4,5,6,8,9,11,12,14,15,16,17,18,19,20,20,21,21,21,22,22,22,22,22,22,22,22
E01000682,EV motorcycles,Number,0,0,1,1,2,3,4,5,5,6,7,8,9,10,10,11,11,12,12,12,12,13,13,13,13,13,13,13,13,13
E01000683,EV motorcycles,Number,0,1,2,4,6,8,10,12,14,17,19,21,23,25,27,28,30,31,31,32,33,33,33,33,34,34,34,34,34,34
E01000684,EV motorcycles,Number,0,1,2,3,4,6,7,9,11,12,14,16,17,18,20,21,22,22,23,24,24,24,24,25,25,25,25,25,25,25
E01000685,EV motorcycles,Number,0,1,2,3,4,5,7,9,10,12,13,15,16,18,19,20,21,22,22,23,23,23,23,24,24,24,24,24,24,24
E01000686,EV motorcycles,Number,0,1,2,3,5,7,8,10,12,14,16,18,20,21,23,24,25,26,27,27,28,28,28,29,29,29,29,29,29,29
E01000687,EV motorcycles,Number,0,1,2,3,5,7,9,11,13,15,17,19,21,22,24,25,26,27,28,28,29,29,29,30,30,30,30,30,30,30
E01000688,EV motorcycles,Number,0,1,1,2,3,4,5,6,7,8,9,10,11,12,13,13,14,14,15,15,15,16,16,16,16,16,16,16,16,16
E01000689,EV motorcycles,Number,0,1,1,2,4,5,6,7,9,10,12,13,14,16,17,17,18,19,19,20,20,20,21,21,21,21,21,21,21,21
E01000690,EV motorcycles,Number,0,1,2,3,4,6,8,9,11,13,15,16,18,19,20,22,23,23,24,25,25,25,25,26,26,26,26,26,26,26
E01000691,EV motorcycles,Number,0,1,2,4,6,7,10,12,14,16,18,21,23,24,26,27,29,30,31,31,32,32,32,33,33,33,33,33,33,33
E01000692,EV motorcycles,Number,0,1,2,3,5,6,8,10,11,13,15,17,18,20,21,22,23,24,25,25,26,26,26,27,27,27,27,27,27,27
E01000693,EV motorcycles,Number,0,1,1,2,3,4,5,6,7,8,10,11,12,13,13,14,15,15,16,16,16,16,17,17,17,17,17,17,17,17
E01000694,EV motorcycles,Number,0,1,1,2,4,5,6,7,9,10,12,13,14,16,17,17,18,19,19,20,20,20,21,21,21,21,21,21,21,21
E01000695,EV motorcycles,Number,1,1,2,4,6,8,10,12,15,17,20,22,24,26,28,29,30,31,32,33,34,34,34,34,35,35,35,35,35,35
E01000696,EV motorcycles,Number,0,1,1,2,3,4,5,6,7,8,10,11,12,13,13,14,15,15,16,16,16,16,17,17,17,17,17,17,17,17
E01000697,EV motorcycles,Number,0,1,1,2,4,5,6,7,9,10,12,13,14,16,17,17,18,19,19,20,20,20,21,21,21,21,21,21,21,21
E01000698,EV motorcycles,Number,0,1,1,2,4,5,6,8,9,11,12,14,15,16,17,18,19,20,20,21,21,21,22,22,22,22,22,22,22,22
E01000699,EV motorcycles,Number,0,1,1,2,4,5,6,7,9,10,12,13,14,16,17,17,18,19,19,20,20,20,21,21,21,21,21,21,21,21
E01000700,EV motorcycles,Number,0,1,1,2,2,3,4,5,6,7,8,9,10,10,11,12,12,13,13,13,13,14,14,14,14,14,14,14,14,14
E01000701,EV motorcycles,Number,0,1,1,2,3,3,4,5,6,7,8,9,10,11,12,12,13,13,14,14,14,15,15,15,15,15,15,15,15,15
E01000702,EV motorcycles,Number,0,1,1,2,3,4,5,6,8,9,10,11,12,13,14,15,16,16,17,17,17,17,18,18,18,18,18,18,18,18
E01000703,EV motorcycles,Number,0,1,1,2,4,5,6,8,9,11,12,14,15,16,17,18,19,20,20,21,21,21,22,22,22,22,22,22,22,22
E01000704,EV motorcycles,Number,0,1,2,3,4,5,7,9,10,12,13,15,16,18,19,20,21,22,22,23,23,23,23,24,24,24,24,24,24,24
E01000705,EV motorcycles,Number,0,1,1,2,3,4,6,7,8,10,11,12,14,15,16,17,17,18,18,19,19,19,20,20,20,20,20,20,20,20
E01000706,EV motorcycles,Number,0,1,1,2,3,4,5,7,8,9,11,12,13,14,15,16,17,17,18,18,18,18,19,19,19,19,19,19,19,19
E01000707,EV motorcycles,Number,0,1,2,3,4,5,7,8,10,11,13,14,16,17,18,19,20,21,21,22,22,22,23,23,23,23,23,23,23,23
E01000708,EV motorcycles,Number,0,1,1,2,4,5,6,8,9,11,12,14,15,16,17,18,19,20,20,21,21,21,22,22,22,22,22,22,22,22
E01000709,EV motorcycles,Number,0,1,2,4,6,8,10,12,14,17,19,21,23,25,27,28,30,31,31,32,33,33,33,33,34,34,34,34,34,34
E01000710,EV motorcycles,Number,1,2,4,6,9,12,16,19,23,27,30,34,37,40,43,45,47,49,50,51,52,52,53,53,53,54,54,54,54,54
E01000711,EV motorcycles,Number,0,1,2,3,5,7,9,11,13,15,17,19,21,22,24,25,26,27,28,28,29,29,29,30,30,30,30,30,30,30
E01000712,EV motorcycles,Number,0,1,2,3,5,6,8,10,11,13,15,17,18,20,21,22,23,24,25,25,26,26,26,27,27,27,27,27,27,27
E01000713,EV motorcycles,Number,0,1,2,4,6,8,10,12,14,17,19,21,23,25,27,28,30,31,31,32,33,33,33,33,34,34,34,34,34,34
E01000714,EV motorcycles,Number,0,1,2,4,6,8,10,12,14,17,19,21,23,25,27,28,30,31,31,32,33,33,33,33,34,34,34,34,34,34
E01000715,EV motorcycles,Number,0,1,1,2,3,4,6,7,8,10,11,12,14,15,16,17,17,18,18,19,19,19,20,20,20,20,20,20,20,20
E01000716,EV motorcycles,Number,1,1,3,4,7,9,12,14,17,20,22,25,27,30,32,33,35,36,37,38,38,39,39,39,40,40,40,40,40,40
E01000717,EV motorcycles,Number,0,1,2,4,6,7,10,12,14,16,18,21,23,24,26,27,29,30,31,31,32,32,32,33,33,33,33,33,33,33
E01000718,EV motorcycles,Number,0,1,2,3,5,7,8,10,12,14,16,18,20,21,23,24,25,26,27,27,28,28,28,29,29,29,29,29,29,29
E01000719,EV motorcycles,Number,0,1,1,2,3,4,6,7,8,10,11,12,14,15,16,17,17,18,18,19,19,19,20,20,20,20,20,20,20,20
E01000720,EV motorcycles,Number,0,1,2,4,5,7,9,11,14,16,18,20,22,24,25,27,28,29,30,30,31,31,31,32,32,32,32,32,32,32
E01000721,EV motorcycles,Number,0,0,1,1,2,2,3,4,5,5,6,7,8,8,9,9,10,10,10,10,11,11,11,11,11,11,11,11,11,11
E01000722,EV motorcycles,Number,1,2,3,5,7,10,12,15,18,21,24,27,29,32,34,36,37,39,40,41,41,42,42,42,43,43,43,43,43,43
E01000723,EV motorcycles,Number,0,1,1,2,3,4,6,7,8,10,11,12,14,15,16,17,17,18,18,19,19,19,20,20,20,20,20,20,20,20
E01000724,EV motorcycles,Number,0,1,2,3,4,5,7,8,10,11,13,14,16,17,18,19,20,21,21,22,22,22,23,23,23,23,23,23,23,23
E01000725,EV motorcycles,Number,0,1,2,3,5,7,8,10,12,14,16,18,20,21,23,24,25,26,27,27,28,28,28,29,29,29,29,29,29,29
E01000726,EV motorcycles,Number,0,1,2,3,4,6,8,9,11,13,15,16,18,19,20,22,23,23,24,25,25,25,25,26,26,26,26,26,26,26
E01000727,EV motorcycles,Number,1,1,2,4,6,8,10,12,15,17,20,22,24,26,28,29,30,31,32,33,34,34,34,34,35,35,35,35,35,35
E01000728,EV motorcycles,Number,0,1,2,3,5,6,8,10,12,14,16,17,19,21,22,23,24,25,26,26,27,27,27,28,28,28,28,28,28,28
E01000729,EV motorcycles,Number,0,1,2,4,6,8,10,12,14,17,19,21,23,25,27,28,30,31,31,32,33,33,33,33,34,34,34,34,34,34
E01000730,EV motorcycles,Number,0,1,1,2,4,5,6,8,9,11,12,14,15,16,17,18,19,20,20,21,21,21,22,22,22,22,22,22,22,22
E01000731,EV motorcycles,Number,0,1,2,3,5,7,9,11,13,15,17,19,21,22,24,25,26,27,28,28,29,29,29,30,30,30,30,30,30,30
E01000732,EV motorcycles,Number,0,1,2,3,5,6,8,10,11,13,15,17,18,20,21,22,23,24,25,25,26,26,26,27,27,27,27,27,27,27
E01000733,EV motorcycles,Number,1,1,3,5,7,9,12,15,17,20,23,26,28,30,32,34,36,37,38,39,39,40,40,40,41,41,41,41,41,41
E01000734,EV motorcycles,Number,0,1,1,2,3,3,4,5,6,7,8,9,10,11,12,12,13,13,14,14,14,15,15,15,15,15,15,15,15,15
E01000735,EV motorcycles,Number,0,1,2,3,5,7,8,10,12,14,16,18,20,21,23,24,25,26,27,27,28,28,28,29,29,29,29,29,29,29
E01000736,EV motorcycles,Number,0,1,2,4,5,7,9,11,14,16,18,20,22,24,25,27,28,29,30,30,31,31,31,32,32,32,32,32,32,32
E01000737,EV motorcycles,Number,0,1,1,2,4,5,6,7,9,10,12,13,14,16,17,17,18,19,19,20,20,20,21,21,21,21,21,21,21,21
E01000738,EV motorcycles,Number,1,1,3,4,7,9,11,14,16,19,22,24,27,29,31,32,34,35,36,37,37,38,38,38,39,39,39,39,39,39
E01000739,EV motorcycles,Number,0,1,1,2,4,5,6,8,9,11,12,14,15,16,17,18,19,20,20,21,21,21,22,22,22,22,22,22,22,22
E01000740,EV motorcycles,Number,0,1,2,3,5,7,9,11,13,15,17,19,21,22,24,25,26,27,28,28,29,29,29,30,30,30,30,30,30,30
E01000741,EV motorcycles,Number,0,1,2,3,4,6,7,9,11,12,14,16,17,18,20,21,22,22,23,24,24,24,24,25,25,25,25,25,25,25
E01000742,EV motorcycles,Number,1,1,2,4,6,8,10,13,15,18,20,22,25,27,28,30,31,32,33,34,35,35,35,35,36,36,36,36,36,36
E01000743,EV motorcycles,Number,0,1,2,4,5,7,9,11,14,16,18,20,22,24,25,27,28,29,30,30,31,31,31,32,32,32,32,32,32,32
E01000744,EV motorcycles,Number,0,1,1,2,3,4,5,6,7,8,9,10,11,12,13,13,14,14,15,15,15,16,16,16,16,16,16,16,16,16
E01000745,EV motorcycles,Number,1,2,3,5,7,9,12,15,18,21,24,26,29,31,33,35,36,38,39,40,40,41,41,41,42,42,42,42,42,42
E01000746,EV motorcycles,Number,1,1,3,4,7,9,11,14,16,19,22,24,27,29,31,32,34,35,36,37,37,38,38,38,39,39,39,39,39,39
E01000747,EV motorcycles,Number,1,3,5,9,13,18,23,28,33,38,44,49,53,58,61,65,68,70,72,74,75,76,76,77,77,77,78,78,78,78
E01000748,EV motorcycles,Number,1,3,5,9,14,18,24,29,35,40,46,51,56,61,65,68,71,74,76,77,79,80,80,81,81,81,82,82,82,82
E01000749,EV motorcycles,Number,1,1,2,4,6,9,11,13,16,19,21,24,26,28,30,32,33,34,35,36,36,37,37,37,38,38,38,38,38,38
E01000750,EV motorcycles,Number,0,1,2,3,5,6,8,10,11,13,15,17,18,20,21,22,23,24,25,25,26,26,26,27,27,27,27,27,27,27
E01000751,EV motorcycles,Number,0,1,1,2,4,5,6,7,9,10,12,13,14,16,17,17,18,19,19,20,20,20,21,21,21,21,21,21,21,21
E01000752,EV motorcycles,Number,0,1,2,4,6,7,10,12,14,16,18,21,23,24,26,27,29,30,31,31,32,32,32,33,33,33,33,33,33,33
E01000753,EV motorcycles,Number,0,1,2,3,4,6,8,9,11,13,15,16,18,19,20,22,23,23,24,25,25,25,25,26,26,26,26,26,26,26
E01000754,EV motorcycles,Number,0,1,1,2,3,4,5,6,7,8,10,11,12,13,13,14,15,15,16,16,16,16,17,17,17,17,17,17,17,17
E01000755,EV motorcycles,Number,0,1,2,3,4,5,7,9,10,12,13,15,16,18,19,20,21,22,22,23,23,23,23,24,24,24,24,24,24,24
E01000756,EV motorcycles,Number,0,1,2,3,4,6,8,9,11,13,15,16,18,19,20,22,23,23,24,25,25,25,25,26,26,26,26,26,26,26
E01000757,EV motorcycles,Number,0,1,2,4,5,7,9,11,14,16,18,20,22,24,25,27,28,29,30,30,31,31,31,32,32,32,32,32,32,32
E01000758,EV motorcycles,Number,0,1,1,2,3,4,5,6,8,9,10,11,12,13,14,15,16,16,17,17,17,17,18,18,18,18,18,18,18,18
E01000759,EV motorcycles,Number,1,1,2,4,6,8,10,12,15,17,20,22,24,26,28,29,30,31,32,33,34,34,34,34,35,35,35,35,35,35
E01000760,EV motorcycles,Number,1,1,2,4,6,8,10,12,15,17,20,22,24,26,28,29,30,31,32,33,34,34,34,34,35,35,35,35,35,35
E01000761,EV motorcycles,Number,1,1,2,4,6,9,11,13,16,19,21,24,26,28,30,32,33,34,35,36,36,37,37,37,38,38,38,38,38,38
E01000762,EV motorcycles,Number,0,1,2,3,5,7,9,11,13,15,17,19,21,22,24,25,26,27,28,28,29,29,29,30,30,30,30,30,30,30
E01000763,EV motorcycles,Number,1,1,2,4,6,8,10,13,15,18,20,22,25,27,28,30,31,32,33,34,35,35,35,35,36,36,36,36,36,36
E01000764,EV motorcycles,Number,0,1,2,3,5,7,9,11,13,15,17,19,21,22,24,25,26,27,28,28,29,29,29,30,30,30,30,30,30,30
E01000765,EV motorcycles,Number,0,1,2,3,5,7,9,11,13,15,17,19,21,22,24,25,26,27,28,28,29,29,29,30,30,30,30,30,30,30
E01000766,EV motorcycles,Number,0,1,2,3,5,7,9,11,13,15,17,19,21,23,24,26,27,28,29,29,30,30,30,31,31,31,31,31,31,31
E01000767,EV motorcycles,Number,0,1,2,4,6,8,10,12,14,17,19,21,23,25,27,28,30,31,31,32,33,33,33,33,34,34,34,34,34,34
E01000768,EV motorcycles,Number,1,2,3,5,7,9,12,15,18,21,24,26,29,31,33,35,36,38,39,40,40,41,41,41,42,42,42,42,42,42
E01000769,EV motorcycles,Number,0,1,2,3,5,6,8,10,12,14,16,17,19,21,22,23,24,25,26,26,27,27,27,28,28,28,28,28,28,28
E01000770,EV motorcycles,Number,0,1,1,2,2,3,4,5,6,7,8,9,10,10,11,12,12,13,13,13,13,14,14,14,14,14,14,14,14,14
E01000771,EV motorcycles,Number,0,1,2,3,4,5,7,9,10,12,13,15,16,18,19,20,21,22,22,23,23,23,23,24,24,24,24,24,24,24
E01000772,EV motorcycles,Number,0,1,1,2,4,5,6,8,9,11,12,14,15,16,17,18,19,20,20,21,21,21,22,22,22,22,22,22,22,22
E01000773,EV motorcycles,Number,0,1,1,2,3,4,5,6,8,9,10,11,12,13,14,15,16,16,17,17,17,17,18,18,18,18,18,18,18,18
E01000774,EV motorcycles,Number,0,1,2,3,5,7,9,11,13,15,17,19,21,22,24,25,26,27,28,28,29,29,29,30,30,30,30,30,30,30
E01000775,EV motorcycles,Number,0,1,2,4,5,7,9,11,14,16,18,20,22,24,25,27,28,29,30,30,31,31,31,32,32,32,32,32,32,32
E01000777,EV motorcycles,Number,1,1,2,4,6,9,11,13,16,19,21,24,26,28,30,32,33,34,35,36,36,37,37,37,38,38,38,38,38,38
E01000778,EV motorcycles,Number,1,1,3,4,7,9,12,14,17,20,22,25,27,30,32,33,35,36,37,38,38,39,39,39,40,40,40,40,40,40
E01000779,EV motorcycles,Number,1,1,2,4,6,8,11,13,16,18,21,23,25,27,29,31,32,33,34,35,35,36,36,36,37,37,37,37,37,37
E01000780,EV motorcycles,Number,1,1,3,4,7,9,11,14,16,19,22,24,27,29,31,32,34,35,36,37,37,38,38,38,39,39,39,39,39,39
E01000781,EV motorcycles,Number,0,1,2,3,4,6,7,9,11,12,14,16,17,18,20,21,22,22,23,24,24,24,24,25,25,25,25,25,25,25
E01000782,EV motorcycles,Number,0,1,2,3,5,6,8,10,11,13,15,17,18,20,21,22,23,24,25,25,26,26,26,27,27,27,27,27,27,27
E01000783,EV motorcycles,Number,0,1,1,2,4,5,6,7,9,10,12,13,14,16,17,17,18,19,19,20,20,20,21,21,21,21,21,21,21,21
E01000784,EV motorcycles,Number,0,1,1,2,4,5,6,8,9,11,12,14,15,16,17,18,19,20,20,21,21,21,22,22,22,22,22,22,22,22
E01000785,EV motorcycles,Number,0,1,1,2,4,5,6,7,9,10,12,13,14,16,17,17,18,19,19,20,20,20,21,21,21,21,21,21,21,21
E01000786,EV motorcycles,Number,1,1,2,4,6,9,11,13,16,19,21,24,26,28,30,32,33,34,35,36,36,37,37,37,38,38,38,38,38,38
E01000787,EV motorcycles,Number,0,1,2,4,6,8,10,12,14,17,19,21,23,25,27,28,30,31,31,32,33,33,33,33,34,34,34,34,34,34
E01000788,EV motorcycles,Number,1,2,3,5,8,10,13,16,19,23,26,29,31,34,36,38,40,41,43,43,44,45,45,45,46,46,46,46,46,46
E01000789,EV motorcycles,Number,0,0,1,1,2,3,4,5,5,6,7,8,9,10,10,11,11,12,12,12,12,13,13,13,13,13,13,13,13,13
E01000790,EV motorcycles,Number,1,2,4,6,9,13,16,20,24,28,31,35,38,41,44,47,49,50,52,53,54,54,55,55,55,56,56,56,56,56
E01000791,EV motorcycles,Number,1,1,2,4,6,8,11,13,16,18,21,23,25,27,29,31,32,33,34,35,35,36,36,36,37,37,37,37,37,37
E01000792,EV motorcycles,Number,0,1,2,3,4,5,7,8,10,11,13,14,16,17,18,19,20,21,21,22,22,22,23,23,23,23,23,23,23,23
E01000793,EV motorcycles,Number,0,1,2,3,5,6,8,10,11,13,15,17,18,20,21,22,23,24,25,25,26,26,26,27,27,27,27,27,27,27
E01000794,EV motorcycles,Number,0,1,2,3,5,7,9,11,13,15,17,19,21,22,24,25,26,27,28,28,29,29,29,30,30,30,30,30,30,30
E01000795,EV motorcycles,Number,0,1,1,2,3,3,4,5,6,7,8,9,10,11,12,12,13,13,14,14,14,15,15,15,15,15,15,15,15,15
E01000796,EV motorcycles,Number,0,0,1,1,2,3,3,4,5,6,7,7,8,9,9,10,10,11,11,11,12,12,12,12,12,12,12,12,12,12
E01000797,EV motorcycles,Number,0,1,2,3,4,6,8,9,11,13,15,16,18,19,20,22,23,23,24,25,25,25,25,26,26,26,26,26,26,26
E01000798,EV motorcycles,Number,0,1,2,3,4,5,7,8,10,11,13,14,16,17,18,19,20,21,21,22,22,22,23,23,23,23,23,23,23,23
E01000799,EV motorcycles,Number,1,1,2,4,6,8,10,13,15,18,20,22,25,27,28,30,31,32,33,34,35,35,35,35,36,36,36,36,36,36
E01000800,EV motorcycles,Number,0,1,1,2,4,5,6,8,9,11,12,14,15,16,17,18,19,20,20,21,21,21,22,22,22,22,22,22,22,22
E01000801,EV motorcycles,Number,0,1,1,2,4,5,6,7,9,10,12,13,14,16,17,17,18,19,19,20,20,20,21,21,21,21,21,21,21,21
E01000802,EV motorcycles,Number,0,1,1,2,3,4,5,6,8,9,10,11,12,13,14,15,16,16,17,17,17,17,18,18,18,18,18,18,18,18
E01000803,EV motorcycles,Number,0,1,2,3,5,6,8,10,12,14,16,17,19,21,22,23,24,25,26,26,27,27,27,28,28,28,28,28,28,28
E01000804,EV motorcycles,Number,0,1,1,2,4,5,6,8,9,11,12,14,15,16,17,18,19,20,20,21,21,21,22,22,22,22,22,22,22,22
E01000805,EV motorcycles,Number,0,1,2,3,4,6,7,9,11,12,14,16,17,18,20,21,22,22,23,24,24,24,24,25,25,25,25,25,25,25
E01000806,EV motorcycles,Number,0,1,2,3,5,7,9,11,13,15,17,19,21,23,24,26,27,28,29,29,30,30,30,31,31,31,31,31,31,31
E01000807,EV motorcycles,Number,0,1,2,4,5,7,9,11,14,16,18,20,22,24,25,27,28,29,30,30,31,31,31,32,32,32,32,32,32,32
E01000808,EV motorcycles,Number,0,1,2,3,4,6,7,9,11,12,14,16,17,18,20,21,22,22,23,24,24,24,24,25,25,25,25,25,25,25
E01000809,EV motorcycles,Number,0,1,2,4,6,8,10,12,14,17,19,21,23,25,27,28,30,31,31,32,33,33,33,33,34,34,34,34,34,34
E01000810,EV motorcycles,Number,0,0,1,1,2,3,4,5,5,6,7,8,9,10,10,11,11,12,12,12,12,13,13,13,13,13,13,13,13,13
E01000811,EV motorcycles,Number,0,1,2,3,4,5,7,8,10,11,13,14,16,17,18,19,20,21,21,22,22,22,23,23,23,23,23,23,23,23
E01000812,EV motorcycles,Number,0,1,2,3,4,5,7,9,10,12,13,15,16,18,19,20,21,22,22,23,23,23,23,24,24,24,24,24,24,24
E01000813,EV motorcycles,Number,0,1,2,3,5,7,8,10,12,14,16,18,20,21,23,24,25,26,27,27,28,28,28,29,29,29,29,29,29,29
E01000814,EV motorcycles,Number,0,1,1,2,3,4,6,7,8,10,11,12,14,15,16,17,17,18,18,19,19,19,20,20,20,20,20,20,20,20
E01000815,EV motorcycles,Number,0,1,1,2,4,5,6,7,9,10,12,13,14,16,17,17,18,19,19,20,20,20,21,21,21,21,21,21,21,21
E01000816,EV motorcycles,Number,0,1,1,2,3,4,5,6,8,9,10,11,12,13,14,15,16,16,17,17,17,17,18,18,18,18,18,18,18,18
E01000818,EV motorcycles,Number,0,1,2,3,4,6,8,9,11,13,15,16,18,19,20,22,23,23,24,25,25,25,25,26,26,26,26,26,26,26
E01000819,EV motorcycles,Number,1,1,2,4,6,8,11,13,16,18,21,23,25,27,29,31,32,33,34,35,35,36,36,36,37,37,37,37,37,37
E01000820,EV motorcycles,Number,0,1,1,2,3,4,5,7,8,9,11,12,13,14,15,16,17,17,18,18,18,18,19,19,19,19,19,19,19,19
E01000822,EV motorcycles,Number,0,1,2,3,4,6,7,9,11,12,14,16,17,18,20,21,22,22,23,24,24,24,24,25,25,25,25,25,25,25
E01000823,EV motorcycles,Number,0,1,2,3,4,6,7,9,11,12,14,16,17,18,20,21,22,22,23,24,24,24,24,25,25,25,25,25,25,25
E01000824,EV motorcycles,Number,0,0,1,1,2,3,4,5,5,6,7,8,9,10,10,11,11,12,12,12,12,13,13,13,13,13,13,13,13,13
E01000825,EV motorcycles,Number,1,1,2,4,6,8,10,13,15,18,20,22,25,27,28,30,31,32,33,34,35,35,35,35,36,36,36,36,36,36
E01000826,EV motorcycles,Number,0,1,2,3,5,6,8,10,12,14,16,17,19,21,22,23,24,25,26,26,27,27,27,28,28,28,28,28,28,28
E01000827,EV motorcycles,Number,0,1,1,2,4,5,6,8,9,11,12,14,15,16,17,18,19,20,20,21,21,21,22,22,22,22,22,22,22,22
E01000828,EV motorcycles,Number,0,1,2,3,5,7,9,11,13,15,17,19,21,22,24,25,26,27,28,28,29,29,29,30,30,30,30,30,30,30
E01000829,EV motorcycles,Number,0,1,2,3,4,5,7,9,10,12,13,15,16,18,19,20,21,22,22,23,23,23,23,24,24,24,24,24,24,24
E01000830,EV motorcycles,Number,0,1,2,3,5,7,9,11,13,15,17,19,21,23,24,26,27,28,29,29,30,30,30,31,31,31,31,31,31,31
E01000831,EV motorcycles,Number,0,1,2,3,5,6,8,10,12,14,16,17,19,21,22,23,24,25,26,26,27,27,27,28,28,28,28,28,28,28
E01000832,EV motorcycles,Number,0,1,2,3,4,6,7,9,11,12,14,16,17,18,20,21,22,22,23,24,24,24,24,25,25,25,25,25,25,25
E01000833,EV motorcycles,Number,0,1,1,2,3,4,5,6,7,8,10,11,12,13,13,14,15,15,16,16,16,16,17,17,17,17,17,17,17,17
E01000834,EV motorcycles,Number,0,1,1,2,3,4,5,7,8,9,11,12,13,14,15,16,17,17,18,18,18,18,19,19,19,19,19,19,19,19
E01000835,EV motorcycles,Number,0,1,2,3,4,6,8,9,11,13,15,16,18,19,20,22,23,23,24,25,25,25,25,26,26,26,26,26,26,26
E01000836,EV motorcycles,Number,0,1,1,2,3,4,5,6,8,9,10,11,12,13,14,15,16,16,17,17,17,17,18,18,18,18,18,18,18,18
E01000837,EV motorcycles,Number,0,1,2,3,4,6,8,9,11,13,15,16,18,19,20,22,23,23,24,25,25,25,25,26,26,26,26,26,26,26
E01000838,EV motorcycles,Number,0,1,1,2,4,5,6,8,9,11,12,14,15,16,17,18,19,20,20,21,21,21,22,22,22,22,22,22,22,22
E01000839,EV motorcycles,Number,0,1,1,2,3,4,5,6,7,8,10,11,12,13,13,14,15,15,16,16,16,16,17,17,17,17,17,17,17,17
E01000840,EV motorcycles,Number,0,1,2,3,4,6,7,9,11,12,14,16,17,18,20,21,22,22,23,24,24,24,24,25,25,25,25,25,25,25
E01000841,EV motorcycles,Number,1,2,3,5,7,10,12,15,18,21,24,27,29,32,34,36,37,39,40,41,41,42,42,42,43,43,43,43,43,43
E01000842,EV motorcycles,Number,0,1,1,2,3,4,5,7,8,9,11,12,13,14,15,16,17,17,18,18,18,18,19,19,19,19,19,19,19,19
E01000843,EV motorcycles,Number,0,1,1,2,3,4,5,6,8,9,10,11,12,13,14,15,16,16,17,17,17,17,18,18,18,18,18,18,18,18
E01000844,EV motorcycles,Number,0,0,1,1,2,3,3,4,5,6,7,7,8,9,9,10,10,11,11,11,12,12,12,12,12,12,12,12,12,12
E01000845,EV motorcycles,Number,0,1,1,2,3,4,5,6,8,9,10,11,12,13,14,15,16,16,17,17,17,17,18,18,18,18,18,18,18,18
E01000846,EV motorcycles,Number,0,1,1,2,3,4,5,6,7,8,10,11,12,13,13,14,15,15,16,16,16,16,17,17,17,17,17,17,17,17
E01000847,EV motorcycles,Number,0,1,2,3,4,5,7,9,10,12,13,15,16,18,19,20,21,22,22,23,23,23,23,24,24,24,24,24,24,24
E01000848,EV motorcycles,Number,0,0,1,1,2,2,3,4,5,5,6,7,8,8,9,9,10,10,10,10,11,11,11,11,11,11,11,11,11,11
E01000849,EV motorcycles,Number,0,0,1,1,2,3,4,5,5,6,7,8,9,10,10,11,11,12,12,12,12,13,13,13,13,13,13,13,13,13
E01000850,EV motorcycles,Number,0,1,1,2,2,3,4,5,6,7,8,9,10,10,11,12,12,13,13,13,13,14,14,14,14,14,14,14,14,14
E01000851,EV motorcycles,Number,0,1,1,2,3,4,6,7,8,10,11,12,14,15,16,17,17,18,18,19,19,19,20,20,20,20,20,20,20,20
E01000852,EV motorcycles,Number,0,0,0,0,0,0,0,0,0,0,0,0,0,0,0,0,0,0,0,0,0,0,0,0,0,0,0,0,0,0
E01000853,EV motorcycles,Number,0,0,0,1,1,2,2,2,3,3,4,4,5,5,6,6,6,6,6,7,7,7,7,7,7,7,7,7,7,7
E01000854,EV motorcycles,Number,0,0,1,1,2,2,3,3,4,4,5,6,6,7,7,7,8,8,8,8,9,9,9,9,9,9,9,9,9,9
E01000855,EV motorcycles,Number,0,0,1,1,2,2,3,4,5,5,6,7,8,8,9,9,10,10,10,10,11,11,11,11,11,11,11,11,11,11
E01000856,EV motorcycles,Number,0,1,1,2,3,4,5,6,7,8,10,11,12,13,13,14,15,15,16,16,16,16,17,17,17,17,17,17,17,17
E01000857,EV motorcycles,Number,0,1,2,3,5,6,8,10,11,13,15,17,18,20,21,22,23,24,25,25,26,26,26,27,27,27,27,27,27,27
E01000858,EV motorcycles,Number,0,1,1,2,3,3,4,5,6,7,8,9,10,11,12,12,13,13,14,14,14,15,15,15,15,15,15,15,15,15
E01000859,EV motorcycles,Number,0,1,1,2,4,5,6,8,9,11,12,14,15,16,17,18,19,20,20,21,21,21,22,22,22,22,22,22,22,22
E01000860,EV motorcycles,Number,0,1,1,2,3,3,4,5,6,7,8,9,10,11,12,12,13,13,14,14,14,15,15,15,15,15,15,15,15,15
E01000861,EV motorcycles,Number,0,1,1,2,3,4,5,6,7,8,9,10,11,12,13,13,14,14,15,15,15,16,16,16,16,16,16,16,16,16
E01000862,EV motorcycles,Number,0,1,1,2,3,4,5,6,7,8,9,10,11,12,13,13,14,14,15,15,15,16,16,16,16,16,16,16,16,16
E01000863,EV motorcycles,Number,0,1,2,3,4,5,7,8,10,11,13,14,16,17,18,19,20,21,21,22,22,22,23,23,23,23,23,23,23,23
E01000864,EV motorcycles,Number,0,1,2,3,4,5,7,9,10,12,13,15,16,18,19,20,21,22,22,23,23,23,23,24,24,24,24,24,24,24
E01000865,EV motorcycles,Number,0,1,2,3,4,5,7,8,10,11,13,14,16,17,18,19,20,21,21,22,22,22,23,23,23,23,23,23,23,23
E01000866,EV motorcycles,Number,0,1,2,3,4,5,7,8,10,11,13,14,16,17,18,19,20,21,21,22,22,22,23,23,23,23,23,23,23,23
E01000867,EV motorcycles,Number,0,1,2,3,5,6,8,10,11,13,15,17,18,20,21,22,23,24,25,25,26,26,26,27,27,27,27,27,27,27
E01000868,EV motorcycles,Number,0,1,2,4,6,7,10,12,14,16,18,21,23,24,26,27,29,30,31,31,32,32,32,33,33,33,33,33,33,33
E01000869,EV motorcycles,Number,0,1,1,2,3,4,5,6,8,9,10,11,12,13,14,15,16,16,17,17,17,17,18,18,18,18,18,18,18,18
E01000870,EV motorcycles,Number,0,1,2,3,4,6,7,9,11,12,14,16,17,18,20,21,22,22,23,24,24,24,24,25,25,25,25,25,25,25
E01000871,EV motorcycles,Number,0,1,2,3,4,5,7,8,10,11,13,14,16,17,18,19,20,21,21,22,22,22,23,23,23,23,23,23,23,23
E01000872,EV motorcycles,Number,1,2,4,7,11,14,19,23,27,31,36,40,44,47,50,53,56,58,59,60,61,62,63,63,63,64,64,64,64,64
E01000873,EV motorcycles,Number,0,0,1,1,2,3,4,5,5,6,7,8,9,10,10,11,11,12,12,12,12,13,13,13,13,13,13,13,13,13
E01000874,EV motorcycles,Number,0,0,1,1,2,2,3,4,4,5,6,6,7,7,8,8,9,9,9,9,10,10,10,10,10,10,10,10,10,10
E01000875,EV motorcycles,Number,0,1,2,3,5,7,9,11,13,15,17,19,21,23,24,26,27,28,29,29,30,30,30,31,31,31,31,31,31,31
E01000876,EV motorcycles,Number,0,1,1,2,3,4,5,6,7,8,9,10,11,12,13,13,14,14,15,15,15,16,16,16,16,16,16,16,16,16
E01000877,EV motorcycles,Number,0,1,2,3,4,5,7,9,10,12,13,15,16,18,19,20,21,22,22,23,23,23,23,24,24,24,24,24,24,24
E01000878,EV motorcycles,Number,0,1,1,2,3,4,5,6,7,8,9,10,11,12,13,13,14,14,15,15,15,16,16,16,16,16,16,16,16,16
E01000879,EV motorcycles,Number,0,0,0,1,1,2,2,2,3,3,4,4,5,5,6,6,6,6,6,7,7,7,7,7,7,7,7,7,7,7
E01000880,EV motorcycles,Number,0,1,1,2,2,3,4,5,6,7,8,9,10,10,11,12,12,13,13,13,13,14,14,14,14,14,14,14,14,14
E01000881,EV motorcycles,Number,0,0,1,1,2,3,3,4,5,6,7,7,8,9,9,10,10,11,11,11,12,12,12,12,12,12,12,12,12,12
E01000882,EV motorcycles,Number,0,0,1,1,2,2,3,3,4,4,5,6,6,7,7,7,8,8,8,8,9,9,9,9,9,9,9,9,9,9
E01000883,EV motorcycles,Number,0,0,1,1,2,3,3,4,5,6,7,7,8,9,9,10,10,11,11,11,12,12,12,12,12,12,12,12,12,12
E01000884,EV motorcycles,Number,0,1,1,2,4,5,6,8,9,11,12,14,15,16,17,18,19,20,20,21,21,21,22,22,22,22,22,22,22,22
E01000885,EV motorcycles,Number,0,0,0,1,1,2,2,2,3,3,4,4,5,5,6,6,6,6,6,7,7,7,7,7,7,7,7,7,7,7
E01000886,EV motorcycles,Number,0,1,1,2,3,4,5,6,7,8,9,10,11,12,13,13,14,14,15,15,15,16,16,16,16,16,16,16,16,16
E01000887,EV motorcycles,Number,0,1,1,2,4,5,6,8,9,11,12,14,15,16,17,18,19,20,20,21,21,21,22,22,22,22,22,22,22,22
E01000888,EV motorcycles,Number,0,0,1,1,2,3,4,5,5,6,7,8,9,10,10,11,11,12,12,12,12,13,13,13,13,13,13,13,13,13
E01000889,EV motorcycles,Number,0,1,2,3,4,5,7,8,10,11,13,14,16,17,18,19,20,21,21,22,22,22,23,23,23,23,23,23,23,23
E01000890,EV motorcycles,Number,0,1,1,2,3,4,5,6,8,9,10,11,12,13,14,15,16,16,17,17,17,17,18,18,18,18,18,18,18,18
E01000891,EV motorcycles,Number,0,1,1,2,3,4,6,7,8,10,11,12,14,15,16,17,17,18,18,19,19,19,20,20,20,20,20,20,20,20
E01000892,EV motorcycles,Number,0,1,1,2,4,5,6,7,9,10,12,13,14,16,17,17,18,19,19,20,20,20,21,21,21,21,21,21,21,21
E01000893,EV motorcycles,Number,0,1,1,2,2,3,4,5,6,7,8,9,10,10,11,12,12,13,13,13,13,14,14,14,14,14,14,14,14,14
E01000894,EV motorcycles,Number,0,1,1,2,3,4,5,7,8,9,11,12,13,14,15,16,17,17,18,18,18,18,19,19,19,19,19,19,19,19
E01000895,EV motorcycles,Number,0,1,1,2,3,4,5,7,8,9,11,12,13,14,15,16,17,17,18,18,18,18,19,19,19,19,19,19,19,19
E01000896,EV motorcycles,Number,0,1,1,2,3,4,5,6,8,9,10,11,12,13,14,15,16,16,17,17,17,17,18,18,18,18,18,18,18,18
E01000897,EV motorcycles,Number,0,1,1,2,4,5,6,8,9,11,12,14,15,16,17,18,19,20,20,21,21,21,22,22,22,22,22,22,22,22
E01000898,EV motorcycles,Number,0,1,1,2,3,3,4,5,6,7,8,9,10,11,12,12,13,13,14,14,14,15,15,15,15,15,15,15,15,15
E01000899,EV motorcycles,Number,0,1,1,2,3,4,5,6,7,8,9,10,11,12,13,13,14,14,15,15,15,16,16,16,16,16,16,16,16,16
E01000900,EV motorcycles,Number,0,1,2,3,5,6,8,10,12,14,16,17,19,21,22,23,24,25,26,26,27,27,27,28,28,28,28,28,28,28
E01000901,EV motorcycles,Number,0,1,2,3,4,6,7,9,11,12,14,16,17,18,20,21,22,22,23,24,24,24,24,25,25,25,25,25,25,25
E01000902,EV motorcycles,Number,0,1,1,2,2,3,4,5,6,7,8,9,10,10,11,12,12,13,13,13,13,14,14,14,14,14,14,14,14,14
E01000903,EV motorcycles,Number,0,0,1,1,2,3,4,5,5,6,7,8,9,10,10,11,11,12,12,12,12,13,13,13,13,13,13,13,13,13
E01000904,EV motorcycles,Number,0,1,1,2,3,4,5,7,8,9,11,12,13,14,15,16,17,17,18,18,18,18,19,19,19,19,19,19,19,19
E01000905,EV motorcycles,Number,0,1,2,3,4,6,7,9,11,12,14,16,17,18,20,21,22,22,23,24,24,24,24,25,25,25,25,25,25,25
E01000906,EV motorcycles,Number,0,1,1,2,2,3,4,5,6,7,8,9,10,10,11,12,12,13,13,13,13,14,14,14,14,14,14,14,14,14
E01000907,EV motorcycles,Number,0,0,1,1,1,2,2,3,3,4,4,5,5,6,6,7,7,7,7,8,8,8,8,8,8,8,8,8,8,8
E01000908,EV motorcycles,Number,0,1,1,2,3,4,6,7,8,10,11,12,14,15,16,17,17,18,18,19,19,19,20,20,20,20,20,20,20,20
E01000909,EV motorcycles,Number,0,1,2,3,5,7,8,10,12,14,16,18,20,21,23,24,25,26,27,27,28,28,28,29,29,29,29,29,29,29
E01000910,EV motorcycles,Number,0,1,1,2,3,3,4,5,6,7,8,9,10,11,12,12,13,13,14,14,14,15,15,15,15,15,15,15,15,15
E01000911,EV motorcycles,Number,0,1,1,2,2,3,4,5,6,7,8,9,10,10,11,12,12,13,13,13,13,14,14,14,14,14,14,14,14,14
E01000912,EV motorcycles,Number,0,1,1,2,3,4,5,6,8,9,10,11,12,13,14,15,16,16,17,17,17,17,18,18,18,18,18,18,18,18
E01000913,EV motorcycles,Number,0,1,2,3,5,7,9,11,13,15,17,19,21,23,24,26,27,28,29,29,30,30,30,31,31,31,31,31,31,31
E01000914,EV motorcycles,Number,0,1,2,3,4,6,7,9,11,12,14,16,17,18,20,21,22,22,23,24,24,24,24,25,25,25,25,25,25,25
E01000915,EV motorcycles,Number,0,1,1,2,3,4,5,6,7,8,10,11,12,13,13,14,15,15,16,16,16,16,17,17,17,17,17,17,17,17
E01000916,EV motorcycles,Number,1,2,3,5,7,10,12,15,18,21,24,27,29,32,34,36,37,39,40,41,41,42,42,42,43,43,43,43,43,43
E01000917,EV motorcycles,Number,0,1,1,2,3,4,5,6,8,9,10,11,12,13,14,15,16,16,17,17,17,17,18,18,18,18,18,18,18,18
E01000918,EV motorcycles,Number,0,1,2,3,5,7,9,11,13,15,17,19,21,23,24,26,27,28,29,29,30,30,30,31,31,31,31,31,31,31
E01000919,EV motorcycles,Number,0,1,1,2,3,4,5,6,7,8,9,10,11,12,13,13,14,14,15,15,15,16,16,16,16,16,16,16,16,16
E01000920,EV motorcycles,Number,0,1,1,2,3,4,6,7,8,10,11,12,14,15,16,17,17,18,18,19,19,19,20,20,20,20,20,20,20,20
E01000921,EV motorcycles,Number,0,1,2,3,4,6,7,9,11,12,14,16,17,18,20,21,22,22,23,24,24,24,24,25,25,25,25,25,25,25
E01000922,EV motorcycles,Number,1,1,2,4,6,8,10,12,15,17,20,22,24,26,28,29,30,31,32,33,34,34,34,34,35,35,35,35,35,35
E01000923,EV motorcycles,Number,0,0,1,1,2,3,3,4,5,6,7,7,8,9,9,10,10,11,11,11,12,12,12,12,12,12,12,12,12,12
E01000924,EV motorcycles,Number,0,0,1,1,2,2,3,4,5,5,6,7,8,8,9,9,10,10,10,10,11,11,11,11,11,11,11,11,11,11
E01000925,EV motorcycles,Number,0,1,1,2,3,4,5,7,8,9,11,12,13,14,15,16,17,17,18,18,18,18,19,19,19,19,19,19,19,19
E01000926,EV motorcycles,Number,0,1,1,2,3,4,6,7,8,10,11,12,14,15,16,17,17,18,18,19,19,19,20,20,20,20,20,20,20,20
E01000927,EV motorcycles,Number,0,1,2,3,4,5,7,8,10,11,13,14,16,17,18,19,20,21,21,22,22,22,23,23,23,23,23,23,23,23
E01000928,EV motorcycles,Number,0,1,2,3,5,7,9,11,13,15,17,19,21,23,24,26,27,28,29,29,30,30,30,31,31,31,31,31,31,31
E01000929,EV motorcycles,Number,0,1,2,3,4,5,7,9,10,12,13,15,16,18,19,20,21,22,22,23,23,23,23,24,24,24,24,24,24,24
E01000930,EV motorcycles,Number,0,1,2,3,4,6,7,9,11,12,14,16,17,18,20,21,22,22,23,24,24,24,24,25,25,25,25,25,25,25
E01000931,EV motorcycles,Number,1,1,3,4,7,9,11,14,16,19,22,24,27,29,31,32,34,35,36,37,37,38,38,38,39,39,39,39,39,39
E01000932,EV motorcycles,Number,0,0,1,1,1,2,2,3,3,4,4,5,5,6,6,7,7,7,7,8,8,8,8,8,8,8,8,8,8,8
E01000933,EV motorcycles,Number,0,0,1,1,1,2,2,3,3,4,4,5,5,6,6,7,7,7,7,8,8,8,8,8,8,8,8,8,8,8
E01000934,EV motorcycles,Number,0,0,1,1,2,2,3,4,5,5,6,7,8,8,9,9,10,10,10,10,11,11,11,11,11,11,11,11,11,11
E01000935,EV motorcycles,Number,0,1,2,3,4,5,7,8,10,11,13,14,16,17,18,19,20,21,21,22,22,22,23,23,23,23,23,23,23,23
E01000936,EV motorcycles,Number,0,0,1,1,2,3,4,5,5,6,7,8,9,10,10,11,11,12,12,12,12,13,13,13,13,13,13,13,13,13
E01000937,EV motorcycles,Number,0,0,0,0,0,0,0,0,0,0,0,0,0,0,0,0,0,0,0,0,0,0,0,0,0,0,0,0,0,0
E01000938,EV motorcycles,Number,0,0,1,1,2,2,3,4,4,5,6,6,7,7,8,8,9,9,9,9,10,10,10,10,10,10,10,10,10,10
E01000939,EV motorcycles,Number,0,1,1,2,2,3,4,5,6,7,8,9,10,10,11,12,12,13,13,13,13,14,14,14,14,14,14,14,14,14
E01000940,EV motorcycles,Number,0,0,0,1,1,1,2,2,3,3,3,4,4,4,5,5,5,5,6,6,6,6,6,6,6,6,6,6,6,6
E01000941,EV motorcycles,Number,0,0,1,1,1,2,2,3,3,4,4,5,5,6,6,7,7,7,7,8,8,8,8,8,8,8,8,8,8,8
E01000942,EV motorcycles,Number,0,1,1,2,4,5,6,8,9,11,12,14,15,16,17,18,19,20,20,21,21,21,22,22,22,22,22,22,22,22
E01000943,EV motorcycles,Number,0,0,0,1,1,2,2,2,3,3,4,4,5,5,6,6,6,6,6,7,7,7,7,7,7,7,7,7,7,7
E01000944,EV motorcycles,Number,0,0,0,1,1,2,2,2,3,3,4,4,5,5,6,6,6,6,6,7,7,7,7,7,7,7,7,7,7,7
E01000945,EV motorcycles,Number,0,0,0,1,1,1,2,2,3,3,3,4,4,4,5,5,5,5,6,6,6,6,6,6,6,6,6,6,6,6
E01000946,EV motorcycles,Number,0,1,1,2,3,4,5,6,7,8,10,11,12,13,13,14,15,15,16,16,16,16,17,17,17,17,17,17,17,17
E01000947,EV motorcycles,Number,0,1,2,3,4,6,8,9,11,13,15,16,18,19,20,22,23,23,24,25,25,25,25,26,26,26,26,26,26,26
E01000948,EV motorcycles,Number,0,1,1,2,3,4,5,6,8,9,10,11,12,13,14,15,16,16,17,17,17,17,18,18,18,18,18,18,18,18
E01000949,EV motorcycles,Number,0,1,1,2,3,3,4,5,6,7,8,9,10,11,12,12,13,13,14,14,14,15,15,15,15,15,15,15,15,15
E01000950,EV motorcycles,Number,0,0,1,1,1,2,2,3,3,4,4,5,5,6,6,7,7,7,7,8,8,8,8,8,8,8,8,8,8,8
E01000951,EV motorcycles,Number,0,1,1,2,3,4,5,6,7,8,9,10,11,12,13,13,14,14,15,15,15,16,16,16,16,16,16,16,16,16
E01000952,EV motorcycles,Number,0,0,1,1,2,2,3,4,5,5,6,7,8,8,9,9,10,10,10,10,11,11,11,11,11,11,11,11,11,11
E01000953,EV motorcycles,Number,0,1,1,2,4,5,6,8,9,11,12,14,15,16,17,18,19,20,20,21,21,21,22,22,22,22,22,22,22,22
E01000954,EV motorcycles,Number,0,0,1,1,2,3,3,4,5,6,7,7,8,9,9,10,10,11,11,11,12,12,12,12,12,12,12,12,12,12
E01000955,EV motorcycles,Number,0,1,1,2,3,4,5,6,8,9,10,11,12,13,14,15,16,16,17,17,17,17,18,18,18,18,18,18,18,18
E01000956,EV motorcycles,Number,0,1,2,3,4,6,7,9,11,12,14,16,17,18,20,21,22,22,23,24,24,24,24,25,25,25,25,25,25,25
E01000957,EV motorcycles,Number,0,1,1,2,3,4,5,6,7,8,10,11,12,13,13,14,15,15,16,16,16,16,17,17,17,17,17,17,17,17
E01000958,EV motorcycles,Number,0,1,2,3,4,5,7,8,10,11,13,14,16,17,18,19,20,21,21,22,22,22,23,23,23,23,23,23,23,23
E01000959,EV motorcycles,Number,0,1,1,2,3,4,5,7,8,9,11,12,13,14,15,16,17,17,18,18,18,18,19,19,19,19,19,19,19,19
E01000960,EV motorcycles,Number,0,1,1,2,3,4,6,7,8,10,11,12,14,15,16,17,17,18,18,19,19,19,20,20,20,20,20,20,20,20
E01000961,EV motorcycles,Number,0,1,1,2,3,4,5,6,7,8,10,11,12,13,13,14,15,15,16,16,16,16,17,17,17,17,17,17,17,17
E01000962,EV motorcycles,Number,0,0,0,1,1,1,2,2,3,3,3,4,4,4,5,5,5,5,6,6,6,6,6,6,6,6,6,6,6,6
E01000963,EV motorcycles,Number,0,0,1,1,2,3,3,4,5,6,7,7,8,9,9,10,10,11,11,11,12,12,12,12,12,12,12,12,12,12
E01000964,EV motorcycles,Number,0,0,1,1,2,2,3,4,4,5,6,6,7,7,8,8,9,9,9,9,10,10,10,10,10,10,10,10,10,10
E01000965,EV motorcycles,Number,0,0,1,1,2,2,3,3,4,4,5,6,6,7,7,7,8,8,8,8,9,9,9,9,9,9,9,9,9,9
E01000966,EV motorcycles,Number,0,0,1,1,2,2,3,4,5,5,6,7,8,8,9,9,10,10,10,10,11,11,11,11,11,11,11,11,11,11
E01000967,EV motorcycles,Number,0,0,1,1,2,3,4,5,5,6,7,8,9,10,10,11,11,12,12,12,12,13,13,13,13,13,13,13,13,13
E01000968,EV motorcycles,Number,0,0,1,1,2,2,3,4,4,5,6,6,7,7,8,8,9,9,9,9,10,10,10,10,10,10,10,10,10,10
E01000969,EV motorcycles,Number,0,1,1,2,3,4,5,6,7,8,9,10,11,12,13,13,14,14,15,15,15,16,16,16,16,16,16,16,16,16
E01000970,EV motorcycles,Number,0,0,0,1,1,2,2,2,3,3,4,4,5,5,6,6,6,6,6,7,7,7,7,7,7,7,7,7,7,7
E01000971,EV motorcycles,Number,0,1,1,2,3,4,5,6,8,9,10,11,12,13,14,15,16,16,17,17,17,17,18,18,18,18,18,18,18,18
E01000972,EV motorcycles,Number,0,1,1,2,4,5,6,8,9,11,12,14,15,16,17,18,19,20,20,21,21,21,22,22,22,22,22,22,22,22
E01000973,EV motorcycles,Number,0,1,2,3,5,6,8,10,11,13,15,17,18,20,21,22,23,24,25,25,26,26,26,27,27,27,27,27,27,27
E01000974,EV motorcycles,Number,0,1,1,2,2,3,4,5,6,7,8,9,10,10,11,12,12,13,13,13,13,14,14,14,14,14,14,14,14,14
E01000975,EV motorcycles,Number,1,1,2,4,6,8,10,13,15,18,20,22,25,27,28,30,31,32,33,34,35,35,35,35,36,36,36,36,36,36
E01000976,EV motorcycles,Number,0,1,2,3,5,7,9,11,13,15,17,19,21,22,24,25,26,27,28,28,29,29,29,30,30,30,30,30,30,30
E01000977,EV motorcycles,Number,0,1,2,3,5,6,8,10,11,13,15,17,18,20,21,22,23,24,25,25,26,26,26,27,27,27,27,27,27,27
E01000978,EV motorcycles,Number,0,1,2,3,4,5,7,8,10,11,13,14,16,17,18,19,20,21,21,22,22,22,23,23,23,23,23,23,23,23
E01000979,EV motorcycles,Number,0,1,1,2,4,5,6,8,9,11,12,14,15,16,17,18,19,20,20,21,21,21,22,22,22,22,22,22,22,22
E01000980,EV motorcycles,Number,0,1,2,3,5,7,9,11,13,15,17,19,21,23,24,26,27,28,29,29,30,30,30,31,31,31,31,31,31,31
E01000981,EV motorcycles,Number,0,1,2,3,5,6,8,10,12,14,16,17,19,21,22,23,24,25,26,26,27,27,27,28,28,28,28,28,28,28
E01000982,EV motorcycles,Number,0,1,1,2,4,5,6,7,9,10,12,13,14,16,17,17,18,19,19,20,20,20,21,21,21,21,21,21,21,21
E01000983,EV motorcycles,Number,0,1,2,4,6,8,10,12,14,17,19,21,23,25,27,28,30,31,31,32,33,33,33,33,34,34,34,34,34,34
E01000984,EV motorcycles,Number,0,1,1,2,3,4,5,7,8,9,11,12,13,14,15,16,17,17,18,18,18,18,19,19,19,19,19,19,19,19
E01000985,EV motorcycles,Number,0,1,1,2,3,4,5,6,8,9,10,11,12,13,14,15,16,16,17,17,17,17,18,18,18,18,18,18,18,18
E01000986,EV motorcycles,Number,0,1,2,4,6,7,10,12,14,16,18,21,23,24,26,27,29,30,31,31,32,32,32,33,33,33,33,33,33,33
E01000987,EV motorcycles,Number,0,1,1,2,2,3,4,5,6,7,8,9,10,10,11,12,12,13,13,13,13,14,14,14,14,14,14,14,14,14
E01000989,EV motorcycles,Number,0,1,2,3,5,6,8,10,11,13,15,17,18,20,21,22,23,24,25,25,26,26,26,27,27,27,27,27,27,27
E01000990,EV motorcycles,Number,0,0,1,1,2,2,3,4,5,5,6,7,8,8,9,9,10,10,10,10,11,11,11,11,11,11,11,11,11,11
E01000991,EV motorcycles,Number,0,1,2,3,4,5,7,9,10,12,13,15,16,18,19,20,21,22,22,23,23,23,23,24,24,24,24,24,24,24
E01000992,EV motorcycles,Number,0,1,2,3,4,5,7,9,10,12,13,15,16,18,19,20,21,22,22,23,23,23,23,24,24,24,24,24,24,24
E01000993,EV motorcycles,Number,0,1,1,2,3,4,5,7,8,9,11,12,13,14,15,16,17,17,18,18,18,18,19,19,19,19,19,19,19,19
E01000994,EV motorcycles,Number,0,1,2,3,4,5,7,8,10,11,13,14,16,17,18,19,20,21,21,22,22,22,23,23,23,23,23,23,23,23
E01000995,EV motorcycles,Number,0,1,2,3,5,7,9,11,13,15,17,19,21,23,24,26,27,28,29,29,30,30,30,31,31,31,31,31,31,31
E01000996,EV motorcycles,Number,1,2,3,5,7,9,12,15,18,21,24,26,29,31,33,35,36,38,39,40,40,41,41,41,42,42,42,42,42,42
E01000997,EV motorcycles,Number,0,1,1,2,3,4,5,6,8,9,10,11,12,13,14,15,16,16,17,17,17,17,18,18,18,18,18,18,18,18
E01000998,EV motorcycles,Number,0,1,2,3,5,7,8,10,12,14,16,18,20,21,23,24,25,26,27,27,28,28,28,29,29,29,29,29,29,29
E01000999,EV motorcycles,Number,0,1,1,2,3,4,5,6,8,9,10,11,12,13,14,15,16,16,17,17,17,17,18,18,18,18,18,18,18,18
E01001000,EV motorcycles,Number,0,1,1,2,3,4,5,6,8,9,10,11,12,13,14,15,16,16,17,17,17,17,18,18,18,18,18,18,18,18
E01001001,EV motorcycles,Number,0,1,1,2,3,4,5,6,7,8,10,11,12,13,13,14,15,15,16,16,16,16,17,17,17,17,17,17,17,17
E01001002,EV motorcycles,Number,0,1,1,2,4,5,6,8,9,11,12,14,15,16,17,18,19,20,20,21,21,21,22,22,22,22,22,22,22,22
E01001003,EV motorcycles,Number,0,1,2,3,4,5,7,9,10,12,13,15,16,18,19,20,21,22,22,23,23,23,23,24,24,24,24,24,24,24
E01001004,EV motorcycles,Number,0,1,2,3,4,6,8,9,11,13,15,16,18,19,20,22,23,23,24,25,25,25,25,26,26,26,26,26,26,26
E01001005,EV motorcycles,Number,0,1,1,2,3,4,5,6,8,9,10,11,12,13,14,15,16,16,17,17,17,17,18,18,18,18,18,18,18,18
E01001006,EV motorcycles,Number,0,1,1,2,4,5,6,8,9,11,12,14,15,16,17,18,19,20,20,21,21,21,22,22,22,22,22,22,22,22
E01001007,EV motorcycles,Number,0,1,2,3,4,6,8,9,11,13,15,16,18,19,20,22,23,23,24,25,25,25,25,26,26,26,26,26,26,26
E01001008,EV motorcycles,Number,0,1,1,2,4,5,6,8,9,11,12,14,15,16,17,18,19,20,20,21,21,21,22,22,22,22,22,22,22,22
E01001009,EV motorcycles,Number,0,1,1,2,3,4,5,6,7,8,10,11,12,13,13,14,15,15,16,16,16,16,17,17,17,17,17,17,17,17
E01001010,EV motorcycles,Number,0,1,1,2,3,4,5,6,7,8,9,10,11,12,13,13,14,14,15,15,15,16,16,16,16,16,16,16,16,16
E01001011,EV motorcycles,Number,0,1,2,4,5,7,9,11,14,16,18,20,22,24,25,27,28,29,30,30,31,31,31,32,32,32,32,32,32,32
E01001012,EV motorcycles,Number,0,1,1,2,3,4,5,6,7,8,9,10,11,12,13,13,14,14,15,15,15,16,16,16,16,16,16,16,16,16
E01001013,EV motorcycles,Number,0,1,1,2,4,5,6,8,9,11,12,14,15,16,17,18,19,20,20,21,21,21,22,22,22,22,22,22,22,22
E01001014,EV motorcycles,Number,0,1,2,4,6,7,10,12,14,16,18,21,23,24,26,27,29,30,31,31,32,32,32,33,33,33,33,33,33,33
E01001015,EV motorcycles,Number,0,1,1,2,4,5,6,8,9,11,12,14,15,16,17,18,19,20,20,21,21,21,22,22,22,22,22,22,22,22
E01001016,EV motorcycles,Number,0,1,2,4,6,8,10,12,14,17,19,21,23,25,27,28,30,31,31,32,33,33,33,33,34,34,34,34,34,34
E01001017,EV motorcycles,Number,0,1,2,3,5,7,9,11,13,15,17,19,21,22,24,25,26,27,28,28,29,29,29,30,30,30,30,30,30,30
E01001018,EV motorcycles,Number,1,1,2,4,6,8,10,13,15,18,20,22,25,27,28,30,31,32,33,34,35,35,35,35,36,36,36,36,36,36
E01001019,EV motorcycles,Number,0,1,1,2,3,4,5,7,8,9,11,12,13,14,15,16,17,17,18,18,18,18,19,19,19,19,19,19,19,19
E01001020,EV motorcycles,Number,0,1,2,3,5,6,8,10,12,14,16,17,19,21,22,23,24,25,26,26,27,27,27,28,28,28,28,28,28,28
E01001021,EV motorcycles,Number,0,1,1,2,2,3,4,5,6,7,8,9,10,10,11,12,12,13,13,13,13,14,14,14,14,14,14,14,14,14
E01001022,EV motorcycles,Number,1,2,4,7,10,13,17,21,25,29,33,37,40,44,47,49,51,53,55,56,57,57,58,58,58,59,59,59,59,59
E01001023,EV motorcycles,Number,1,2,3,5,8,11,14,17,21,24,27,31,33,36,39,41,43,44,45,46,47,48,48,48,48,49,49,49,49,49
E01001024,EV motorcycles,Number,0,1,1,2,3,4,5,7,8,9,11,12,13,14,15,16,17,17,18,18,18,18,19,19,19,19,19,19,19,19
E01001025,EV motorcycles,Number,0,1,2,3,5,7,9,11,13,15,17,19,21,23,24,26,27,28,29,29,30,30,30,31,31,31,31,31,31,31
E01001026,EV motorcycles,Number,1,2,3,5,7,10,13,16,19,22,25,27,30,33,35,37,38,40,41,42,42,43,43,43,44,44,44,44,44,44
E01001027,EV motorcycles,Number,1,1,3,5,7,9,12,15,17,20,23,26,28,30,32,34,36,37,38,39,39,40,40,40,41,41,41,41,41,41
E01001028,EV motorcycles,Number,0,1,2,3,4,5,7,8,10,11,13,14,16,17,18,19,20,21,21,22,22,22,23,23,23,23,23,23,23,23
E01001029,EV motorcycles,Number,0,1,1,2,4,5,6,8,9,11,12,14,15,16,17,18,19,20,20,21,21,21,22,22,22,22,22,22,22,22
E01001030,EV motorcycles,Number,0,0,1,1,2,2,3,4,4,5,6,6,7,7,8,8,9,9,9,9,10,10,10,10,10,10,10,10,10,10
E01001031,EV motorcycles,Number,0,1,1,2,4,5,6,8,9,11,12,14,15,16,17,18,19,20,20,21,21,21,22,22,22,22,22,22,22,22
E01001032,EV motorcycles,Number,0,1,1,2,3,4,6,7,8,10,11,12,14,15,16,17,17,18,18,19,19,19,20,20,20,20,20,20,20,20
E01001033,EV motorcycles,Number,0,1,1,2,3,4,5,7,8,9,11,12,13,14,15,16,17,17,18,18,18,18,19,19,19,19,19,19,19,19
E01001034,EV motorcycles,Number,1,2,3,5,7,9,12,15,18,21,24,26,29,31,33,35,36,38,39,40,40,41,41,41,42,42,42,42,42,42
E01001035,EV motorcycles,Number,0,1,2,3,5,7,9,11,13,15,17,19,21,22,24,25,26,27,28,28,29,29,29,30,30,30,30,30,30,30
E01001036,EV motorcycles,Number,0,0,1,1,2,3,4,5,5,6,7,8,9,10,10,11,11,12,12,12,12,13,13,13,13,13,13,13,13,13
E01001037,EV motorcycles,Number,1,1,3,4,7,9,12,14,17,20,22,25,27,30,32,33,35,36,37,38,38,39,39,39,40,40,40,40,40,40
E01001038,EV motorcycles,Number,0,1,2,3,4,5,7,9,10,12,13,15,16,18,19,20,21,22,22,23,23,23,23,24,24,24,24,24,24,24
E01001039,EV motorcycles,Number,0,1,2,3,5,6,8,10,11,13,15,17,18,20,21,22,23,24,25,25,26,26,26,27,27,27,27,27,27,27
E01001040,EV motorcycles,Number,0,1,1,2,3,4,5,7,8,9,11,12,13,14,15,16,17,17,18,18,18,18,19,19,19,19,19,19,19,19
E01001041,EV motorcycles,Number,0,1,1,2,4,5,6,8,9,11,12,14,15,16,17,18,19,20,20,21,21,21,22,22,22,22,22,22,22,22
E01001042,EV motorcycles,Number,0,1,2,3,5,6,8,10,12,14,16,17,19,21,22,23,24,25,26,26,27,27,27,28,28,28,28,28,28,28
E01001043,EV motorcycles,Number,1,2,4,6,9,13,16,20,24,28,31,35,38,41,44,47,49,50,52,53,54,54,55,55,55,56,56,56,56,56
E01001044,EV motorcycles,Number,0,1,1,2,4,5,6,8,9,11,12,14,15,16,17,18,19,20,20,21,21,21,22,22,22,22,22,22,22,22
E01001045,EV motorcycles,Number,1,1,3,4,7,9,11,14,16,19,22,24,27,29,31,32,34,35,36,37,37,38,38,38,39,39,39,39,39,39
E01001046,EV motorcycles,Number,0,1,1,2,3,4,5,6,7,8,9,10,11,12,13,13,14,14,15,15,15,16,16,16,16,16,16,16,16,16
E01001047,EV motorcycles,Number,0,1,1,2,3,4,5,6,7,8,10,11,12,13,13,14,15,15,16,16,16,16,17,17,17,17,17,17,17,17
E01001048,EV motorcycles,Number,1,2,3,6,8,11,14,18,21,25,28,31,34,37,39,42,43,45,46,47,48,49,49,49,49,50,50,50,50,50
E01001049,EV motorcycles,Number,0,0,1,1,2,3,4,5,5,6,7,8,9,10,10,11,11,12,12,12,12,13,13,13,13,13,13,13,13,13
E01001050,EV motorcycles,Number,0,1,1,2,2,3,4,5,6,7,8,9,10,10,11,12,12,13,13,13,13,14,14,14,14,14,14,14,14,14
E01001051,EV motorcycles,Number,0,1,1,2,3,4,5,6,7,8,10,11,12,13,13,14,15,15,16,16,16,16,17,17,17,17,17,17,17,17
E01001052,EV motorcycles,Number,0,1,1,2,3,4,5,6,7,8,9,10,11,12,13,13,14,14,15,15,15,16,16,16,16,16,16,16,16,16
E01001053,EV motorcycles,Number,0,1,1,2,4,5,6,8,9,11,12,14,15,16,17,18,19,20,20,21,21,21,22,22,22,22,22,22,22,22
E01001054,EV motorcycles,Number,0,1,1,2,3,3,4,5,6,7,8,9,10,11,12,12,13,13,14,14,14,15,15,15,15,15,15,15,15,15
E01001055,EV motorcycles,Number,0,1,1,2,4,5,6,7,9,10,12,13,14,16,17,17,18,19,19,20,20,20,21,21,21,21,21,21,21,21
E01001056,EV motorcycles,Number,0,0,1,1,2,3,3,4,5,6,7,7,8,9,9,10,10,11,11,11,12,12,12,12,12,12,12,12,12,12
E01001057,EV motorcycles,Number,0,0,1,1,2,2,3,4,5,5,6,7,8,8,9,9,10,10,10,10,11,11,11,11,11,11,11,11,11,11
E01001058,EV motorcycles,Number,0,1,2,3,4,5,7,8,10,11,13,14,16,17,18,19,20,21,21,22,22,22,23,23,23,23,23,23,23,23
E01001059,EV motorcycles,Number,0,1,2,3,5,7,8,10,12,14,16,18,20,21,23,24,25,26,27,27,28,28,28,29,29,29,29,29,29,29
E01001060,EV motorcycles,Number,0,1,2,3,5,7,8,10,12,14,16,18,20,21,23,24,25,26,27,27,28,28,28,29,29,29,29,29,29,29
E01001061,EV motorcycles,Number,0,1,2,3,5,7,9,11,13,15,17,19,21,23,24,26,27,28,29,29,30,30,30,31,31,31,31,31,31,31
E01001062,EV motorcycles,Number,0,1,2,3,4,5,7,9,10,12,13,15,16,18,19,20,21,22,22,23,23,23,23,24,24,24,24,24,24,24
E01001063,EV motorcycles,Number,0,1,2,3,4,6,7,9,11,12,14,16,17,18,20,21,22,22,23,24,24,24,24,25,25,25,25,25,25,25
E01001064,EV motorcycles,Number,0,1,2,3,5,6,8,10,12,14,16,17,19,21,22,23,24,25,26,26,27,27,27,28,28,28,28,28,28,28
E01001065,EV motorcycles,Number,0,1,2,3,5,7,9,11,13,15,17,19,21,22,24,25,26,27,28,28,29,29,29,30,30,30,30,30,30,30
E01001066,EV motorcycles,Number,0,1,1,2,3,4,5,6,7,8,9,10,11,12,13,13,14,14,15,15,15,16,16,16,16,16,16,16,16,16
E01001067,EV motorcycles,Number,0,1,2,3,4,6,8,9,11,13,15,16,18,19,20,22,23,23,24,25,25,25,25,26,26,26,26,26,26,26
E01001068,EV motorcycles,Number,1,2,3,5,7,10,12,15,18,21,24,27,29,32,34,36,37,39,40,41,41,42,42,42,43,43,43,43,43,43
E01001069,EV motorcycles,Number,0,1,1,2,4,5,6,8,9,11,12,14,15,16,17,18,19,20,20,21,21,21,22,22,22,22,22,22,22,22
E01001070,EV motorcycles,Number,0,1,2,4,6,7,10,12,14,16,18,21,23,24,26,27,29,30,31,31,32,32,32,33,33,33,33,33,33,33
E01001071,EV motorcycles,Number,0,1,2,3,5,7,9,11,13,15,17,19,21,23,24,26,27,28,29,29,30,30,30,31,31,31,31,31,31,31
E01001072,EV motorcycles,Number,1,1,2,4,6,8,11,13,16,18,21,23,25,27,29,31,32,33,34,35,35,36,36,36,37,37,37,37,37,37
E01001073,EV motorcycles,Number,0,1,2,3,5,7,8,10,12,14,16,18,20,21,23,24,25,26,27,27,28,28,28,29,29,29,29,29,29,29
E01001074,EV motorcycles,Number,0,1,2,3,5,7,9,11,13,15,17,19,21,22,24,25,26,27,28,28,29,29,29,30,30,30,30,30,30,30
E01001075,EV motorcycles,Number,0,1,1,2,3,4,5,6,8,9,10,11,12,13,14,15,16,16,17,17,17,17,18,18,18,18,18,18,18,18
E01001076,EV motorcycles,Number,0,1,2,4,5,7,9,11,14,16,18,20,22,24,25,27,28,29,30,30,31,31,31,32,32,32,32,32,32,32
E01001077,EV motorcycles,Number,0,1,2,3,4,6,8,9,11,13,15,16,18,19,20,22,23,23,24,25,25,25,25,26,26,26,26,26,26,26
E01001078,EV motorcycles,Number,0,1,2,3,4,6,7,9,11,12,14,16,17,18,20,21,22,22,23,24,24,24,24,25,25,25,25,25,25,25
E01001079,EV motorcycles,Number,0,1,2,3,5,6,8,10,12,14,16,17,19,21,22,23,24,25,26,26,27,27,27,28,28,28,28,28,28,28
E01001080,EV motorcycles,Number,0,0,1,1,2,3,4,5,5,6,7,8,9,10,10,11,11,12,12,12,12,13,13,13,13,13,13,13,13,13
E01001081,EV motorcycles,Number,0,1,2,3,5,6,8,10,11,13,15,17,18,20,21,22,23,24,25,25,26,26,26,27,27,27,27,27,27,27
E01001082,EV motorcycles,Number,0,1,2,3,5,6,8,10,11,13,15,17,18,20,21,22,23,24,25,25,26,26,26,27,27,27,27,27,27,27
E01001083,EV motorcycles,Number,1,2,3,6,9,12,15,18,22,26,29,32,36,38,41,43,45,47,48,49,50,50,51,51,51,52,52,52,52,52
E01001084,EV motorcycles,Number,1,2,4,6,9,12,16,19,23,27,30,34,37,40,43,45,47,49,50,51,52,52,53,53,53,54,54,54,54,54
E01001085,EV motorcycles,Number,1,1,2,4,6,8,10,13,15,18,20,22,25,27,28,30,31,32,33,34,35,35,35,35,36,36,36,36,36,36
E01001086,EV motorcycles,Number,0,1,1,2,4,5,6,8,9,11,12,14,15,16,17,18,19,20,20,21,21,21,22,22,22,22,22,22,22,22
E01001087,EV motorcycles,Number,1,3,5,8,12,16,21,25,30,35,40,44,49,52,56,59,62,64,66,67,68,69,70,70,70,71,71,71,71,71
E01001088,EV motorcycles,Number,0,1,2,3,4,5,7,8,10,11,13,14,16,17,18,19,20,21,21,22,22,22,23,23,23,23,23,23,23,23
E01001089,EV motorcycles,Number,1,2,3,5,7,10,13,16,19,22,25,27,30,33,35,37,38,40,41,42,42,43,43,43,44,44,44,44,44,44
E01001090,EV motorcycles,Number,1,2,3,5,8,10,13,16,19,23,26,29,31,34,36,38,40,41,43,43,44,45,45,45,46,46,46,46,46,46
E01001091,EV motorcycles,Number,0,1,2,3,4,6,8,9,11,13,15,16,18,19,20,22,23,23,24,25,25,25,25,26,26,26,26,26,26,26
E01001092,EV motorcycles,Number,0,1,1,2,3,4,5,6,8,9,10,11,12,13,14,15,16,16,17,17,17,17,18,18,18,18,18,18,18,18
E01001093,EV motorcycles,Number,0,1,1,2,3,3,4,5,6,7,8,9,10,11,12,12,13,13,14,14,14,15,15,15,15,15,15,15,15,15
E01001094,EV motorcycles,Number,0,0,1,1,2,2,3,4,5,5,6,7,8,8,9,9,10,10,10,10,11,11,11,11,11,11,11,11,11,11
E01001095,EV motorcycles,Number,0,0,0,1,1,2,2,2,3,3,4,4,5,5,6,6,6,6,6,7,7,7,7,7,7,7,7,7,7,7
E01001096,EV motorcycles,Number,0,1,1,2,3,3,4,5,6,7,8,9,10,11,12,12,13,13,14,14,14,15,15,15,15,15,15,15,15,15
E01001097,EV motorcycles,Number,0,1,2,3,5,6,8,10,11,13,15,17,18,20,21,22,23,24,25,25,26,26,26,27,27,27,27,27,27,27
E01001098,EV motorcycles,Number,0,0,1,1,1,2,2,3,3,4,4,5,5,6,6,7,7,7,7,8,8,8,8,8,8,8,8,8,8,8
E01001099,EV motorcycles,Number,0,1,1,2,4,5,6,7,9,10,12,13,14,16,17,17,18,19,19,20,20,20,21,21,21,21,21,21,21,21
E01001100,EV motorcycles,Number,0,1,1,2,3,4,5,6,7,8,10,11,12,13,13,14,15,15,16,16,16,16,17,17,17,17,17,17,17,17
E01001101,EV motorcycles,Number,1,2,3,5,7,9,12,15,18,21,24,26,29,31,33,35,36,38,39,40,40,41,41,41,42,42,42,42,42,42
E01001102,EV motorcycles,Number,0,1,1,2,3,4,5,7,8,9,11,12,13,14,15,16,17,17,18,18,18,18,19,19,19,19,19,19,19,19
E01001103,EV motorcycles,Number,0,1,1,2,4,5,6,8,9,11,12,14,15,16,17,18,19,20,20,21,21,21,22,22,22,22,22,22,22,22
E01001104,EV motorcycles,Number,0,1,2,3,4,6,7,9,11,12,14,16,17,18,20,21,22,22,23,24,24,24,24,25,25,25,25,25,25,25
E01001105,EV motorcycles,Number,0,1,2,4,6,8,10,12,14,17,19,21,23,25,27,28,30,31,31,32,33,33,33,33,34,34,34,34,34,34
E01001106,EV motorcycles,Number,0,1,2,3,5,7,8,10,12,14,16,18,20,21,23,24,25,26,27,27,28,28,28,29,29,29,29,29,29,29
E01001107,EV motorcycles,Number,0,1,2,3,5,7,9,11,13,15,17,19,21,22,24,25,26,27,28,28,29,29,29,30,30,30,30,30,30,30
E01001108,EV motorcycles,Number,0,1,2,3,5,6,8,10,12,14,16,17,19,21,22,23,24,25,26,26,27,27,27,28,28,28,28,28,28,28
E01001109,EV motorcycles,Number,1,3,5,8,13,17,22,27,32,37,43,47,52,56,60,63,66,68,70,72,73,74,74,75,75,75,76,76,76,76
E01001110,EV motorcycles,Number,1,1,2,4,6,8,10,13,15,18,20,22,25,27,28,30,31,32,33,34,35,35,35,35,36,36,36,36,36,36
E01001111,EV motorcycles,Number,0,1,1,2,2,3,4,5,6,7,8,9,10,10,11,12,12,13,13,13,13,14,14,14,14,14,14,14,14,14
E01001112,EV motorcycles,Number,0,1,2,3,5,6,8,10,12,14,16,17,19,21,22,23,24,25,26,26,27,27,27,28,28,28,28,28,28,28
E01001113,EV motorcycles,Number,1,2,3,5,7,9,12,15,18,21,24,26,29,31,33,35,36,38,39,40,40,41,41,41,42,42,42,42,42,42
E01001114,EV motorcycles,Number,0,0,1,1,2,3,4,5,5,6,7,8,9,10,10,11,11,12,12,12,12,13,13,13,13,13,13,13,13,13
E01001115,EV motorcycles,Number,0,1,1,2,4,5,6,8,9,11,12,14,15,16,17,18,19,20,20,21,21,21,22,22,22,22,22,22,22,22
E01001116,EV motorcycles,Number,1,1,3,4,7,9,12,14,17,20,22,25,27,30,32,33,35,36,37,38,38,39,39,39,40,40,40,40,40,40
E01001117,EV motorcycles,Number,2,5,10,17,25,34,43,53,63,74,84,93,103,111,118,125,130,135,139,142,144,146,147,148,148,149,150,150,150,150
E01001118,EV motorcycles,Number,0,1,2,3,5,6,8,10,11,13,15,17,18,20,21,22,23,24,25,25,26,26,26,27,27,27,27,27,27,27
E01001119,EV motorcycles,Number,0,1,2,3,5,7,9,11,13,15,17,19,21,23,24,26,27,28,29,29,30,30,30,31,31,31,31,31,31,31
E01001120,EV motorcycles,Number,0,1,1,2,3,4,5,6,7,8,9,10,11,12,13,13,14,14,15,15,15,16,16,16,16,16,16,16,16,16
E01001121,EV motorcycles,Number,0,1,2,4,5,7,9,11,14,16,18,20,22,24,25,27,28,29,30,30,31,31,31,32,32,32,32,32,32,32
E01001122,EV motorcycles,Number,0,1,2,3,5,6,8,10,11,13,15,17,18,20,21,22,23,24,25,25,26,26,26,27,27,27,27,27,27,27
E01001123,EV motorcycles,Number,0,1,2,3,4,5,7,8,10,11,13,14,16,17,18,19,20,21,21,22,22,22,23,23,23,23,23,23,23,23
E01001124,EV motorcycles,Number,0,0,1,1,2,2,3,4,5,5,6,7,8,8,9,9,10,10,10,10,11,11,11,11,11,11,11,11,11,11
E01001125,EV motorcycles,Number,0,1,2,3,5,6,8,10,11,13,15,17,18,20,21,22,23,24,25,25,26,26,26,27,27,27,27,27,27,27
E01001126,EV motorcycles,Number,0,1,1,2,3,4,5,7,8,9,11,12,13,14,15,16,17,17,18,18,18,18,19,19,19,19,19,19,19,19
E01001127,EV motorcycles,Number,0,1,2,3,5,6,8,10,12,14,16,17,19,21,22,23,24,25,26,26,27,27,27,28,28,28,28,28,28,28
E01001128,EV motorcycles,Number,0,1,1,2,3,3,4,5,6,7,8,9,10,11,12,12,13,13,14,14,14,15,15,15,15,15,15,15,15,15
E01001129,EV motorcycles,Number,0,1,2,3,4,5,7,9,10,12,13,15,16,18,19,20,21,22,22,23,23,23,23,24,24,24,24,24,24,24
E01001130,EV motorcycles,Number,0,0,1,1,2,2,3,4,4,5,6,6,7,7,8,8,9,9,9,9,10,10,10,10,10,10,10,10,10,10
E01001131,EV motorcycles,Number,0,1,1,2,3,4,5,6,7,8,10,11,12,13,13,14,15,15,16,16,16,16,17,17,17,17,17,17,17,17
E01001132,EV motorcycles,Number,1,2,3,5,8,10,13,16,19,22,25,28,31,33,35,37,39,40,42,42,43,44,44,44,45,45,45,45,45,45
E01001133,EV motorcycles,Number,0,1,2,3,5,7,9,11,13,15,17,19,21,22,24,25,26,27,28,28,29,29,29,30,30,30,30,30,30,30
E01001134,EV motorcycles,Number,0,1,1,2,4,5,6,7,9,10,12,13,14,16,17,17,18,19,19,20,20,20,21,21,21,21,21,21,21,21
E01001135,EV motorcycles,Number,1,1,2,4,6,8,10,12,15,17,20,22,24,26,28,29,30,31,32,33,34,34,34,34,35,35,35,35,35,35
E01001136,EV motorcycles,Number,0,1,1,2,3,4,5,7,8,9,11,12,13,14,15,16,17,17,18,18,18,18,19,19,19,19,19,19,19,19
E01001137,EV motorcycles,Number,1,1,2,4,6,8,10,12,15,17,20,22,24,26,28,29,30,31,32,33,34,34,34,34,35,35,35,35,35,35
E01001138,EV motorcycles,Number,0,1,2,3,4,6,8,9,11,13,15,16,18,19,20,22,23,23,24,25,25,25,25,26,26,26,26,26,26,26
E01001139,EV motorcycles,Number,0,1,2,3,4,6,7,9,11,12,14,16,17,18,20,21,22,22,23,24,24,24,24,25,25,25,25,25,25,25
E01001140,EV motorcycles,Number,0,1,2,3,4,5,7,8,10,11,13,14,16,17,18,19,20,21,21,22,22,22,23,23,23,23,23,23,23,23
E01001141,EV motorcycles,Number,0,0,1,1,2,3,4,5,5,6,7,8,9,10,10,11,11,12,12,12,12,13,13,13,13,13,13,13,13,13
E01001142,EV motorcycles,Number,0,1,1,2,4,5,6,7,9,10,12,13,14,16,17,17,18,19,19,20,20,20,21,21,21,21,21,21,21,21
E01001143,EV motorcycles,Number,0,1,1,2,3,4,5,7,8,9,11,12,13,14,15,16,17,17,18,18,18,18,19,19,19,19,19,19,19,19
E01001144,EV motorcycles,Number,0,1,1,2,3,4,5,6,8,9,10,11,12,13,14,15,16,16,17,17,17,17,18,18,18,18,18,18,18,18
E01001145,EV motorcycles,Number,1,1,2,4,6,8,11,13,16,18,21,23,25,27,29,31,32,33,34,35,35,36,36,36,37,37,37,37,37,37
E01001146,EV motorcycles,Number,0,1,2,3,5,7,9,11,13,15,17,19,21,22,24,25,26,27,28,28,29,29,29,30,30,30,30,30,30,30
E01001147,EV motorcycles,Number,0,1,2,3,5,6,8,10,11,13,15,17,18,20,21,22,23,24,25,25,26,26,26,27,27,27,27,27,27,27
E01001148,EV motorcycles,Number,0,1,1,2,3,4,5,6,7,8,9,10,11,12,13,13,14,14,15,15,15,16,16,16,16,16,16,16,16,16
E01001149,EV motorcycles,Number,0,0,1,1,2,3,4,5,5,6,7,8,9,10,10,11,11,12,12,12,12,13,13,13,13,13,13,13,13,13
E01001150,EV motorcycles,Number,0,1,2,3,5,7,8,10,12,14,16,18,20,21,23,24,25,26,27,27,28,28,28,29,29,29,29,29,29,29
E01001151,EV motorcycles,Number,1,1,2,4,6,9,11,13,16,19,21,24,26,28,30,32,33,34,35,36,36,37,37,37,38,38,38,38,38,38
E01001152,EV motorcycles,Number,0,1,2,3,5,6,8,10,11,13,15,17,18,20,21,22,23,24,25,25,26,26,26,27,27,27,27,27,27,27
E01001153,EV motorcycles,Number,0,1,1,2,3,4,5,7,8,9,11,12,13,14,15,16,17,17,18,18,18,18,19,19,19,19,19,19,19,19
E01001154,EV motorcycles,Number,1,1,3,4,7,9,11,14,16,19,22,24,27,29,31,32,34,35,36,37,37,38,38,38,39,39,39,39,39,39
E01001155,EV motorcycles,Number,0,1,2,3,4,6,7,9,11,12,14,16,17,18,20,21,22,22,23,24,24,24,24,25,25,25,25,25,25,25
E01001156,EV motorcycles,Number,0,1,2,3,4,5,7,8,10,11,13,14,16,17,18,19,20,21,21,22,22,22,23,23,23,23,23,23,23,23
E01001157,EV motorcycles,Number,1,1,2,4,6,8,10,12,15,17,20,22,24,26,28,29,30,31,32,33,34,34,34,34,35,35,35,35,35,35
E01001158,EV motorcycles,Number,0,1,2,4,6,7,10,12,14,16,18,21,23,24,26,27,29,30,31,31,32,32,32,33,33,33,33,33,33,33
E01001159,EV motorcycles,Number,1,1,2,4,6,9,11,13,16,19,21,24,26,28,30,32,33,34,35,36,36,37,37,37,38,38,38,38,38,38
E01001160,EV motorcycles,Number,0,1,1,2,4,5,6,8,9,11,12,14,15,16,17,18,19,20,20,21,21,21,22,22,22,22,22,22,22,22
E01001161,EV motorcycles,Number,1,2,3,5,8,11,14,17,21,24,27,31,33,36,39,41,43,44,45,46,47,48,48,48,48,49,49,49,49,49
E01001162,EV motorcycles,Number,0,1,2,3,5,7,9,11,13,15,17,19,21,22,24,25,26,27,28,28,29,29,29,30,30,30,30,30,30,30
E01001163,EV motorcycles,Number,0,1,2,4,5,7,9,11,14,16,18,20,22,24,25,27,28,29,30,30,31,31,31,32,32,32,32,32,32,32
E01001164,EV motorcycles,Number,0,1,2,3,5,7,9,11,13,15,17,19,21,22,24,25,26,27,28,28,29,29,29,30,30,30,30,30,30,30
E01001165,EV motorcycles,Number,1,1,2,4,6,8,10,12,15,17,20,22,24,26,28,29,30,31,32,33,34,34,34,34,35,35,35,35,35,35
E01001166,EV motorcycles,Number,0,1,2,3,5,6,8,10,12,14,16,17,19,21,22,23,24,25,26,26,27,27,27,28,28,28,28,28,28,28
E01001167,EV motorcycles,Number,0,1,2,3,4,5,7,8,10,11,13,14,16,17,18,19,20,21,21,22,22,22,23,23,23,23,23,23,23,23
E01001168,EV motorcycles,Number,0,1,2,3,5,7,9,11,13,15,17,19,21,22,24,25,26,27,28,28,29,29,29,30,30,30,30,30,30,30
E01001169,EV motorcycles,Number,0,0,1,1,2,2,3,3,4,4,5,6,6,7,7,7,8,8,8,8,9,9,9,9,9,9,9,9,9,9
E01001170,EV motorcycles,Number,0,1,1,2,2,3,4,5,6,7,8,9,10,10,11,12,12,13,13,13,13,14,14,14,14,14,14,14,14,14
E01001171,EV motorcycles,Number,1,1,2,4,6,8,10,13,15,18,20,22,25,27,28,30,31,32,33,34,35,35,35,35,36,36,36,36,36,36
E01001172,EV motorcycles,Number,0,1,2,3,5,6,8,10,11,13,15,17,18,20,21,22,23,24,25,25,26,26,26,27,27,27,27,27,27,27
E01001173,EV motorcycles,Number,0,1,2,3,5,6,8,10,12,14,16,17,19,21,22,23,24,25,26,26,27,27,27,28,28,28,28,28,28,28
E01001174,EV motorcycles,Number,0,1,1,2,2,3,4,5,6,7,8,9,10,10,11,12,12,13,13,13,13,14,14,14,14,14,14,14,14,14
E01001175,EV motorcycles,Number,0,1,1,2,3,4,6,7,8,10,11,12,14,15,16,17,17,18,18,19,19,19,20,20,20,20,20,20,20,20
E01001176,EV motorcycles,Number,0,1,2,3,5,7,8,10,12,14,16,18,20,21,23,24,25,26,27,27,28,28,28,29,29,29,29,29,29,29
E01001177,EV motorcycles,Number,0,1,2,3,4,5,7,9,10,12,13,15,16,18,19,20,21,22,22,23,23,23,23,24,24,24,24,24,24,24
E01001178,EV motorcycles,Number,0,1,1,2,3,4,5,7,8,9,11,12,13,14,15,16,17,17,18,18,18,18,19,19,19,19,19,19,19,19
E01001179,EV motorcycles,Number,0,1,1,2,4,5,6,7,9,10,12,13,14,16,17,17,18,19,19,20,20,20,21,21,21,21,21,21,21,21
E01001180,EV motorcycles,Number,0,1,1,2,4,5,6,7,9,10,12,13,14,16,17,17,18,19,19,20,20,20,21,21,21,21,21,21,21,21
E01001181,EV motorcycles,Number,0,1,1,2,3,4,6,7,8,10,11,12,14,15,16,17,17,18,18,19,19,19,20,20,20,20,20,20,20,20
E01001182,EV motorcycles,Number,1,2,4,6,9,12,16,20,23,27,31,34,38,41,43,46,48,49,51,52,53,53,54,54,54,55,55,55,55,55
E01001183,EV motorcycles,Number,0,1,2,3,4,5,7,8,10,11,13,14,16,17,18,19,20,21,21,22,22,22,23,23,23,23,23,23,23,23
E01001184,EV motorcycles,Number,0,1,1,2,3,3,4,5,6,7,8,9,10,11,12,12,13,13,14,14,14,15,15,15,15,15,15,15,15,15
E01001185,EV motorcycles,Number,0,0,1,1,2,2,3,3,4,4,5,6,6,7,7,7,8,8,8,8,9,9,9,9,9,9,9,9,9,9
E01001186,EV motorcycles,Number,1,2,3,5,7,10,12,15,18,21,24,27,29,32,34,36,37,39,40,41,41,42,42,42,43,43,43,43,43,43
E01001187,EV motorcycles,Number,0,1,2,3,5,6,8,10,12,14,16,17,19,21,22,23,24,25,26,26,27,27,27,28,28,28,28,28,28,28
E01001188,EV motorcycles,Number,0,1,2,3,4,6,7,9,11,12,14,16,17,18,20,21,22,22,23,24,24,24,24,25,25,25,25,25,25,25
E01001189,EV motorcycles,Number,0,0,1,1,2,3,3,4,5,6,7,7,8,9,9,10,10,11,11,11,12,12,12,12,12,12,12,12,12,12
E01001190,EV motorcycles,Number,0,1,1,2,2,3,4,5,6,7,8,9,10,10,11,12,12,13,13,13,13,14,14,14,14,14,14,14,14,14
E01001191,EV motorcycles,Number,0,1,2,3,5,6,8,10,11,13,15,17,18,20,21,22,23,24,25,25,26,26,26,27,27,27,27,27,27,27
E01001192,EV motorcycles,Number,0,0,1,1,2,2,3,4,5,5,6,7,8,8,9,9,10,10,10,10,11,11,11,11,11,11,11,11,11,11
E01001193,EV motorcycles,Number,0,1,1,2,3,4,5,6,8,9,10,11,12,13,14,15,16,16,17,17,17,17,18,18,18,18,18,18,18,18
E01001194,EV motorcycles,Number,0,1,1,2,3,4,5,6,7,8,9,10,11,12,13,13,14,14,15,15,15,16,16,16,16,16,16,16,16,16
E01001243,EV motorcycles,Number,1,2,4,7,10,13,17,21,25,30,34,37,41,44,47,50,52,54,55,57,58,58,59,59,59,60,60,60,60,60
E01001245,EV motorcycles,Number,0,0,0,0,0,0,0,0,0,0,0,0,0,0,0,0,0,0,0,0,0,0,0,0,0,0,0,0,0,0
E01001246,EV motorcycles,Number,1,2,4,6,9,13,16,20,24,28,32,35,39,42,44,47,49,51,52,53,54,55,55,56,56,56,56,56,56,56
E01001276,EV motorcycles,Number,1,2,4,7,11,14,19,23,27,31,36,40,44,47,50,53,56,58,59,60,61,62,63,63,63,64,64,64,64,64
E01001277,EV motorcycles,Number,0,1,1,2,4,5,6,8,9,10,12,13,14,16,17,18,18,19,20,20,20,21,21,21,21,21,21,21,21,21
E01001278,EV motorcycles,Number,0,0,0,0,0,0,0,0,0,0,0,0,0,0,0,0,0,0,0,0,0,0,0,0,0,0,0,0,0,0
E01001308,EV motorcycles,Number,0,1,1,2,3,4,5,6,7,9,10,11,12,13,14,14,15,16,16,16,17,17,17,17,17,17,17,17,17,17
E01001310,EV motorcycles,Number,0,0,0,0,0,0,0,0,0,0,0,0,0,0,0,0,0,0,0,0,0,0,0,0,0,0,0,0,0,0
E01001312,EV motorcycles,Number,0,0,0,0,0,0,0,0,0,0,0,0,0,0,0,0,0,0,0,0,0,0,0,0,0,0,0,0,0,0
E01001313,EV motorcycles,Number,0,1,2,3,5,7,9,11,13,15,17,19,21,22,24,25,26,27,28,28,29,29,29,30,30,30,30,30,30,30
E01001314,EV motorcycles,Number,0,0,0,0,0,0,0,0,0,0,0,0,0,0,0,0,0,0,0,0,0,0,0,0,0,0,0,0,0,0
E01001326,EV motorcycles,Number,0,0,0,0,0,1,1,1,1,1,2,2,2,2,2,2,2,2,3,3,3,3,3,3,3,3,3,3,3,3
E01001342,EV motorcycles,Number,0,0,1,1,2,2,3,4,4,5,6,6,7,8,8,9,9,9,9,10,10,10,10,10,10,10,10,10,10,10
E01001345,EV motorcycles,Number,0,0,0,0,0,0,0,0,0,0,0,0,0,0,0,0,0,0,0,0,0,0,0,0,0,0,0,0,0,0
E01001390,EV motorcycles,Number,0,1,2,4,5,7,9,11,14,16,18,20,22,24,25,27,28,29,30,30,31,31,31,32,32,32,32,32,32,32
E01001391,EV motorcycles,Number,1,1,2,4,6,8,10,12,15,17,20,22,24,26,28,29,30,31,32,33,34,34,34,34,35,35,35,35,35,35
E01001392,EV motorcycles,Number,0,1,1,2,3,4,5,6,7,8,10,11,12,13,13,14,15,15,16,16,16,16,17,17,17,17,17,17,17,17
E01001393,EV motorcycles,Number,0,1,2,3,5,6,8,10,12,14,16,17,19,21,22,23,24,25,26,26,27,27,27,28,28,28,28,28,28,28
E01001394,EV motorcycles,Number,0,1,1,2,4,5,6,7,9,10,12,13,14,16,17,17,18,19,19,20,20,20,21,21,21,21,21,21,21,21
E01001395,EV motorcycles,Number,0,1,1,2,2,3,4,5,6,7,8,9,10,10,11,12,12,13,13,13,13,14,14,14,14,14,14,14,14,14
E01001396,EV motorcycles,Number,0,0,1,1,2,3,3,4,5,6,7,7,8,9,9,10,10,11,11,11,12,12,12,12,12,12,12,12,12,12
E01001397,EV motorcycles,Number,0,1,1,2,4,5,6,8,9,11,12,14,15,16,17,18,19,20,20,21,21,21,22,22,22,22,22,22,22,22
E01001398,EV motorcycles,Number,0,0,1,1,2,2,3,4,5,5,6,7,8,8,9,9,10,10,10,10,11,11,11,11,11,11,11,11,11,11
E01001399,EV motorcycles,Number,0,1,1,2,3,4,5,6,7,8,9,10,11,12,13,13,14,14,15,15,15,16,16,16,16,16,16,16,16,16
E01001400,EV motorcycles,Number,0,1,1,2,3,4,6,7,8,10,11,12,14,15,16,17,17,18,18,19,19,19,20,20,20,20,20,20,20,20
E01001401,EV motorcycles,Number,0,1,1,2,3,3,4,5,6,7,8,9,10,11,12,12,13,13,14,14,14,15,15,15,15,15,15,15,15,15
E01001402,EV motorcycles,Number,0,1,2,3,4,6,7,9,11,12,14,16,17,18,20,21,22,22,23,24,24,24,24,25,25,25,25,25,25,25
E01001403,EV motorcycles,Number,0,1,1,2,3,4,5,6,7,8,9,10,11,12,13,13,14,14,15,15,15,16,16,16,16,16,16,16,16,16
E01001404,EV motorcycles,Number,0,1,1,2,4,5,6,7,9,10,12,13,14,16,17,17,18,19,19,20,20,20,21,21,21,21,21,21,21,21
E01001405,EV motorcycles,Number,0,1,2,3,4,5,7,8,10,11,13,14,16,17,18,19,20,21,21,22,22,22,23,23,23,23,23,23,23,23
E01001406,EV motorcycles,Number,0,1,1,2,3,4,5,6,8,9,10,11,12,13,14,15,16,16,17,17,17,17,18,18,18,18,18,18,18,18
E01001407,EV motorcycles,Number,0,1,1,2,3,4,6,7,8,10,11,12,14,15,16,17,17,18,18,19,19,19,20,20,20,20,20,20,20,20
E01001408,EV motorcycles,Number,0,1,1,2,3,4,6,7,8,10,11,12,14,15,16,17,17,18,18,19,19,19,20,20,20,20,20,20,20,20
E01001409,EV motorcycles,Number,0,1,2,3,4,6,7,9,11,12,14,16,17,18,20,21,22,22,23,24,24,24,24,25,25,25,25,25,25,25
E01001410,EV motorcycles,Number,0,1,1,2,2,3,4,5,6,7,8,9,10,10,11,12,12,13,13,13,13,14,14,14,14,14,14,14,14,14
E01001411,EV motorcycles,Number,1,2,3,6,9,12,15,19,22,26,30,33,36,39,42,44,46,48,49,50,51,51,52,52,52,53,53,53,53,53
E01001412,EV motorcycles,Number,0,1,2,3,5,6,8,10,11,13,15,17,18,20,21,22,23,24,25,25,26,26,26,27,27,27,27,27,27,27
E01001413,EV motorcycles,Number,1,2,3,5,8,11,14,17,21,24,27,31,33,36,39,41,43,44,45,46,47,48,48,48,48,49,49,49,49,49
E01001414,EV motorcycles,Number,0,1,1,2,3,4,5,6,7,8,10,11,12,13,13,14,15,15,16,16,16,16,17,17,17,17,17,17,17,17
E01001415,EV motorcycles,Number,0,1,1,2,3,4,5,6,7,8,10,11,12,13,13,14,15,15,16,16,16,16,17,17,17,17,17,17,17,17
E01001416,EV motorcycles,Number,0,1,1,2,2,3,4,5,6,7,8,9,10,10,11,12,12,13,13,13,13,14,14,14,14,14,14,14,14,14
E01001417,EV motorcycles,Number,0,1,1,2,3,4,5,7,8,9,11,12,13,14,15,16,17,17,18,18,18,18,19,19,19,19,19,19,19,19
E01001418,EV motorcycles,Number,0,1,1,2,3,4,5,7,8,9,11,12,13,14,15,16,17,17,18,18,18,18,19,19,19,19,19,19,19,19
E01001419,EV motorcycles,Number,0,0,1,1,2,3,4,5,5,6,7,8,9,10,10,11,11,12,12,12,12,13,13,13,13,13,13,13,13,13
E01001420,EV motorcycles,Number,0,1,1,2,3,4,6,7,8,10,11,12,14,15,16,17,17,18,18,19,19,19,20,20,20,20,20,20,20,20
E01001421,EV motorcycles,Number,0,0,1,1,2,3,3,4,5,6,7,7,8,9,9,10,10,11,11,11,12,12,12,12,12,12,12,12,12,12
E01001422,EV motorcycles,Number,0,0,1,1,2,2,3,4,4,5,6,6,7,7,8,8,9,9,9,9,10,10,10,10,10,10,10,10,10,10
E01001423,EV motorcycles,Number,0,0,0,1,1,1,2,2,3,3,3,4,4,4,5,5,5,5,6,6,6,6,6,6,6,6,6,6,6,6
E01001424,EV motorcycles,Number,0,0,0,1,1,1,2,2,3,3,3,4,4,4,5,5,5,5,6,6,6,6,6,6,6,6,6,6,6,6
E01001425,EV motorcycles,Number,0,0,1,1,2,2,3,3,4,4,5,6,6,7,7,7,8,8,8,8,9,9,9,9,9,9,9,9,9,9
E01001426,EV motorcycles,Number,0,1,1,2,3,3,4,5,6,7,8,9,10,11,12,12,13,13,14,14,14,15,15,15,15,15,15,15,15,15
E01001427,EV motorcycles,Number,0,1,1,2,2,3,4,5,6,7,8,9,10,10,11,12,12,13,13,13,13,14,14,14,14,14,14,14,14,14
E01001428,EV motorcycles,Number,0,1,1,2,3,4,5,6,7,8,10,11,12,13,13,14,15,15,16,16,16,16,17,17,17,17,17,17,17,17
E01001429,EV motorcycles,Number,0,0,1,1,2,3,3,4,5,6,7,7,8,9,9,10,10,11,11,11,12,12,12,12,12,12,12,12,12,12
E01001430,EV motorcycles,Number,0,0,1,1,2,3,3,4,5,6,7,7,8,9,9,10,10,11,11,11,12,12,12,12,12,12,12,12,12,12
E01001431,EV motorcycles,Number,0,1,1,2,2,3,4,5,6,7,8,9,10,10,11,12,12,13,13,13,13,14,14,14,14,14,14,14,14,14
E01001432,EV motorcycles,Number,1,1,2,4,6,8,10,12,15,17,20,22,24,26,28,29,30,31,32,33,34,34,34,34,35,35,35,35,35,35
E01001433,EV motorcycles,Number,0,1,2,3,4,5,7,8,10,11,13,14,16,17,18,19,20,21,21,22,22,22,23,23,23,23,23,23,23,23
E01001434,EV motorcycles,Number,0,1,1,2,3,4,6,7,8,10,11,12,14,15,16,17,17,18,18,19,19,19,20,20,20,20,20,20,20,20
E01001435,EV motorcycles,Number,0,0,1,1,2,2,3,3,4,4,5,6,6,7,7,7,8,8,8,8,9,9,9,9,9,9,9,9,9,9
E01001436,EV motorcycles,Number,0,1,2,3,4,6,8,9,11,13,15,16,18,19,20,22,23,23,24,25,25,25,25,26,26,26,26,26,26,26
E01001437,EV motorcycles,Number,0,1,1,2,3,4,5,6,7,8,9,10,11,12,13,13,14,14,15,15,15,16,16,16,16,16,16,16,16,16
E01001438,EV motorcycles,Number,0,1,1,2,2,3,4,5,6,7,8,9,10,10,11,12,12,13,13,13,13,14,14,14,14,14,14,14,14,14
E01001439,EV motorcycles,Number,0,1,2,3,4,5,7,8,10,11,13,14,16,17,18,19,20,21,21,22,22,22,23,23,23,23,23,23,23,23
E01001440,EV motorcycles,Number,0,0,1,1,2,3,3,4,5,6,7,7,8,9,9,10,10,11,11,11,12,12,12,12,12,12,12,12,12,12
E01001441,EV motorcycles,Number,0,1,1,2,3,4,5,6,7,8,10,11,12,13,13,14,15,15,16,16,16,16,17,17,17,17,17,17,17,17
E01001442,EV motorcycles,Number,0,0,1,1,2,3,4,5,5,6,7,8,9,10,10,11,11,12,12,12,12,13,13,13,13,13,13,13,13,13
E01001444,EV motorcycles,Number,0,1,2,3,4,5,7,9,10,12,13,15,16,18,19,20,21,22,22,23,23,23,23,24,24,24,24,24,24,24
E01001445,EV motorcycles,Number,0,1,1,2,4,5,6,8,9,11,12,14,15,16,17,18,19,20,20,21,21,21,22,22,22,22,22,22,22,22
E01001446,EV motorcycles,Number,1,1,2,4,6,8,11,13,16,18,21,23,25,27,29,31,32,33,34,35,35,36,36,36,37,37,37,37,37,37
E01001447,EV motorcycles,Number,0,1,2,3,5,6,8,10,11,13,15,17,18,20,21,22,23,24,25,25,26,26,26,27,27,27,27,27,27,27
E01001448,EV motorcycles,Number,0,1,1,2,3,4,5,6,8,9,10,11,12,13,14,15,16,16,17,17,17,17,18,18,18,18,18,18,18,18
E01001449,EV motorcycles,Number,0,0,1,1,2,3,3,4,5,6,7,7,8,9,9,10,10,11,11,11,12,12,12,12,12,12,12,12,12,12
E01001450,EV motorcycles,Number,0,1,1,2,4,5,6,8,9,11,12,14,15,16,17,18,19,20,20,21,21,21,22,22,22,22,22,22,22,22
E01001451,EV motorcycles,Number,0,0,0,1,1,2,2,2,3,3,4,4,5,5,6,6,6,6,6,7,7,7,7,7,7,7,7,7,7,7
E01001452,EV motorcycles,Number,0,1,1,2,3,4,5,6,8,9,10,11,12,13,14,15,16,16,17,17,17,17,18,18,18,18,18,18,18,18
E01001453,EV motorcycles,Number,0,1,1,2,3,3,4,5,6,7,8,9,10,11,12,12,13,13,14,14,14,15,15,15,15,15,15,15,15,15
E01001454,EV motorcycles,Number,0,1,1,2,3,3,4,5,6,7,8,9,10,11,12,12,13,13,14,14,14,15,15,15,15,15,15,15,15,15
E01001455,EV motorcycles,Number,0,1,1,2,3,4,6,7,8,10,11,12,14,15,16,17,17,18,18,19,19,19,20,20,20,20,20,20,20,20
E01001456,EV motorcycles,Number,0,0,1,1,2,2,3,4,4,5,6,6,7,7,8,8,9,9,9,9,10,10,10,10,10,10,10,10,10,10
E01001457,EV motorcycles,Number,0,1,1,2,3,4,5,6,7,8,10,11,12,13,13,14,15,15,16,16,16,16,17,17,17,17,17,17,17,17
E01001458,EV motorcycles,Number,0,0,1,1,2,2,3,3,4,4,5,6,6,7,7,7,8,8,8,8,9,9,9,9,9,9,9,9,9,9
E01001459,EV motorcycles,Number,0,1,2,3,4,6,8,9,11,13,15,16,18,19,20,22,23,23,24,25,25,25,25,26,26,26,26,26,26,26
E01001460,EV motorcycles,Number,0,0,1,1,2,2,3,4,4,5,6,6,7,7,8,8,9,9,9,9,10,10,10,10,10,10,10,10,10,10
E01001461,EV motorcycles,Number,0,1,1,2,4,5,6,7,9,10,12,13,14,16,17,17,18,19,19,20,20,20,21,21,21,21,21,21,21,21
E01001462,EV motorcycles,Number,0,1,1,2,4,5,6,7,9,10,12,13,14,16,17,17,18,19,19,20,20,20,21,21,21,21,21,21,21,21
E01001463,EV motorcycles,Number,0,0,1,1,2,3,4,5,5,6,7,8,9,10,10,11,11,12,12,12,12,13,13,13,13,13,13,13,13,13
E01001464,EV motorcycles,Number,0,1,1,2,2,3,4,5,6,7,8,9,10,10,11,12,12,13,13,13,13,14,14,14,14,14,14,14,14,14
E01001465,EV motorcycles,Number,0,1,2,3,4,5,7,9,10,12,13,15,16,18,19,20,21,22,22,23,23,23,23,24,24,24,24,24,24,24
E01001466,EV motorcycles,Number,0,1,1,2,4,5,6,8,9,11,12,14,15,16,17,18,19,20,20,21,21,21,22,22,22,22,22,22,22,22
E01001467,EV motorcycles,Number,0,1,1,2,3,4,5,6,8,9,10,11,12,13,14,15,16,16,17,17,17,17,18,18,18,18,18,18,18,18
E01001468,EV motorcycles,Number,0,1,1,2,3,3,4,5,6,7,8,9,10,11,12,12,13,13,14,14,14,15,15,15,15,15,15,15,15,15
E01001469,EV motorcycles,Number,0,1,1,2,4,5,6,8,9,11,12,14,15,16,17,18,19,20,20,21,21,21,22,22,22,22,22,22,22,22
E01001470,EV motorcycles,Number,0,1,1,2,3,4,5,6,7,8,10,11,12,13,13,14,15,15,16,16,16,16,17,17,17,17,17,17,17,17
E01001471,EV motorcycles,Number,0,1,1,2,3,4,5,6,8,9,10,11,12,13,14,15,16,16,17,17,17,17,18,18,18,18,18,18,18,18
E01001472,EV motorcycles,Number,0,1,2,3,4,6,8,9,11,13,15,16,18,19,20,22,23,23,24,25,25,25,25,26,26,26,26,26,26,26
E01001473,EV motorcycles,Number,0,1,1,2,3,4,5,7,8,9,11,12,13,14,15,16,17,17,18,18,18,18,19,19,19,19,19,19,19,19
E01001474,EV motorcycles,Number,0,1,2,3,4,5,7,8,10,11,13,14,16,17,18,19,20,21,21,22,22,22,23,23,23,23,23,23,23,23
E01001475,EV motorcycles,Number,0,0,1,1,2,2,3,3,4,4,5,6,6,7,7,7,8,8,8,8,9,9,9,9,9,9,9,9,9,9
E01001476,EV motorcycles,Number,0,1,1,2,3,3,4,5,6,7,8,9,10,11,12,12,13,13,14,14,14,15,15,15,15,15,15,15,15,15
E01001477,EV motorcycles,Number,0,1,1,2,3,4,5,6,7,8,9,10,11,12,13,13,14,14,15,15,15,16,16,16,16,16,16,16,16,16
E01001478,EV motorcycles,Number,0,1,2,3,4,6,7,9,11,12,14,16,17,18,20,21,22,22,23,24,24,24,24,25,25,25,25,25,25,25
E01001479,EV motorcycles,Number,0,1,1,2,3,4,5,6,7,8,9,10,11,12,13,13,14,14,15,15,15,16,16,16,16,16,16,16,16,16
E01001480,EV motorcycles,Number,0,0,0,1,1,2,2,2,3,3,4,4,5,5,6,6,6,6,6,7,7,7,7,7,7,7,7,7,7,7
E01001481,EV motorcycles,Number,0,1,1,2,3,4,5,6,7,8,10,11,12,13,13,14,15,15,16,16,16,16,17,17,17,17,17,17,17,17
E01001482,EV motorcycles,Number,0,0,1,1,1,2,2,3,3,4,4,5,5,6,6,7,7,7,7,8,8,8,8,8,8,8,8,8,8,8
E01001483,EV motorcycles,Number,0,1,2,3,5,7,9,11,13,15,17,19,21,22,24,25,26,27,28,28,29,29,29,30,30,30,30,30,30,30
E01001484,EV motorcycles,Number,0,0,1,1,1,2,2,3,3,4,4,5,5,6,6,7,7,7,7,8,8,8,8,8,8,8,8,8,8,8
E01001485,EV motorcycles,Number,0,1,1,2,3,4,5,6,7,8,10,11,12,13,13,14,15,15,16,16,16,16,17,17,17,17,17,17,17,17
E01001486,EV motorcycles,Number,0,1,1,2,3,4,6,7,8,10,11,12,14,15,16,17,17,18,18,19,19,19,20,20,20,20,20,20,20,20
E01001487,EV motorcycles,Number,0,1,2,3,4,6,7,9,11,12,14,16,17,18,20,21,22,22,23,24,24,24,24,25,25,25,25,25,25,25
E01001488,EV motorcycles,Number,0,1,1,2,3,4,5,6,7,8,9,10,11,12,13,13,14,14,15,15,15,16,16,16,16,16,16,16,16,16
E01001489,EV motorcycles,Number,0,1,2,3,4,6,8,9,11,13,15,16,18,19,20,22,23,23,24,25,25,25,25,26,26,26,26,26,26,26
E01001491,EV motorcycles,Number,0,0,1,1,2,2,3,4,5,5,6,7,8,8,9,9,10,10,10,10,11,11,11,11,11,11,11,11,11,11
E01001492,EV motorcycles,Number,0,0,1,1,2,3,3,4,5,6,7,7,8,9,9,10,10,11,11,11,12,12,12,12,12,12,12,12,12,12
E01001493,EV motorcycles,Number,0,1,1,2,4,5,6,7,9,10,12,13,14,16,17,17,18,19,19,20,20,20,21,21,21,21,21,21,21,21
E01001494,EV motorcycles,Number,0,1,1,2,3,4,5,6,8,9,10,11,12,13,14,15,16,16,17,17,17,17,18,18,18,18,18,18,18,18
E01001495,EV motorcycles,Number,0,1,2,3,4,6,8,9,11,13,15,16,18,19,20,22,23,23,24,25,25,25,25,26,26,26,26,26,26,26
E01001496,EV motorcycles,Number,1,1,2,4,6,8,10,12,15,17,20,22,24,26,28,29,30,31,32,33,34,34,34,34,35,35,35,35,35,35
E01001497,EV motorcycles,Number,0,1,2,3,5,6,8,10,11,13,15,17,18,20,21,22,23,24,25,25,26,26,26,27,27,27,27,27,27,27
E01001498,EV motorcycles,Number,0,1,2,3,5,6,8,10,12,14,16,17,19,21,22,23,24,25,26,26,27,27,27,28,28,28,28,28,28,28
E01001499,EV motorcycles,Number,0,1,1,2,3,4,5,6,8,9,10,11,12,13,14,15,16,16,17,17,17,17,18,18,18,18,18,18,18,18
E01001500,EV motorcycles,Number,0,1,1,2,3,4,5,6,8,9,10,11,12,13,14,15,16,16,17,17,17,17,18,18,18,18,18,18,18,18
E01001501,EV motorcycles,Number,0,1,1,2,3,4,6,7,8,10,11,12,14,15,16,17,17,18,18,19,19,19,20,20,20,20,20,20,20,20
E01001502,EV motorcycles,Number,0,1,1,2,3,4,5,6,8,9,10,11,12,13,14,15,16,16,17,17,17,17,18,18,18,18,18,18,18,18
E01001503,EV motorcycles,Number,0,1,2,3,4,5,7,8,10,11,13,14,16,17,18,19,20,21,21,22,22,22,23,23,23,23,23,23,23,23
E01001504,EV motorcycles,Number,0,1,1,2,4,5,6,8,9,11,12,14,15,16,17,18,19,20,20,21,21,21,22,22,22,22,22,22,22,22
E01001505,EV motorcycles,Number,0,1,2,3,4,5,7,8,10,11,13,14,16,17,18,19,20,21,21,22,22,22,23,23,23,23,23,23,23,23
E01001506,EV motorcycles,Number,0,1,2,3,5,6,8,10,12,14,16,17,19,21,22,23,24,25,26,26,27,27,27,28,28,28,28,28,28,28
E01001507,EV motorcycles,Number,0,1,1,2,3,3,4,5,6,7,8,9,10,11,12,12,13,13,14,14,14,15,15,15,15,15,15,15,15,15
E01001508,EV motorcycles,Number,0,1,1,2,3,3,4,5,6,7,8,9,10,11,12,12,13,13,14,14,14,15,15,15,15,15,15,15,15,15
E01001509,EV motorcycles,Number,0,1,1,2,4,5,6,8,9,11,12,14,15,16,17,18,19,20,20,21,21,21,22,22,22,22,22,22,22,22
E01001510,EV motorcycles,Number,0,0,0,0,0,0,0,0,0,0,0,0,0,0,0,0,0,0,0,0,0,0,0,0,0,0,0,0,0,0
E01001511,EV motorcycles,Number,0,1,2,3,5,6,8,10,12,14,16,17,19,21,22,23,24,25,26,26,27,27,27,28,28,28,28,28,28,28
E01001512,EV motorcycles,Number,0,1,2,3,4,5,7,8,10,11,13,14,16,17,18,19,20,21,21,22,22,22,23,23,23,23,23,23,23,23
E01001513,EV motorcycles,Number,0,1,2,3,5,7,9,11,13,15,17,19,21,23,24,26,27,28,29,29,30,30,30,31,31,31,31,31,31,31
E01001514,EV motorcycles,Number,0,1,1,2,3,4,5,6,7,8,10,11,12,13,13,14,15,15,16,16,16,16,17,17,17,17,17,17,17,17
E01001515,EV motorcycles,Number,0,1,2,3,5,6,8,10,11,13,15,17,18,20,21,22,23,24,25,25,26,26,26,27,27,27,27,27,27,27
E01001516,EV motorcycles,Number,0,0,1,1,2,2,3,4,4,5,6,6,7,7,8,8,9,9,9,9,10,10,10,10,10,10,10,10,10,10
E01001517,EV motorcycles,Number,0,1,1,2,4,5,6,7,9,10,12,13,14,16,17,17,18,19,19,20,20,20,21,21,21,21,21,21,21,21
E01001518,EV motorcycles,Number,0,1,2,3,4,5,7,8,10,11,13,14,16,17,18,19,20,21,21,22,22,22,23,23,23,23,23,23,23,23
E01001519,EV motorcycles,Number,0,1,2,3,4,5,7,8,10,11,13,14,16,17,18,19,20,21,21,22,22,22,23,23,23,23,23,23,23,23
E01001520,EV motorcycles,Number,1,2,4,6,9,13,16,20,24,28,31,35,38,41,44,47,49,50,52,53,54,54,55,55,55,56,56,56,56,56
E01001521,EV motorcycles,Number,0,1,2,3,4,6,7,9,11,12,14,16,17,18,20,21,22,22,23,24,24,24,24,25,25,25,25,25,25,25
E01001522,EV motorcycles,Number,0,0,1,1,2,3,4,5,5,6,7,8,9,10,10,11,11,12,12,12,12,13,13,13,13,13,13,13,13,13
E01001523,EV motorcycles,Number,0,0,1,1,2,2,3,4,5,5,6,7,8,8,9,9,10,10,10,10,11,11,11,11,11,11,11,11,11,11
E01001524,EV motorcycles,Number,0,0,1,1,2,2,3,4,5,5,6,7,8,8,9,9,10,10,10,10,11,11,11,11,11,11,11,11,11,11
E01001525,EV motorcycles,Number,0,0,1,1,2,3,3,4,5,6,7,7,8,9,9,10,10,11,11,11,12,12,12,12,12,12,12,12,12,12
E01001526,EV motorcycles,Number,0,1,1,2,3,4,5,7,8,9,11,12,13,14,15,16,17,17,18,18,18,18,19,19,19,19,19,19,19,19
E01001527,EV motorcycles,Number,0,1,1,2,3,4,5,6,8,9,10,11,12,13,14,15,16,16,17,17,17,17,18,18,18,18,18,18,18,18
E01001528,EV motorcycles,Number,0,0,1,1,2,3,3,4,5,6,7,7,8,9,9,10,10,11,11,11,12,12,12,12,12,12,12,12,12,12
E01001529,EV motorcycles,Number,1,2,3,5,7,10,13,16,19,22,25,27,30,33,35,37,38,40,41,42,42,43,43,43,44,44,44,44,44,44
E01001530,EV motorcycles,Number,0,1,1,2,2,3,4,5,6,7,8,9,10,10,11,12,12,13,13,13,13,14,14,14,14,14,14,14,14,14
E01001531,EV motorcycles,Number,0,1,1,2,3,4,5,6,7,8,10,11,12,13,13,14,15,15,16,16,16,16,17,17,17,17,17,17,17,17
E01001532,EV motorcycles,Number,0,1,1,2,4,5,6,7,9,10,12,13,14,16,17,17,18,19,19,20,20,20,21,21,21,21,21,21,21,21
E01001533,EV motorcycles,Number,0,0,1,1,1,2,2,3,3,4,4,5,5,6,6,7,7,7,7,8,8,8,8,8,8,8,8,8,8,8
E01001534,EV motorcycles,Number,0,1,2,3,4,5,7,8,10,11,13,14,16,17,18,19,20,21,21,22,22,22,23,23,23,23,23,23,23,23
E01001535,EV motorcycles,Number,0,0,1,1,2,2,3,4,5,5,6,7,8,8,9,9,10,10,10,10,11,11,11,11,11,11,11,11,11,11
E01001536,EV motorcycles,Number,0,1,2,3,4,5,7,9,10,12,13,15,16,18,19,20,21,22,22,23,23,23,23,24,24,24,24,24,24,24
E01001537,EV motorcycles,Number,0,1,2,3,4,5,7,8,10,11,13,14,16,17,18,19,20,21,21,22,22,22,23,23,23,23,23,23,23,23
E01001538,EV motorcycles,Number,0,0,1,1,2,2,3,4,5,5,6,7,8,8,9,9,10,10,10,10,11,11,11,11,11,11,11,11,11,11
E01001539,EV motorcycles,Number,0,1,2,3,4,6,8,9,11,13,15,16,18,19,20,22,23,23,24,25,25,25,25,26,26,26,26,26,26,26
E01001540,EV motorcycles,Number,0,1,2,3,4,5,7,8,10,11,13,14,16,17,18,19,20,21,21,22,22,22,23,23,23,23,23,23,23,23
E01001541,EV motorcycles,Number,0,0,1,1,2,2,3,4,5,5,6,7,8,8,9,9,10,10,10,10,11,11,11,11,11,11,11,11,11,11
E01001542,EV motorcycles,Number,0,1,2,3,4,6,7,9,11,12,14,16,17,18,20,21,22,22,23,24,24,24,24,25,25,25,25,25,25,25
E01001543,EV motorcycles,Number,0,1,1,2,4,5,6,8,9,11,12,14,15,16,17,18,19,20,20,21,21,21,22,22,22,22,22,22,22,22
E01001544,EV motorcycles,Number,0,1,2,3,5,7,9,11,13,15,17,19,21,23,24,26,27,28,29,29,30,30,30,31,31,31,31,31,31,31
E01001545,EV motorcycles,Number,0,1,1,2,3,4,5,6,7,8,9,10,11,12,13,13,14,14,15,15,15,16,16,16,16,16,16,16,16,16
E01001546,EV motorcycles,Number,0,1,1,2,3,4,5,6,7,8,10,11,12,13,13,14,15,15,16,16,16,16,17,17,17,17,17,17,17,17
E01001547,EV motorcycles,Number,0,1,2,4,6,8,10,12,14,17,19,21,23,25,27,28,30,31,31,32,33,33,33,33,34,34,34,34,34,34
E01001548,EV motorcycles,Number,0,1,2,3,4,6,7,9,11,12,14,16,17,18,20,21,22,22,23,24,24,24,24,25,25,25,25,25,25,25
E01001549,EV motorcycles,Number,0,1,1,2,3,4,5,6,7,8,9,10,11,12,13,13,14,14,15,15,15,16,16,16,16,16,16,16,16,16
E01001550,EV motorcycles,Number,0,1,1,2,3,4,6,7,8,10,11,12,14,15,16,17,17,18,18,19,19,19,20,20,20,20,20,20,20,20
E01001551,EV motorcycles,Number,0,1,1,2,4,5,6,7,9,10,12,13,14,16,17,17,18,19,19,20,20,20,21,21,21,21,21,21,21,21
E01001552,EV motorcycles,Number,0,1,2,3,5,6,8,10,12,14,16,17,19,21,22,23,24,25,26,26,27,27,27,28,28,28,28,28,28,28
E01001553,EV motorcycles,Number,0,1,2,3,5,7,9,11,13,15,17,19,21,23,24,26,27,28,29,29,30,30,30,31,31,31,31,31,31,31
E01001554,EV motorcycles,Number,0,0,1,1,2,2,3,4,5,5,6,7,8,8,9,9,10,10,10,10,11,11,11,11,11,11,11,11,11,11
E01001555,EV motorcycles,Number,0,0,1,1,2,2,3,4,4,5,6,6,7,7,8,8,9,9,9,9,10,10,10,10,10,10,10,10,10,10
E01001556,EV motorcycles,Number,0,0,1,1,2,3,3,4,5,6,7,7,8,9,9,10,10,11,11,11,12,12,12,12,12,12,12,12,12,12
E01001557,EV motorcycles,Number,0,0,1,1,2,3,4,5,5,6,7,8,9,10,10,11,11,12,12,12,12,13,13,13,13,13,13,13,13,13
E01001558,EV motorcycles,Number,0,1,1,2,3,4,5,6,7,8,10,11,12,13,13,14,15,15,16,16,16,16,17,17,17,17,17,17,17,17
E01001559,EV motorcycles,Number,0,1,1,2,3,4,5,6,7,8,9,10,11,12,13,13,14,14,15,15,15,16,16,16,16,16,16,16,16,16
E01001560,EV motorcycles,Number,0,0,1,1,2,2,3,4,4,5,6,6,7,7,8,8,9,9,9,9,10,10,10,10,10,10,10,10,10,10
E01001562,EV motorcycles,Number,0,0,1,1,1,2,2,3,3,4,4,5,5,6,6,7,7,7,7,8,8,8,8,8,8,8,8,8,8,8
E01001563,EV motorcycles,Number,0,1,1,2,3,4,5,6,7,8,10,11,12,13,13,14,15,15,16,16,16,16,17,17,17,17,17,17,17,17
E01001564,EV motorcycles,Number,0,0,1,1,2,2,3,4,5,5,6,7,8,8,9,9,10,10,10,10,11,11,11,11,11,11,11,11,11,11
E01001565,EV motorcycles,Number,0,0,0,1,1,2,2,2,3,3,4,4,5,5,6,6,6,6,6,7,7,7,7,7,7,7,7,7,7,7
E01001566,EV motorcycles,Number,0,1,1,2,3,3,4,5,6,7,8,9,10,11,12,12,13,13,14,14,14,15,15,15,15,15,15,15,15,15
E01001567,EV motorcycles,Number,0,0,1,1,2,3,4,5,5,6,7,8,9,10,10,11,11,12,12,12,12,13,13,13,13,13,13,13,13,13
E01001568,EV motorcycles,Number,0,0,0,1,1,1,2,2,3,3,3,4,4,4,5,5,5,5,6,6,6,6,6,6,6,6,6,6,6,6
E01001569,EV motorcycles,Number,0,1,1,2,3,4,5,6,7,8,10,11,12,13,13,14,15,15,16,16,16,16,17,17,17,17,17,17,17,17
E01001570,EV motorcycles,Number,0,1,1,2,3,4,6,7,8,10,11,12,14,15,16,17,17,18,18,19,19,19,20,20,20,20,20,20,20,20
E01001571,EV motorcycles,Number,0,1,1,2,3,4,5,6,7,8,10,11,12,13,13,14,15,15,16,16,16,16,17,17,17,17,17,17,17,17
E01001572,EV motorcycles,Number,0,1,1,2,3,4,5,7,8,9,11,12,13,14,15,16,17,17,18,18,18,18,19,19,19,19,19,19,19,19
E01001573,EV motorcycles,Number,0,1,1,2,3,4,5,6,8,9,10,11,12,13,14,15,16,16,17,17,17,17,18,18,18,18,18,18,18,18
E01001574,EV motorcycles,Number,0,1,1,2,2,3,4,5,6,7,8,9,10,10,11,12,12,13,13,13,13,14,14,14,14,14,14,14,14,14
E01001575,EV motorcycles,Number,0,0,0,0,0,0,0,0,0,0,0,0,0,0,0,0,0,0,0,0,0,0,0,0,0,0,0,0,0,0
E01001576,EV motorcycles,Number,0,0,1,1,2,3,4,5,5,6,7,8,9,10,10,11,11,12,12,12,12,13,13,13,13,13,13,13,13,13
E01001577,EV motorcycles,Number,1,1,2,4,6,8,11,13,16,18,21,23,25,27,29,31,32,33,34,35,35,36,36,36,37,37,37,37,37,37
E01001578,EV motorcycles,Number,0,1,2,3,5,7,9,11,13,15,17,19,21,22,24,25,26,27,28,28,29,29,29,30,30,30,30,30,30,30
E01001579,EV motorcycles,Number,0,0,1,1,2,2,3,3,4,4,5,6,6,7,7,7,8,8,8,8,9,9,9,9,9,9,9,9,9,9
E01001580,EV motorcycles,Number,1,2,3,6,9,12,15,19,22,26,30,33,36,39,42,44,46,48,49,50,51,51,52,52,52,53,53,53,53,53
E01001581,EV motorcycles,Number,0,1,1,2,2,3,4,5,6,7,8,9,10,10,11,12,12,13,13,13,13,14,14,14,14,14,14,14,14,14
E01001582,EV motorcycles,Number,0,1,2,3,4,6,7,9,11,12,14,16,17,18,20,21,22,22,23,24,24,24,24,25,25,25,25,25,25,25
E01001583,EV motorcycles,Number,0,1,1,2,3,4,6,7,8,10,11,12,14,15,16,17,17,18,18,19,19,19,20,20,20,20,20,20,20,20
E01001584,EV motorcycles,Number,0,1,1,2,3,4,5,6,7,8,10,11,12,13,13,14,15,15,16,16,16,16,17,17,17,17,17,17,17,17
E01001585,EV motorcycles,Number,0,1,1,2,3,4,6,7,8,10,11,12,14,15,16,17,17,18,18,19,19,19,20,20,20,20,20,20,20,20
E01001586,EV motorcycles,Number,0,1,1,2,3,4,5,6,7,8,9,10,11,12,13,13,14,14,15,15,15,16,16,16,16,16,16,16,16,16
E01001587,EV motorcycles,Number,0,1,1,2,3,4,5,7,8,9,11,12,13,14,15,16,17,17,18,18,18,18,19,19,19,19,19,19,19,19
E01001588,EV motorcycles,Number,0,1,1,2,3,4,5,6,7,8,9,10,11,12,13,13,14,14,15,15,15,16,16,16,16,16,16,16,16,16
E01001589,EV motorcycles,Number,0,1,2,3,5,6,8,10,11,13,15,17,18,20,21,22,23,24,25,25,26,26,26,27,27,27,27,27,27,27
E01001590,EV motorcycles,Number,0,1,2,3,4,5,7,9,10,12,13,15,16,18,19,20,21,22,22,23,23,23,23,24,24,24,24,24,24,24
E01001591,EV motorcycles,Number,0,1,1,2,4,5,6,8,9,11,12,14,15,16,17,18,19,20,20,21,21,21,22,22,22,22,22,22,22,22
E01001592,EV motorcycles,Number,0,1,2,3,4,5,7,9,10,12,13,15,16,18,19,20,21,22,22,23,23,23,23,24,24,24,24,24,24,24
E01001593,EV motorcycles,Number,0,1,1,2,3,4,5,6,8,9,10,11,12,13,14,15,16,16,17,17,17,17,18,18,18,18,18,18,18,18
E01001594,EV motorcycles,Number,0,1,1,2,4,5,6,8,9,11,12,14,15,16,17,18,19,20,20,21,21,21,22,22,22,22,22,22,22,22
E01001595,EV motorcycles,Number,0,0,1,1,2,3,4,5,5,6,7,8,9,10,10,11,11,12,12,12,12,13,13,13,13,13,13,13,13,13
E01001596,EV motorcycles,Number,1,2,3,5,8,11,14,17,20,24,27,30,33,35,38,40,42,43,44,45,46,47,47,47,48,48,48,48,48,48
E01001597,EV motorcycles,Number,0,1,2,4,5,7,9,11,14,16,18,20,22,24,25,27,28,29,30,30,31,31,31,32,32,32,32,32,32,32
E01001598,EV motorcycles,Number,0,1,2,3,5,6,8,10,12,14,16,17,19,21,22,23,24,25,26,26,27,27,27,28,28,28,28,28,28,28
E01001599,EV motorcycles,Number,0,1,2,3,5,6,8,10,12,14,16,17,19,21,22,23,24,25,26,26,27,27,27,28,28,28,28,28,28,28
E01001600,EV motorcycles,Number,0,1,2,4,5,7,9,11,14,16,18,20,22,24,25,27,28,29,30,30,31,31,31,32,32,32,32,32,32,32
E01001601,EV motorcycles,Number,0,1,1,2,3,4,5,6,8,9,10,11,12,13,14,15,16,16,17,17,17,17,18,18,18,18,18,18,18,18
E01001602,EV motorcycles,Number,0,1,2,3,5,6,8,10,12,14,16,17,19,21,22,23,24,25,26,26,27,27,27,28,28,28,28,28,28,28
E01001603,EV motorcycles,Number,0,1,2,3,5,7,9,11,13,15,17,19,21,23,24,26,27,28,29,29,30,30,30,31,31,31,31,31,31,31
E01001604,EV motorcycles,Number,0,1,1,2,3,3,4,5,6,7,8,9,10,11,12,12,13,13,14,14,14,15,15,15,15,15,15,15,15,15
E01001605,EV motorcycles,Number,1,1,3,4,7,9,11,14,16,19,22,24,27,29,31,32,34,35,36,37,37,38,38,38,39,39,39,39,39,39
E01001606,EV motorcycles,Number,0,1,2,4,6,7,10,12,14,16,18,21,23,24,26,27,29,30,31,31,32,32,32,33,33,33,33,33,33,33
E01001607,EV motorcycles,Number,0,1,1,2,3,4,5,7,8,9,11,12,13,14,15,16,17,17,18,18,18,18,19,19,19,19,19,19,19,19
E01001608,EV motorcycles,Number,0,1,2,3,5,7,9,11,13,15,17,19,21,22,24,25,26,27,28,28,29,29,29,30,30,30,30,30,30,30
E01001609,EV motorcycles,Number,0,1,2,3,4,6,8,9,11,13,15,16,18,19,20,22,23,23,24,25,25,25,25,26,26,26,26,26,26,26
E01001610,EV motorcycles,Number,1,1,2,4,6,8,11,13,16,18,21,23,25,27,29,31,32,33,34,35,35,36,36,36,37,37,37,37,37,37
E01001611,EV motorcycles,Number,0,1,2,3,5,7,9,11,13,15,17,19,21,23,24,26,27,28,29,29,30,30,30,31,31,31,31,31,31,31
E01001613,EV motorcycles,Number,1,1,2,4,6,8,11,13,16,18,21,23,25,27,29,31,32,33,34,35,35,36,36,36,37,37,37,37,37,37
E01001614,EV motorcycles,Number,1,1,2,4,6,9,11,13,16,19,21,24,26,28,30,32,33,34,35,36,36,37,37,37,38,38,38,38,38,38
E01001615,EV motorcycles,Number,0,1,2,3,5,7,9,11,13,15,17,19,21,23,24,26,27,28,29,29,30,30,30,31,31,31,31,31,31,31
E01001617,EV motorcycles,Number,0,1,1,2,3,4,5,6,7,8,9,10,11,12,13,13,14,14,15,15,15,16,16,16,16,16,16,16,16,16
E01001618,EV motorcycles,Number,0,1,2,4,6,8,10,12,14,17,19,21,23,25,27,28,30,31,31,32,33,33,33,33,34,34,34,34,34,34
E01001619,EV motorcycles,Number,0,1,2,3,4,6,8,9,11,13,15,16,18,19,20,22,23,23,24,25,25,25,25,26,26,26,26,26,26,26
E01001620,EV motorcycles,Number,0,1,2,3,5,7,8,10,12,14,16,18,20,21,23,24,25,26,27,27,28,28,28,29,29,29,29,29,29,29
E01001621,EV motorcycles,Number,0,1,2,4,6,7,10,12,14,16,18,21,23,24,26,27,29,30,31,31,32,32,32,33,33,33,33,33,33,33
E01001623,EV motorcycles,Number,0,1,2,4,6,8,10,12,14,17,19,21,23,25,27,28,30,31,31,32,33,33,33,33,34,34,34,34,34,34
E01001624,EV motorcycles,Number,0,1,2,3,4,5,7,9,10,12,13,15,16,18,19,20,21,22,22,23,23,23,23,24,24,24,24,24,24,24
E01001625,EV motorcycles,Number,0,1,2,3,5,7,9,11,13,15,17,19,21,22,24,25,26,27,28,28,29,29,29,30,30,30,30,30,30,30
E01001629,EV motorcycles,Number,0,0,1,1,2,3,3,4,5,6,7,7,8,9,9,10,10,11,11,11,12,12,12,12,12,12,12,12,12,12
E01001631,EV motorcycles,Number,0,0,1,1,2,2,3,4,5,5,6,7,8,8,9,9,10,10,10,10,11,11,11,11,11,11,11,11,11,11
E01001632,EV motorcycles,Number,0,0,1,1,2,3,4,5,5,6,7,8,9,10,10,11,11,12,12,12,12,13,13,13,13,13,13,13,13,13
E01001633,EV motorcycles,Number,0,0,1,1,2,3,4,5,5,6,7,8,9,10,10,11,11,12,12,12,12,13,13,13,13,13,13,13,13,13
E01001634,EV motorcycles,Number,0,0,0,1,1,1,2,2,3,3,3,4,4,4,5,5,5,5,6,6,6,6,6,6,6,6,6,6,6,6
E01001635,EV motorcycles,Number,0,1,1,2,3,3,4,5,6,7,8,9,10,11,12,12,13,13,14,14,14,15,15,15,15,15,15,15,15,15
E01001636,EV motorcycles,Number,0,1,1,2,3,4,5,7,8,9,11,12,13,14,15,16,17,17,18,18,18,18,19,19,19,19,19,19,19,19
E01001637,EV motorcycles,Number,0,1,1,2,3,4,5,6,8,9,10,11,12,13,14,15,16,16,17,17,17,17,18,18,18,18,18,18,18,18
E01001638,EV motorcycles,Number,0,0,1,1,2,3,3,4,5,6,7,7,8,9,9,10,10,11,11,11,12,12,12,12,12,12,12,12,12,12
E01001640,EV motorcycles,Number,0,1,2,4,6,8,10,12,14,17,19,21,23,25,27,28,30,31,31,32,33,33,33,33,34,34,34,34,34,34
E01001641,EV motorcycles,Number,0,0,1,1,2,3,3,4,5,6,7,7,8,9,9,10,10,11,11,11,12,12,12,12,12,12,12,12,12,12
E01001642,EV motorcycles,Number,0,1,1,2,3,4,5,6,7,8,9,10,11,12,13,13,14,14,15,15,15,16,16,16,16,16,16,16,16,16
E01001644,EV motorcycles,Number,0,1,2,3,5,7,9,11,13,15,17,19,21,23,24,26,27,28,29,29,30,30,30,31,31,31,31,31,31,31
E01001645,EV motorcycles,Number,0,1,2,3,4,5,7,9,10,12,13,15,16,18,19,20,21,22,22,23,23,23,23,24,24,24,24,24,24,24
E01001646,EV motorcycles,Number,1,1,2,4,6,8,10,12,15,17,20,22,24,26,28,29,30,31,32,33,34,34,34,34,35,35,35,35,35,35
E01001647,EV motorcycles,Number,1,1,2,4,6,8,10,13,15,18,20,22,25,27,28,30,31,32,33,34,35,35,35,35,36,36,36,36,36,36
E01001648,EV motorcycles,Number,0,1,1,2,4,5,6,7,9,10,12,13,14,16,17,17,18,19,19,20,20,20,21,21,21,21,21,21,21,21
E01001649,EV motorcycles,Number,0,1,2,3,5,7,9,11,13,15,17,19,21,23,24,26,27,28,29,29,30,30,30,31,31,31,31,31,31,31
E01001650,EV motorcycles,Number,0,1,1,2,3,4,5,6,7,8,9,10,11,12,13,13,14,14,15,15,15,16,16,16,16,16,16,16,16,16
E01001651,EV motorcycles,Number,0,1,1,2,3,4,5,6,8,9,10,11,12,13,14,15,16,16,17,17,17,17,18,18,18,18,18,18,18,18
E01001652,EV motorcycles,Number,0,1,1,2,3,3,4,5,6,7,8,9,10,11,12,12,13,13,14,14,14,15,15,15,15,15,15,15,15,15
E01001653,EV motorcycles,Number,0,1,2,3,5,6,8,10,12,14,16,17,19,21,22,23,24,25,26,26,27,27,27,28,28,28,28,28,28,28
E01001654,EV motorcycles,Number,0,1,1,2,3,4,5,7,8,9,11,12,13,14,15,16,17,17,18,18,18,18,19,19,19,19,19,19,19,19
E01001655,EV motorcycles,Number,0,1,2,3,4,5,7,9,10,12,13,15,16,18,19,20,21,22,22,23,23,23,23,24,24,24,24,24,24,24
E01001656,EV motorcycles,Number,0,1,1,2,3,4,6,7,8,10,11,12,14,15,16,17,17,18,18,19,19,19,20,20,20,20,20,20,20,20
E01001657,EV motorcycles,Number,0,1,1,2,3,4,5,6,8,9,10,11,12,13,14,15,16,16,17,17,17,17,18,18,18,18,18,18,18,18
E01001658,EV motorcycles,Number,0,1,1,2,3,4,5,7,8,9,11,12,13,14,15,16,17,17,18,18,18,18,19,19,19,19,19,19,19,19
E01001659,EV motorcycles,Number,1,1,2,4,6,8,10,13,15,18,20,22,25,27,28,30,31,32,33,34,35,35,35,35,36,36,36,36,36,36
E01001660,EV motorcycles,Number,0,1,1,2,3,4,6,7,8,10,11,12,14,15,16,17,17,18,18,19,19,19,20,20,20,20,20,20,20,20
E01001661,EV motorcycles,Number,0,1,1,2,3,4,5,6,8,9,10,11,12,13,14,15,16,16,17,17,17,17,18,18,18,18,18,18,18,18
E01001662,EV motorcycles,Number,0,1,2,3,5,7,9,11,13,15,17,19,21,23,24,26,27,28,29,29,30,30,30,31,31,31,31,31,31,31
E01001664,EV motorcycles,Number,0,1,1,2,2,3,4,5,6,7,8,9,10,10,11,12,12,13,13,13,13,14,14,14,14,14,14,14,14,14
E01001665,EV motorcycles,Number,0,1,1,2,2,3,4,5,6,7,8,9,10,10,11,12,12,13,13,13,13,14,14,14,14,14,14,14,14,14
E01001666,EV motorcycles,Number,0,1,1,2,3,4,5,6,8,9,10,11,12,13,14,15,16,16,17,17,17,17,18,18,18,18,18,18,18,18
E01001667,EV motorcycles,Number,1,2,3,5,8,10,13,16,19,22,25,28,31,33,35,37,39,40,42,42,43,44,44,44,45,45,45,45,45,45
E01001668,EV motorcycles,Number,0,1,2,3,5,7,9,11,13,15,17,19,21,23,24,26,27,28,29,29,30,30,30,31,31,31,31,31,31,31
E01001669,EV motorcycles,Number,0,1,2,3,5,6,8,10,12,14,16,17,19,21,22,23,24,25,26,26,27,27,27,28,28,28,28,28,28,28
E01001671,EV motorcycles,Number,0,0,1,1,2,3,3,4,5,6,7,7,8,9,9,10,10,11,11,11,12,12,12,12,12,12,12,12,12,12
E01001672,EV motorcycles,Number,0,1,1,2,3,4,5,6,7,8,10,11,12,13,13,14,15,15,16,16,16,16,17,17,17,17,17,17,17,17
E01001673,EV motorcycles,Number,0,0,1,1,2,3,3,4,5,6,7,7,8,9,9,10,10,11,11,11,12,12,12,12,12,12,12,12,12,12
E01001674,EV motorcycles,Number,0,0,1,1,2,3,4,5,5,6,7,8,9,10,10,11,11,12,12,12,12,13,13,13,13,13,13,13,13,13
E01001675,EV motorcycles,Number,0,0,1,1,2,3,3,4,5,6,7,7,8,9,9,10,10,11,11,11,12,12,12,12,12,12,12,12,12,12
E01001676,EV motorcycles,Number,0,1,1,2,3,3,4,5,6,7,8,9,10,11,12,12,13,13,14,14,14,15,15,15,15,15,15,15,15,15
E01001677,EV motorcycles,Number,0,1,2,4,5,7,9,11,14,16,18,20,22,24,25,27,28,29,30,30,31,31,31,32,32,32,32,32,32,32
E01001678,EV motorcycles,Number,0,1,2,3,4,6,7,9,11,12,14,16,17,18,20,21,22,22,23,24,24,24,24,25,25,25,25,25,25,25
E01001679,EV motorcycles,Number,0,1,2,3,5,7,9,11,13,15,17,19,21,23,24,26,27,28,29,29,30,30,30,31,31,31,31,31,31,31
E01001680,EV motorcycles,Number,0,1,2,4,5,7,9,11,14,16,18,20,22,24,25,27,28,29,30,30,31,31,31,32,32,32,32,32,32,32
E01001681,EV motorcycles,Number,0,1,1,2,3,4,6,7,8,10,11,12,14,15,16,17,17,18,18,19,19,19,20,20,20,20,20,20,20,20
E01001682,EV motorcycles,Number,0,1,2,4,6,8,10,12,14,17,19,21,23,25,27,28,30,31,31,32,33,33,33,33,34,34,34,34,34,34
E01001683,EV motorcycles,Number,0,0,1,1,2,2,3,4,5,5,6,7,8,8,9,9,10,10,10,10,11,11,11,11,11,11,11,11,11,11
E01001684,EV motorcycles,Number,0,1,2,3,4,6,7,9,11,12,14,16,17,18,20,21,22,22,23,24,24,24,24,25,25,25,25,25,25,25
E01001685,EV motorcycles,Number,0,1,1,2,2,3,4,5,6,7,8,9,10,10,11,12,12,13,13,13,13,14,14,14,14,14,14,14,14,14
E01001686,EV motorcycles,Number,1,1,2,4,6,8,10,12,15,17,20,22,24,26,28,29,30,31,32,33,34,34,34,34,35,35,35,35,35,35
E01001687,EV motorcycles,Number,1,1,2,4,6,8,10,12,15,17,20,22,24,26,28,29,30,31,32,33,34,34,34,34,35,35,35,35,35,35
E01001688,EV motorcycles,Number,0,1,1,2,3,4,5,6,7,8,10,11,12,13,13,14,15,15,16,16,16,16,17,17,17,17,17,17,17,17
E01001690,EV motorcycles,Number,0,0,1,1,2,2,3,3,4,4,5,6,6,7,7,7,8,8,8,8,9,9,9,9,9,9,9,9,9,9
E01001692,EV motorcycles,Number,0,0,0,0,0,0,0,0,0,0,0,0,0,0,0,0,0,0,0,0,0,0,0,0,0,0,0,0,0,0
E01001693,EV motorcycles,Number,0,0,1,1,2,3,4,5,5,6,7,8,9,10,10,11,11,12,12,12,12,13,13,13,13,13,13,13,13,13
E01001694,EV motorcycles,Number,0,1,1,2,3,4,5,6,7,8,10,11,12,13,13,14,15,15,16,16,16,16,17,17,17,17,17,17,17,17
E01001695,EV motorcycles,Number,0,0,0,0,0,0,0,0,0,0,0,0,0,0,0,0,0,0,0,0,0,0,0,0,0,0,0,0,0,0
E01001696,EV motorcycles,Number,0,0,1,1,2,2,3,3,4,4,5,6,6,7,7,7,8,8,8,8,9,9,9,9,9,9,9,9,9,9
E01001697,EV motorcycles,Number,0,1,2,3,4,5,7,9,10,12,13,15,16,18,19,20,21,22,22,23,23,23,23,24,24,24,24,24,24,24
E01001698,EV motorcycles,Number,0,0,1,1,2,3,4,5,5,6,7,8,9,10,10,11,11,12,12,12,12,13,13,13,13,13,13,13,13,13
E01001699,EV motorcycles,Number,0,1,1,2,3,4,5,6,8,9,10,11,12,13,14,15,16,16,17,17,17,17,18,18,18,18,18,18,18,18
E01001700,EV motorcycles,Number,0,1,1,2,2,3,4,5,6,7,8,9,10,10,11,12,12,13,13,13,13,14,14,14,14,14,14,14,14,14
E01001701,EV motorcycles,Number,0,1,2,3,4,6,7,9,11,12,14,16,17,18,20,21,22,22,23,24,24,24,24,25,25,25,25,25,25,25
E01001702,EV motorcycles,Number,0,0,1,1,2,2,3,4,4,5,6,6,7,7,8,8,9,9,9,9,10,10,10,10,10,10,10,10,10,10
E01001703,EV motorcycles,Number,0,1,1,2,2,3,4,5,6,7,8,9,10,10,11,12,12,13,13,13,13,14,14,14,14,14,14,14,14,14
E01001704,EV motorcycles,Number,0,1,1,2,2,3,4,5,6,7,8,9,10,10,11,12,12,13,13,13,13,14,14,14,14,14,14,14,14,14
E01001705,EV motorcycles,Number,0,1,1,2,2,3,4,5,6,7,8,9,10,10,11,12,12,13,13,13,13,14,14,14,14,14,14,14,14,14
E01001706,EV motorcycles,Number,0,1,1,2,3,4,5,6,7,8,10,11,12,13,13,14,15,15,16,16,16,16,17,17,17,17,17,17,17,17
E01001708,EV motorcycles,Number,0,1,1,2,3,4,6,7,8,10,11,12,14,15,16,17,17,18,18,19,19,19,20,20,20,20,20,20,20,20
E01001709,EV motorcycles,Number,0,0,1,1,2,3,4,5,5,6,7,8,9,10,10,11,11,12,12,12,12,13,13,13,13,13,13,13,13,13
E01001710,EV motorcycles,Number,0,0,0,1,1,2,2,2,3,3,4,4,5,5,6,6,6,6,6,7,7,7,7,7,7,7,7,7,7,7
E01001711,EV motorcycles,Number,0,0,1,1,2,3,4,5,5,6,7,8,9,10,10,11,11,12,12,12,12,13,13,13,13,13,13,13,13,13
E01001712,EV motorcycles,Number,0,0,1,1,1,2,2,3,3,4,4,5,5,6,6,7,7,7,7,8,8,8,8,8,8,8,8,8,8,8
E01001713,EV motorcycles,Number,0,0,0,0,0,0,0,0,0,0,0,0,0,0,0,0,0,0,0,0,0,0,0,0,0,0,0,0,0,0
E01001714,EV motorcycles,Number,0,1,1,2,2,3,4,5,6,7,8,9,10,10,11,12,12,13,13,13,13,14,14,14,14,14,14,14,14,14
E01001715,EV motorcycles,Number,0,0,1,1,2,3,4,5,5,6,7,8,9,10,10,11,11,12,12,12,12,13,13,13,13,13,13,13,13,13
E01001716,EV motorcycles,Number,0,1,1,2,3,4,6,7,8,10,11,12,14,15,16,17,17,18,18,19,19,19,20,20,20,20,20,20,20,20
E01001717,EV motorcycles,Number,0,0,0,1,1,2,2,2,3,3,4,4,5,5,6,6,6,6,6,7,7,7,7,7,7,7,7,7,7,7
E01001718,EV motorcycles,Number,0,0,1,1,2,3,4,5,5,6,7,8,9,10,10,11,11,12,12,12,12,13,13,13,13,13,13,13,13,13
E01001719,EV motorcycles,Number,0,1,1,2,3,4,5,6,7,8,9,10,11,12,13,13,14,14,15,15,15,16,16,16,16,16,16,16,16,16
E01001720,EV motorcycles,Number,0,0,1,1,2,2,3,3,4,4,5,6,6,7,7,7,8,8,8,8,9,9,9,9,9,9,9,9,9,9
E01001722,EV motorcycles,Number,0,0,1,1,2,3,4,5,5,6,7,8,9,10,10,11,11,12,12,12,12,13,13,13,13,13,13,13,13,13
E01001723,EV motorcycles,Number,0,1,1,2,3,4,5,7,8,9,11,12,13,14,15,16,17,17,18,18,18,18,19,19,19,19,19,19,19,19
E01001724,EV motorcycles,Number,1,2,4,6,9,12,16,19,23,27,30,34,37,40,43,45,47,49,50,51,52,52,53,53,53,54,54,54,54,54
E01001725,EV motorcycles,Number,0,0,1,1,2,3,4,5,5,6,7,8,9,10,10,11,11,12,12,12,12,13,13,13,13,13,13,13,13,13
E01001726,EV motorcycles,Number,0,0,0,1,1,1,2,2,3,3,3,4,4,4,5,5,5,5,6,6,6,6,6,6,6,6,6,6,6,6
E01001727,EV motorcycles,Number,0,1,1,2,3,4,5,7,8,9,11,12,13,14,15,16,17,17,18,18,18,18,19,19,19,19,19,19,19,19
E01001728,EV motorcycles,Number,0,0,0,0,0,0,0,0,0,0,0,0,0,0,0,0,0,0,0,0,0,0,0,0,0,0,0,0,0,0
E01001729,EV motorcycles,Number,0,1,1,2,2,3,4,5,6,7,8,9,10,10,11,12,12,13,13,13,13,14,14,14,14,14,14,14,14,14
E01001730,EV motorcycles,Number,0,1,1,2,3,4,5,6,7,8,10,11,12,13,13,14,15,15,16,16,16,16,17,17,17,17,17,17,17,17
E01001731,EV motorcycles,Number,0,1,1,2,3,4,5,6,8,9,10,11,12,13,14,15,16,16,17,17,17,17,18,18,18,18,18,18,18,18
E01001732,EV motorcycles,Number,0,1,1,2,3,4,5,7,8,9,11,12,13,14,15,16,17,17,18,18,18,18,19,19,19,19,19,19,19,19
E01001733,EV motorcycles,Number,0,1,1,2,3,4,5,6,7,8,9,10,11,12,13,13,14,14,15,15,15,16,16,16,16,16,16,16,16,16
E01001734,EV motorcycles,Number,0,1,2,3,4,5,7,9,10,12,13,15,16,18,19,20,21,22,22,23,23,23,23,24,24,24,24,24,24,24
E01001735,EV motorcycles,Number,0,1,2,3,4,6,8,9,11,13,15,16,18,19,20,22,23,23,24,25,25,25,25,26,26,26,26,26,26,26
E01001736,EV motorcycles,Number,0,1,1,2,3,4,5,6,7,8,9,10,11,12,13,13,14,14,15,15,15,16,16,16,16,16,16,16,16,16
E01001737,EV motorcycles,Number,0,1,2,3,4,6,7,9,11,12,14,16,17,18,20,21,22,22,23,24,24,24,24,25,25,25,25,25,25,25
E01001738,EV motorcycles,Number,0,1,1,2,3,4,5,7,8,9,11,12,13,14,15,16,17,17,18,18,18,18,19,19,19,19,19,19,19,19
E01001739,EV motorcycles,Number,0,1,1,2,4,5,6,7,9,10,12,13,14,16,17,17,18,19,19,20,20,20,21,21,21,21,21,21,21,21
E01001740,EV motorcycles,Number,0,0,1,1,2,3,4,5,5,6,7,8,9,10,10,11,11,12,12,12,12,13,13,13,13,13,13,13,13,13
E01001741,EV motorcycles,Number,0,1,1,2,3,4,5,6,7,8,9,10,11,12,13,13,14,14,15,15,15,16,16,16,16,16,16,16,16,16
E01001742,EV motorcycles,Number,0,1,1,2,4,5,6,7,9,10,12,13,14,16,17,17,18,19,19,20,20,20,21,21,21,21,21,21,21,21
E01001744,EV motorcycles,Number,1,2,3,5,7,9,12,15,18,21,24,26,29,31,33,35,36,38,39,40,40,41,41,41,42,42,42,42,42,42
E01001745,EV motorcycles,Number,0,1,1,2,3,4,5,6,7,8,10,11,12,13,13,14,15,15,16,16,16,16,17,17,17,17,17,17,17,17
E01001746,EV motorcycles,Number,0,0,1,1,2,2,3,3,4,4,5,6,6,7,7,7,8,8,8,8,9,9,9,9,9,9,9,9,9,9
E01001747,EV motorcycles,Number,0,1,2,3,5,6,8,10,11,13,15,17,18,20,21,22,23,24,25,25,26,26,26,27,27,27,27,27,27,27
E01001748,EV motorcycles,Number,0,1,2,3,4,5,7,8,10,11,13,14,16,17,18,19,20,21,21,22,22,22,23,23,23,23,23,23,23,23
E01001749,EV motorcycles,Number,0,1,1,2,4,5,6,7,9,10,12,13,14,16,17,17,18,19,19,20,20,20,21,21,21,21,21,21,21,21
E01001750,EV motorcycles,Number,0,1,1,2,3,4,6,7,8,10,11,12,14,15,16,17,17,18,18,19,19,19,20,20,20,20,20,20,20,20
E01001751,EV motorcycles,Number,0,1,1,2,4,5,6,8,9,11,12,14,15,16,17,18,19,20,20,21,21,21,22,22,22,22,22,22,22,22
E01001752,EV motorcycles,Number,0,1,1,2,4,5,6,7,9,10,12,13,14,16,17,17,18,19,19,20,20,20,21,21,21,21,21,21,21,21
E01001753,EV motorcycles,Number,0,0,1,1,1,2,2,3,3,4,4,5,5,6,6,7,7,7,7,8,8,8,8,8,8,8,8,8,8,8
E01001754,EV motorcycles,Number,1,2,3,5,7,10,12,15,18,21,24,27,29,32,34,36,37,39,40,41,41,42,42,42,43,43,43,43,43,43
E01001755,EV motorcycles,Number,0,0,1,1,2,3,3,4,5,6,7,7,8,9,9,10,10,11,11,11,12,12,12,12,12,12,12,12,12,12
E01001756,EV motorcycles,Number,1,3,6,10,15,21,27,33,39,45,51,57,63,68,73,77,80,83,85,87,88,89,90,91,91,91,92,92,92,92
E01001757,EV motorcycles,Number,0,0,1,1,1,2,2,3,3,4,4,5,5,6,6,7,7,7,7,8,8,8,8,8,8,8,8,8,8,8
E01001758,EV motorcycles,Number,0,1,1,2,3,4,5,6,7,8,9,10,11,12,13,13,14,14,15,15,15,16,16,16,16,16,16,16,16,16
E01001759,EV motorcycles,Number,0,1,1,2,3,4,5,6,8,9,10,11,12,13,14,15,16,16,17,17,17,17,18,18,18,18,18,18,18,18
E01001760,EV motorcycles,Number,0,1,1,2,2,3,4,5,6,7,8,9,10,10,11,12,12,13,13,13,13,14,14,14,14,14,14,14,14,14
E01001761,EV motorcycles,Number,0,1,1,2,3,4,5,7,8,9,11,12,13,14,15,16,17,17,18,18,18,18,19,19,19,19,19,19,19,19
E01001762,EV motorcycles,Number,0,1,1,2,3,3,4,5,6,7,8,9,10,11,12,12,13,13,14,14,14,15,15,15,15,15,15,15,15,15
E01001763,EV motorcycles,Number,0,0,1,1,2,2,3,4,4,5,6,6,7,7,8,8,9,9,9,9,10,10,10,10,10,10,10,10,10,10
E01001764,EV motorcycles,Number,0,1,1,2,3,4,5,6,7,8,9,10,11,12,13,13,14,14,15,15,15,16,16,16,16,16,16,16,16,16
E01001765,EV motorcycles,Number,0,1,1,2,3,4,5,6,7,8,10,11,12,13,13,14,15,15,16,16,16,16,17,17,17,17,17,17,17,17
E01001767,EV motorcycles,Number,0,1,2,3,5,6,8,10,12,14,16,17,19,21,22,23,24,25,26,26,27,27,27,28,28,28,28,28,28,28
E01001768,EV motorcycles,Number,0,1,2,3,4,5,7,9,10,12,13,15,16,18,19,20,21,22,22,23,23,23,23,24,24,24,24,24,24,24
E01001769,EV motorcycles,Number,0,1,1,2,4,5,6,7,9,10,12,13,14,16,17,17,18,19,19,20,20,20,21,21,21,21,21,21,21,21
E01001770,EV motorcycles,Number,0,1,1,2,2,3,4,5,6,7,8,9,10,10,11,12,12,13,13,13,13,14,14,14,14,14,14,14,14,14
E01001772,EV motorcycles,Number,0,1,2,3,4,5,7,9,10,12,13,15,16,18,19,20,21,22,22,23,23,23,23,24,24,24,24,24,24,24
E01001773,EV motorcycles,Number,0,1,2,3,5,7,8,10,12,14,16,18,20,21,23,24,25,26,27,27,28,28,28,29,29,29,29,29,29,29
E01001774,EV motorcycles,Number,0,1,1,2,3,4,5,6,7,8,9,10,11,12,13,13,14,14,15,15,15,16,16,16,16,16,16,16,16,16
E01001775,EV motorcycles,Number,0,1,2,3,4,6,7,9,11,12,14,16,17,18,20,21,22,22,23,24,24,24,24,25,25,25,25,25,25,25
E01001776,EV motorcycles,Number,0,0,0,1,1,2,2,2,3,3,4,4,5,5,6,6,6,6,6,7,7,7,7,7,7,7,7,7,7,7
E01001777,EV motorcycles,Number,0,1,1,2,4,5,6,8,9,11,12,14,15,16,17,18,19,20,20,21,21,21,22,22,22,22,22,22,22,22
E01001779,EV motorcycles,Number,0,1,2,3,5,7,8,10,12,14,16,18,20,21,23,24,25,26,27,27,28,28,28,29,29,29,29,29,29,29
E01001780,EV motorcycles,Number,0,1,1,2,4,5,6,7,9,10,12,13,14,16,17,17,18,19,19,20,20,20,21,21,21,21,21,21,21,21
E01001781,EV motorcycles,Number,0,0,1,1,2,3,4,5,5,6,7,8,9,10,10,11,11,12,12,12,12,13,13,13,13,13,13,13,13,13
E01001782,EV motorcycles,Number,0,1,2,3,5,7,8,10,12,14,16,18,20,21,23,24,25,26,27,27,28,28,28,29,29,29,29,29,29,29
E01001783,EV motorcycles,Number,0,0,1,1,2,3,4,5,5,6,7,8,9,10,10,11,11,12,12,12,12,13,13,13,13,13,13,13,13,13
E01001784,EV motorcycles,Number,0,1,2,3,4,6,7,9,11,12,14,16,17,18,20,21,22,22,23,24,24,24,24,25,25,25,25,25,25,25
E01001785,EV motorcycles,Number,0,1,1,2,4,5,6,8,9,11,12,14,15,16,17,18,19,20,20,21,21,21,22,22,22,22,22,22,22,22
E01001786,EV motorcycles,Number,0,1,1,2,2,3,4,5,6,7,8,9,10,10,11,12,12,13,13,13,13,14,14,14,14,14,14,14,14,14
E01001787,EV motorcycles,Number,0,0,1,1,2,3,3,4,5,6,7,7,8,9,9,10,10,11,11,11,12,12,12,12,12,12,12,12,12,12
E01001788,EV motorcycles,Number,0,0,1,1,2,3,4,5,5,6,7,8,9,10,10,11,11,12,12,12,12,13,13,13,13,13,13,13,13,13
E01001789,EV motorcycles,Number,0,0,1,1,2,3,3,4,5,6,7,7,8,9,9,10,10,11,11,11,12,12,12,12,12,12,12,12,12,12
E01001790,EV motorcycles,Number,0,0,1,1,2,3,4,5,5,6,7,8,9,10,10,11,11,12,12,12,12,13,13,13,13,13,13,13,13,13
E01001791,EV motorcycles,Number,0,0,1,1,2,2,3,4,5,5,6,7,8,8,9,9,10,10,10,10,11,11,11,11,11,11,11,11,11,11
E01001792,EV motorcycles,Number,1,2,3,5,7,9,12,15,18,21,24,26,29,31,33,35,36,38,39,40,40,41,41,41,42,42,42,42,42,42
E01001793,EV motorcycles,Number,0,0,1,1,2,2,3,4,5,5,6,7,8,8,9,9,10,10,10,10,11,11,11,11,11,11,11,11,11,11
E01001794,EV motorcycles,Number,0,1,1,2,2,3,4,5,6,7,8,9,10,10,11,12,12,13,13,13,13,14,14,14,14,14,14,14,14,14
E01001795,EV motorcycles,Number,0,0,1,1,2,3,3,4,5,6,7,7,8,9,9,10,10,11,11,11,12,12,12,12,12,12,12,12,12,12
E01001796,EV motorcycles,Number,0,1,2,3,4,5,7,8,10,11,13,14,16,17,18,19,20,21,21,22,22,22,23,23,23,23,23,23,23,23
E01001798,EV motorcycles,Number,0,1,1,2,3,4,5,6,7,8,9,10,11,12,13,13,14,14,15,15,15,16,16,16,16,16,16,16,16,16
E01001799,EV motorcycles,Number,0,0,0,0,0,0,0,0,0,0,0,0,0,0,0,0,0,0,0,0,0,0,0,0,0,0,0,0,0,0
E01001800,EV motorcycles,Number,0,1,1,2,3,4,5,7,8,9,11,12,13,14,15,16,17,17,18,18,18,18,19,19,19,19,19,19,19,19
E01001801,EV motorcycles,Number,0,0,1,1,2,2,3,4,4,5,6,6,7,7,8,8,9,9,9,9,10,10,10,10,10,10,10,10,10,10
E01001802,EV motorcycles,Number,0,0,0,0,0,0,0,0,0,0,0,0,0,0,0,0,0,0,0,0,0,0,0,0,0,0,0,0,0,0
E01001803,EV motorcycles,Number,0,1,2,3,4,5,7,8,10,11,13,14,16,17,18,19,20,21,21,22,22,22,23,23,23,23,23,23,23,23
E01001804,EV motorcycles,Number,0,1,1,2,3,4,6,7,8,10,11,12,14,15,16,17,17,18,18,19,19,19,20,20,20,20,20,20,20,20
E01001805,EV motorcycles,Number,0,1,1,2,4,5,6,7,9,10,12,13,14,16,17,17,18,19,19,20,20,20,21,21,21,21,21,21,21,21
E01001806,EV motorcycles,Number,0,1,1,2,3,4,6,7,8,10,11,12,14,15,16,17,17,18,18,19,19,19,20,20,20,20,20,20,20,20
E01001807,EV motorcycles,Number,1,2,3,5,7,10,12,15,18,21,24,27,29,32,34,36,37,39,40,41,41,42,42,42,43,43,43,43,43,43
E01001808,EV motorcycles,Number,0,1,1,2,3,4,5,6,7,8,10,11,12,13,13,14,15,15,16,16,16,16,17,17,17,17,17,17,17,17
E01001809,EV motorcycles,Number,0,0,1,1,2,3,4,5,5,6,7,8,9,10,10,11,11,12,12,12,12,13,13,13,13,13,13,13,13,13
E01001811,EV motorcycles,Number,0,0,1,1,2,3,4,5,5,6,7,8,9,10,10,11,11,12,12,12,12,13,13,13,13,13,13,13,13,13
E01001812,EV motorcycles,Number,0,1,1,2,3,4,5,6,7,8,9,10,11,12,13,13,14,14,15,15,15,16,16,16,16,16,16,16,16,16
E01001813,EV motorcycles,Number,0,1,2,3,4,5,7,8,10,11,13,14,16,17,18,19,20,21,21,22,22,22,23,23,23,23,23,23,23,23
E01001814,EV motorcycles,Number,0,1,1,2,3,4,5,6,7,8,9,10,11,12,13,13,14,14,15,15,15,16,16,16,16,16,16,16,16,16
E01001815,EV motorcycles,Number,0,1,1,2,3,4,5,6,7,8,10,11,12,13,13,14,15,15,16,16,16,16,17,17,17,17,17,17,17,17
E01001816,EV motorcycles,Number,0,1,2,3,4,5,7,8,10,11,13,14,16,17,18,19,20,21,21,22,22,22,23,23,23,23,23,23,23,23
E01001819,EV motorcycles,Number,0,1,1,2,3,4,5,7,8,9,11,12,13,14,15,16,17,17,18,18,18,18,19,19,19,19,19,19,19,19
E01001820,EV motorcycles,Number,0,1,1,2,3,4,5,6,8,9,10,11,12,13,14,15,16,16,17,17,17,17,18,18,18,18,18,18,18,18
E01001821,EV motorcycles,Number,0,0,1,1,2,2,3,4,4,5,6,6,7,7,8,8,9,9,9,9,10,10,10,10,10,10,10,10,10,10
E01001822,EV motorcycles,Number,0,0,1,1,2,2,3,4,5,5,6,7,8,8,9,9,10,10,10,10,11,11,11,11,11,11,11,11,11,11
E01001823,EV motorcycles,Number,0,1,1,2,3,4,5,7,8,9,11,12,13,14,15,16,17,17,18,18,18,18,19,19,19,19,19,19,19,19
E01001824,EV motorcycles,Number,0,0,1,1,2,2,3,4,4,5,6,6,7,7,8,8,9,9,9,9,10,10,10,10,10,10,10,10,10,10
E01001825,EV motorcycles,Number,0,0,0,0,0,0,0,0,0,0,0,0,0,0,0,0,0,0,0,0,0,0,0,0,0,0,0,0,0,0
E01001826,EV motorcycles,Number,0,0,1,1,2,2,3,4,4,5,6,6,7,7,8,8,9,9,9,9,10,10,10,10,10,10,10,10,10,10
E01001827,EV motorcycles,Number,0,1,1,2,3,4,5,6,7,8,10,11,12,13,13,14,15,15,16,16,16,16,17,17,17,17,17,17,17,17
E01001828,EV motorcycles,Number,0,0,1,1,2,3,4,5,5,6,7,8,9,10,10,11,11,12,12,12,12,13,13,13,13,13,13,13,13,13
E01001829,EV motorcycles,Number,0,1,2,4,6,7,10,12,14,16,18,21,23,24,26,27,29,30,31,31,32,32,32,33,33,33,33,33,33,33
E01001830,EV motorcycles,Number,0,1,2,3,4,5,7,8,10,11,13,14,16,17,18,19,20,21,21,22,22,22,23,23,23,23,23,23,23,23
E01001831,EV motorcycles,Number,0,1,1,2,3,4,5,7,8,9,11,12,13,14,15,16,17,17,18,18,18,18,19,19,19,19,19,19,19,19
E01001832,EV motorcycles,Number,0,1,2,4,5,7,9,11,14,16,18,20,22,24,25,27,28,29,30,30,31,31,31,32,32,32,32,32,32,32
E01001833,EV motorcycles,Number,1,1,2,4,6,8,10,13,15,18,20,22,25,27,28,30,31,32,33,34,35,35,35,35,36,36,36,36,36,36
E01001834,EV motorcycles,Number,0,1,2,3,4,6,8,9,11,13,15,16,18,19,20,22,23,23,24,25,25,25,25,26,26,26,26,26,26,26
E01001835,EV motorcycles,Number,0,0,1,1,2,2,3,4,5,5,6,7,8,8,9,9,10,10,10,10,11,11,11,11,11,11,11,11,11,11
E01001836,EV motorcycles,Number,0,1,1,2,4,5,6,8,9,11,12,14,15,16,17,18,19,20,20,21,21,21,22,22,22,22,22,22,22,22
E01001837,EV motorcycles,Number,0,1,1,2,3,3,4,5,6,7,8,9,10,11,12,12,13,13,14,14,14,15,15,15,15,15,15,15,15,15
E01001838,EV motorcycles,Number,0,0,0,1,1,2,2,2,3,3,4,4,5,5,6,6,6,6,6,7,7,7,7,7,7,7,7,7,7,7
E01001839,EV motorcycles,Number,0,0,1,1,2,2,3,4,5,5,6,7,8,8,9,9,10,10,10,10,11,11,11,11,11,11,11,11,11,11
E01001840,EV motorcycles,Number,0,1,1,2,3,4,5,6,8,9,10,11,12,13,14,15,16,16,17,17,17,17,18,18,18,18,18,18,18,18
E01001841,EV motorcycles,Number,0,1,1,2,2,3,4,5,6,7,8,9,10,10,11,12,12,13,13,13,13,14,14,14,14,14,14,14,14,14
E01001842,EV motorcycles,Number,0,0,1,1,1,2,2,3,3,4,4,5,5,6,6,7,7,7,7,8,8,8,8,8,8,8,8,8,8,8
E01001843,EV motorcycles,Number,0,1,1,2,2,3,4,5,6,7,8,9,10,10,11,12,12,13,13,13,13,14,14,14,14,14,14,14,14,14
E01001844,EV motorcycles,Number,0,1,1,2,4,5,6,7,9,10,12,13,14,16,17,17,18,19,19,20,20,20,21,21,21,21,21,21,21,21
E01001845,EV motorcycles,Number,0,0,1,1,2,2,3,4,5,5,6,7,8,8,9,9,10,10,10,10,11,11,11,11,11,11,11,11,11,11
E01001846,EV motorcycles,Number,0,1,1,2,2,3,4,5,6,7,8,9,10,10,11,12,12,13,13,13,13,14,14,14,14,14,14,14,14,14
E01001847,EV motorcycles,Number,0,1,1,2,2,3,4,5,6,7,8,9,10,10,11,12,12,13,13,13,13,14,14,14,14,14,14,14,14,14
E01001848,EV motorcycles,Number,0,1,1,2,3,4,5,6,7,8,10,11,12,13,13,14,15,15,16,16,16,16,17,17,17,17,17,17,17,17
E01001849,EV motorcycles,Number,1,2,3,5,8,11,14,17,20,23,26,29,32,35,37,39,41,42,43,44,45,46,46,46,47,47,47,47,47,47
E01001850,EV motorcycles,Number,0,0,0,1,1,1,2,2,3,3,3,4,4,4,5,5,5,5,6,6,6,6,6,6,6,6,6,6,6,6
E01001851,EV motorcycles,Number,0,1,1,2,3,4,5,6,8,9,10,11,12,13,14,15,16,16,17,17,17,17,18,18,18,18,18,18,18,18
E01001852,EV motorcycles,Number,0,1,2,3,5,7,8,10,12,14,16,18,20,21,23,24,25,26,27,27,28,28,28,29,29,29,29,29,29,29
E01001853,EV motorcycles,Number,0,1,2,3,4,6,8,9,11,13,15,16,18,19,20,22,23,23,24,25,25,25,25,26,26,26,26,26,26,26
E01001854,EV motorcycles,Number,1,1,3,5,7,9,12,15,17,20,23,26,28,30,32,34,36,37,38,39,39,40,40,40,41,41,41,41,41,41
E01001855,EV motorcycles,Number,0,1,2,4,5,7,9,11,14,16,18,20,22,24,25,27,28,29,30,30,31,31,31,32,32,32,32,32,32,32
E01001856,EV motorcycles,Number,0,1,2,3,5,6,8,10,12,14,16,17,19,21,22,23,24,25,26,26,27,27,27,28,28,28,28,28,28,28
E01001857,EV motorcycles,Number,0,1,1,2,3,4,5,7,8,9,11,12,13,14,15,16,17,17,18,18,18,18,19,19,19,19,19,19,19,19
E01001858,EV motorcycles,Number,0,1,2,3,4,6,7,9,11,12,14,16,17,18,20,21,22,22,23,24,24,24,24,25,25,25,25,25,25,25
E01001859,EV motorcycles,Number,1,2,4,6,9,12,16,20,23,27,31,34,38,41,43,46,48,49,51,52,53,53,54,54,54,55,55,55,55,55
E01001860,EV motorcycles,Number,0,1,1,2,4,5,6,8,9,11,12,14,15,16,17,18,19,20,20,21,21,21,22,22,22,22,22,22,22,22
E01001861,EV motorcycles,Number,0,1,2,3,4,5,7,9,10,12,13,15,16,18,19,20,21,22,22,23,23,23,23,24,24,24,24,24,24,24
E01001862,EV motorcycles,Number,1,1,2,4,6,8,11,13,16,18,21,23,25,27,29,31,32,33,34,35,35,36,36,36,37,37,37,37,37,37
E01001863,EV motorcycles,Number,1,1,2,4,6,8,10,12,15,17,20,22,24,26,28,29,30,31,32,33,34,34,34,34,35,35,35,35,35,35
E01001864,EV motorcycles,Number,1,1,2,4,6,8,10,12,15,17,20,22,24,26,28,29,30,31,32,33,34,34,34,34,35,35,35,35,35,35
E01001865,EV motorcycles,Number,0,1,2,3,4,5,7,8,10,11,13,14,16,17,18,19,20,21,21,22,22,22,23,23,23,23,23,23,23,23
E01001866,EV motorcycles,Number,0,1,1,2,3,3,4,5,6,7,8,9,10,11,12,12,13,13,14,14,14,15,15,15,15,15,15,15,15,15
E01001867,EV motorcycles,Number,0,0,0,1,1,1,1,2,2,2,3,3,3,4,4,4,4,4,5,5,5,5,5,5,5,5,5,5,5,5
E01001868,EV motorcycles,Number,0,1,1,2,3,4,5,6,8,9,10,11,12,13,14,15,16,16,17,17,17,17,18,18,18,18,18,18,18,18
E01001869,EV motorcycles,Number,0,1,1,2,4,5,6,8,9,11,12,14,15,16,17,18,19,20,20,21,21,21,22,22,22,22,22,22,22,22
E01001870,EV motorcycles,Number,0,1,2,4,6,7,10,12,14,16,18,21,23,24,26,27,29,30,31,31,32,32,32,33,33,33,33,33,33,33
E01001871,EV motorcycles,Number,0,1,2,3,4,5,7,8,10,11,13,14,16,17,18,19,20,21,21,22,22,22,23,23,23,23,23,23,23,23
E01001872,EV motorcycles,Number,0,1,1,2,4,5,6,7,9,10,12,13,14,16,17,17,18,19,19,20,20,20,21,21,21,21,21,21,21,21
E01001873,EV motorcycles,Number,0,1,2,3,4,6,7,9,11,12,14,16,17,18,20,21,22,22,23,24,24,24,24,25,25,25,25,25,25,25
E01001874,EV motorcycles,Number,1,1,2,4,6,8,10,13,15,18,20,22,25,27,28,30,31,32,33,34,35,35,35,35,36,36,36,36,36,36
E01001875,EV motorcycles,Number,0,1,2,3,4,5,7,8,10,11,13,14,16,17,18,19,20,21,21,22,22,22,23,23,23,23,23,23,23,23
E01001876,EV motorcycles,Number,0,1,2,3,5,7,9,11,13,15,17,19,21,22,24,25,26,27,28,28,29,29,29,30,30,30,30,30,30,30
E01001877,EV motorcycles,Number,1,2,4,7,10,13,17,21,25,30,34,37,41,44,47,50,52,54,55,57,58,58,59,59,59,60,60,60,60,60
E01001878,EV motorcycles,Number,0,1,2,3,4,5,7,9,10,12,13,15,16,18,19,20,21,22,22,23,23,23,23,24,24,24,24,24,24,24
E01001879,EV motorcycles,Number,0,1,2,3,4,5,7,9,10,12,13,15,16,18,19,20,21,22,22,23,23,23,23,24,24,24,24,24,24,24
E01001880,EV motorcycles,Number,0,1,2,3,4,5,7,8,10,11,13,14,16,17,18,19,20,21,21,22,22,22,23,23,23,23,23,23,23,23
E01001881,EV motorcycles,Number,1,1,2,4,6,8,10,12,15,17,20,22,24,26,28,29,30,31,32,33,34,34,34,34,35,35,35,35,35,35
E01001882,EV motorcycles,Number,0,1,1,2,4,5,6,8,9,11,12,14,15,16,17,18,19,20,20,21,21,21,22,22,22,22,22,22,22,22
E01001883,EV motorcycles,Number,1,1,2,4,6,8,11,13,16,18,21,23,25,27,29,31,32,33,34,35,35,36,36,36,37,37,37,37,37,37
E01001884,EV motorcycles,Number,0,1,2,3,5,7,9,11,13,15,17,19,21,22,24,25,26,27,28,28,29,29,29,30,30,30,30,30,30,30
E01001885,EV motorcycles,Number,0,1,1,2,3,4,5,7,8,9,11,12,13,14,15,16,17,17,18,18,18,18,19,19,19,19,19,19,19,19
E01001886,EV motorcycles,Number,0,1,2,3,5,7,8,10,12,14,16,18,20,21,23,24,25,26,27,27,28,28,28,29,29,29,29,29,29,29
E01001887,EV motorcycles,Number,0,1,2,4,5,7,9,11,14,16,18,20,22,24,25,27,28,29,30,30,31,31,31,32,32,32,32,32,32,32
E01001888,EV motorcycles,Number,0,1,2,3,5,6,8,10,11,13,15,17,18,20,21,22,23,24,25,25,26,26,26,27,27,27,27,27,27,27
E01001889,EV motorcycles,Number,0,1,1,2,3,4,5,6,7,8,9,10,11,12,13,13,14,14,15,15,15,16,16,16,16,16,16,16,16,16
E01001890,EV motorcycles,Number,0,1,1,2,3,4,5,7,8,9,11,12,13,14,15,16,17,17,18,18,18,18,19,19,19,19,19,19,19,19
E01001891,EV motorcycles,Number,1,2,4,6,10,13,17,21,25,29,32,36,40,43,46,48,50,52,54,55,56,56,57,57,57,58,58,58,58,58
E01001892,EV motorcycles,Number,0,1,2,3,4,5,7,8,10,11,13,14,16,17,18,19,20,21,21,22,22,22,23,23,23,23,23,23,23,23
E01001893,EV motorcycles,Number,2,5,9,15,23,31,40,49,58,68,77,86,94,102,109,115,120,124,128,130,132,134,135,136,137,137,138,138,138,138
E01001894,EV motorcycles,Number,0,1,2,3,4,5,7,9,10,12,13,15,16,18,19,20,21,22,22,23,23,23,23,24,24,24,24,24,24,24
E01001895,EV motorcycles,Number,0,1,1,2,3,4,5,6,8,9,10,11,12,13,14,15,16,16,17,17,17,17,18,18,18,18,18,18,18,18
E01001896,EV motorcycles,Number,1,2,3,5,8,11,14,17,20,23,26,29,32,35,37,39,41,42,43,44,45,46,46,46,47,47,47,47,47,47
E01001897,EV motorcycles,Number,0,1,1,2,4,5,6,7,9,10,12,13,14,16,17,17,18,19,19,20,20,20,21,21,21,21,21,21,21,21
E01001898,EV motorcycles,Number,4,11,20,33,50,67,86,106,126,147,167,186,204,221,236,249,260,269,276,282,287,290,293,295,296,297,299,299,299,299
E01001899,EV motorcycles,Number,0,1,1,2,3,4,5,6,7,8,10,11,12,13,13,14,15,15,16,16,16,16,17,17,17,17,17,17,17,17
E01001900,EV motorcycles,Number,0,1,1,2,4,5,6,7,9,10,12,13,14,16,17,17,18,19,19,20,20,20,21,21,21,21,21,21,21,21
E01001901,EV motorcycles,Number,0,1,2,3,4,6,7,9,11,12,14,16,17,18,20,21,22,22,23,24,24,24,24,25,25,25,25,25,25,25
E01001902,EV motorcycles,Number,0,1,2,4,5,7,9,11,14,16,18,20,22,24,25,27,28,29,30,30,31,31,31,32,32,32,32,32,32,32
E01001903,EV motorcycles,Number,0,1,2,3,4,5,7,8,10,11,13,14,16,17,18,19,20,21,21,22,22,22,23,23,23,23,23,23,23,23
E01001904,EV motorcycles,Number,1,1,2,4,6,8,11,13,16,18,21,23,25,27,29,31,32,33,34,35,35,36,36,36,37,37,37,37,37,37
E01001905,EV motorcycles,Number,1,1,2,4,6,8,10,12,15,17,20,22,24,26,28,29,30,31,32,33,34,34,34,34,35,35,35,35,35,35
E01001906,EV motorcycles,Number,1,1,2,4,6,8,10,12,15,17,20,22,24,26,28,29,30,31,32,33,34,34,34,34,35,35,35,35,35,35
E01001907,EV motorcycles,Number,0,1,2,3,5,7,9,11,13,15,17,19,21,22,24,25,26,27,28,28,29,29,29,30,30,30,30,30,30,30
E01001908,EV motorcycles,Number,0,1,2,3,4,5,7,8,10,11,13,14,16,17,18,19,20,21,21,22,22,22,23,23,23,23,23,23,23,23
E01001909,EV motorcycles,Number,0,1,2,3,4,6,7,9,11,12,14,16,17,18,20,21,22,22,23,24,24,24,24,25,25,25,25,25,25,25
E01001910,EV motorcycles,Number,0,0,1,1,2,3,4,5,5,6,7,8,9,10,10,11,11,12,12,12,12,13,13,13,13,13,13,13,13,13
E01001911,EV motorcycles,Number,0,1,2,4,5,7,9,11,14,16,18,20,22,24,25,27,28,29,30,30,31,31,31,32,32,32,32,32,32,32
E01001912,EV motorcycles,Number,1,2,3,6,8,11,14,18,21,25,28,31,34,37,39,42,43,45,46,47,48,49,49,49,49,50,50,50,50,50
E01001913,EV motorcycles,Number,0,0,1,1,2,3,3,4,5,6,7,7,8,9,9,10,10,11,11,11,12,12,12,12,12,12,12,12,12,12
E01001914,EV motorcycles,Number,1,2,3,5,7,10,12,15,18,21,24,27,29,32,34,36,37,39,40,41,41,42,42,42,43,43,43,43,43,43
E01001915,EV motorcycles,Number,0,1,2,3,5,7,8,10,12,14,16,18,20,21,23,24,25,26,27,27,28,28,28,29,29,29,29,29,29,29
E01001916,EV motorcycles,Number,0,1,2,3,5,6,8,10,11,13,15,17,18,20,21,22,23,24,25,25,26,26,26,27,27,27,27,27,27,27
E01001917,EV motorcycles,Number,0,1,2,3,5,7,8,10,12,14,16,18,20,21,23,24,25,26,27,27,28,28,28,29,29,29,29,29,29,29
E01001918,EV motorcycles,Number,1,1,3,4,7,9,12,14,17,20,22,25,27,30,32,33,35,36,37,38,38,39,39,39,40,40,40,40,40,40
E01001919,EV motorcycles,Number,1,1,3,4,7,9,11,14,16,19,22,24,27,29,31,32,34,35,36,37,37,38,38,38,39,39,39,39,39,39
E01001920,EV motorcycles,Number,0,1,2,3,5,7,9,11,13,15,17,19,21,22,24,25,26,27,28,28,29,29,29,30,30,30,30,30,30,30
E01001921,EV motorcycles,Number,0,1,2,4,6,8,10,12,14,17,19,21,23,25,27,28,30,31,31,32,33,33,33,33,34,34,34,34,34,34
E01001922,EV motorcycles,Number,0,1,2,4,5,7,9,11,14,16,18,20,22,24,25,27,28,29,30,30,31,31,31,32,32,32,32,32,32,32
E01001923,EV motorcycles,Number,1,1,2,4,6,8,11,13,16,18,21,23,25,27,29,31,32,33,34,35,35,36,36,36,37,37,37,37,37,37
E01001924,EV motorcycles,Number,0,1,2,3,4,5,7,9,10,12,13,15,16,18,19,20,21,22,22,23,23,23,23,24,24,24,24,24,24,24
E01001925,EV motorcycles,Number,0,1,2,3,4,5,7,8,10,11,13,14,16,17,18,19,20,21,21,22,22,22,23,23,23,23,23,23,23,23
E01001926,EV motorcycles,Number,0,1,2,3,5,6,8,10,12,14,16,17,19,21,22,23,24,25,26,26,27,27,27,28,28,28,28,28,28,28
E01001927,EV motorcycles,Number,0,1,2,3,5,7,9,11,13,15,17,19,21,22,24,25,26,27,28,28,29,29,29,30,30,30,30,30,30,30
E01001928,EV motorcycles,Number,0,1,1,2,3,4,6,7,8,10,11,12,14,15,16,17,17,18,18,19,19,19,20,20,20,20,20,20,20,20
E01001929,EV motorcycles,Number,0,1,1,2,3,4,5,7,8,9,11,12,13,14,15,16,17,17,18,18,18,18,19,19,19,19,19,19,19,19
E01001930,EV motorcycles,Number,0,1,2,3,5,6,8,10,11,13,15,17,18,20,21,22,23,24,25,25,26,26,26,27,27,27,27,27,27,27
E01001931,EV motorcycles,Number,0,1,1,2,3,4,5,6,7,8,9,10,11,12,13,13,14,14,15,15,15,16,16,16,16,16,16,16,16,16
E01001932,EV motorcycles,Number,0,1,1,2,3,4,5,6,8,9,10,11,12,13,14,15,16,16,17,17,17,17,18,18,18,18,18,18,18,18
E01001933,EV motorcycles,Number,0,1,1,2,3,4,5,7,8,9,11,12,13,14,15,16,17,17,18,18,18,18,19,19,19,19,19,19,19,19
E01001934,EV motorcycles,Number,1,3,5,8,12,16,20,25,30,34,39,44,48,52,55,58,61,63,65,66,67,68,69,69,69,70,70,70,70,70
E01001935,EV motorcycles,Number,1,2,4,6,9,12,16,19,23,27,30,34,37,40,43,45,47,49,50,51,52,52,53,53,53,54,54,54,54,54
E01001937,EV motorcycles,Number,1,2,3,6,9,11,15,18,22,25,29,32,35,38,40,42,44,46,47,48,49,49,50,50,50,51,51,51,51,51
E01001938,EV motorcycles,Number,1,2,3,5,8,10,13,16,19,22,25,28,31,33,35,37,39,40,42,42,43,44,44,44,45,45,45,45,45,45
E01001939,EV motorcycles,Number,1,3,6,10,15,20,26,32,38,44,50,55,61,66,70,74,77,80,82,84,85,86,87,88,88,88,89,89,89,89
E01001940,EV motorcycles,Number,0,1,2,3,4,6,8,9,11,13,15,16,18,19,20,22,23,23,24,25,25,25,25,26,26,26,26,26,26,26
E01001941,EV motorcycles,Number,1,2,3,5,7,9,12,15,18,21,24,26,29,31,33,35,36,38,39,40,40,41,41,41,42,42,42,42,42,42
E01001942,EV motorcycles,Number,0,1,2,4,6,7,10,12,14,16,18,21,23,24,26,27,29,30,31,31,32,32,32,33,33,33,33,33,33,33
E01001943,EV motorcycles,Number,1,2,3,5,7,10,12,15,18,21,24,27,29,32,34,36,37,39,40,41,41,42,42,42,43,43,43,43,43,43
E01001944,EV motorcycles,Number,0,1,1,2,3,4,5,7,8,9,11,12,13,14,15,16,17,17,18,18,18,18,19,19,19,19,19,19,19,19
E01001945,EV motorcycles,Number,0,1,2,3,5,7,8,10,12,14,16,18,20,21,23,24,25,26,27,27,28,28,28,29,29,29,29,29,29,29
E01001946,EV motorcycles,Number,0,1,2,4,5,7,9,11,14,16,18,20,22,24,25,27,28,29,30,30,31,31,31,32,32,32,32,32,32,32
E01001947,EV motorcycles,Number,1,1,3,4,7,9,11,14,16,19,22,24,27,29,31,32,34,35,36,37,37,38,38,38,39,39,39,39,39,39
E01001948,EV motorcycles,Number,1,1,2,4,6,8,11,13,16,18,21,23,25,27,29,31,32,33,34,35,35,36,36,36,37,37,37,37,37,37
E01001949,EV motorcycles,Number,0,1,2,3,4,5,7,8,10,11,13,14,16,17,18,19,20,21,21,22,22,22,23,23,23,23,23,23,23,23
E01001950,EV motorcycles,Number,0,1,2,3,4,5,7,9,10,12,13,15,16,18,19,20,21,22,22,23,23,23,23,24,24,24,24,24,24,24
E01001951,EV motorcycles,Number,0,1,2,4,6,7,10,12,14,16,18,21,23,24,26,27,29,30,31,31,32,32,32,33,33,33,33,33,33,33
E01001952,EV motorcycles,Number,0,1,2,4,6,7,10,12,14,16,18,21,23,24,26,27,29,30,31,31,32,32,32,33,33,33,33,33,33,33
E01001953,EV motorcycles,Number,0,1,2,3,4,5,7,8,10,11,13,14,16,17,18,19,20,21,21,22,22,22,23,23,23,23,23,23,23,23
E01001954,EV motorcycles,Number,0,1,1,2,3,4,6,7,8,10,11,12,14,15,16,17,17,18,18,19,19,19,20,20,20,20,20,20,20,20
E01001955,EV motorcycles,Number,0,1,2,3,5,7,9,11,13,15,17,19,21,23,24,26,27,28,29,29,30,30,30,31,31,31,31,31,31,31
E01001956,EV motorcycles,Number,0,1,2,3,4,5,7,9,10,12,13,15,16,18,19,20,21,22,22,23,23,23,23,24,24,24,24,24,24,24
E01001957,EV motorcycles,Number,0,0,1,1,2,3,4,5,5,6,7,8,9,10,10,11,11,12,12,12,12,13,13,13,13,13,13,13,13,13
E01001958,EV motorcycles,Number,0,1,1,2,3,3,4,5,6,7,8,9,10,11,12,12,13,13,14,14,14,15,15,15,15,15,15,15,15,15
E01001959,EV motorcycles,Number,1,1,2,4,6,9,11,13,16,19,21,24,26,28,30,32,33,34,35,36,36,37,37,37,38,38,38,38,38,38
E01001960,EV motorcycles,Number,1,2,3,6,8,11,14,18,21,25,28,31,34,37,39,42,43,45,46,47,48,49,49,49,49,50,50,50,50,50
E01001961,EV motorcycles,Number,0,1,1,2,4,5,6,8,9,11,12,14,15,16,17,18,19,20,20,21,21,21,22,22,22,22,22,22,22,22
E01001962,EV motorcycles,Number,0,1,1,2,3,4,5,6,8,9,10,11,12,13,14,15,16,16,17,17,17,17,18,18,18,18,18,18,18,18
E01001963,EV motorcycles,Number,0,1,2,3,4,6,8,9,11,13,15,16,18,19,20,22,23,23,24,25,25,25,25,26,26,26,26,26,26,26
E01001964,EV motorcycles,Number,0,1,2,3,4,6,8,9,11,13,15,16,18,19,20,22,23,23,24,25,25,25,25,26,26,26,26,26,26,26
E01001965,EV motorcycles,Number,0,0,1,1,2,2,3,3,4,4,5,6,6,7,7,7,8,8,8,8,9,9,9,9,9,9,9,9,9,9
E01001966,EV motorcycles,Number,0,1,1,2,3,4,6,7,8,10,11,12,14,15,16,17,17,18,18,19,19,19,20,20,20,20,20,20,20,20
E01001967,EV motorcycles,Number,0,1,2,3,4,5,7,8,10,11,13,14,16,17,18,19,20,21,21,22,22,22,23,23,23,23,23,23,23,23
E01001968,EV motorcycles,Number,0,1,2,3,4,6,8,9,11,13,15,16,18,19,20,22,23,23,24,25,25,25,25,26,26,26,26,26,26,26
E01001969,EV motorcycles,Number,0,1,1,2,4,5,6,7,9,10,12,13,14,16,17,17,18,19,19,20,20,20,21,21,21,21,21,21,21,21
E01001970,EV motorcycles,Number,0,1,2,3,4,5,7,9,10,12,13,15,16,18,19,20,21,22,22,23,23,23,23,24,24,24,24,24,24,24
E01001971,EV motorcycles,Number,0,1,1,2,2,3,4,5,6,7,8,9,10,10,11,12,12,13,13,13,13,14,14,14,14,14,14,14,14,14
E01001972,EV motorcycles,Number,0,1,1,2,3,4,5,7,8,9,11,12,13,14,15,16,17,17,18,18,18,18,19,19,19,19,19,19,19,19
E01001973,EV motorcycles,Number,1,2,4,7,10,14,18,22,26,30,35,39,42,46,49,52,54,56,57,59,59,60,61,61,61,62,62,62,62,62
E01001974,EV motorcycles,Number,0,1,2,3,4,6,8,9,11,13,15,16,18,19,20,22,23,23,24,25,25,25,25,26,26,26,26,26,26,26
E01001975,EV motorcycles,Number,0,1,2,4,6,8,10,12,14,17,19,21,23,25,27,28,30,31,31,32,33,33,33,33,34,34,34,34,34,34
E01001976,EV motorcycles,Number,0,1,2,3,5,7,8,10,12,14,16,18,20,21,23,24,25,26,27,27,28,28,28,29,29,29,29,29,29,29
E01001977,EV motorcycles,Number,0,1,2,3,5,7,9,11,13,15,17,19,21,22,24,25,26,27,28,28,29,29,29,30,30,30,30,30,30,30
E01001978,EV motorcycles,Number,0,0,1,1,2,2,3,4,5,5,6,7,8,8,9,9,10,10,10,10,11,11,11,11,11,11,11,11,11,11
E01001979,EV motorcycles,Number,1,1,2,4,6,9,11,13,16,19,21,24,26,28,30,32,33,34,35,36,36,37,37,37,38,38,38,38,38,38
E01001980,EV motorcycles,Number,0,1,2,4,5,7,9,11,14,16,18,20,22,24,25,27,28,29,30,30,31,31,31,32,32,32,32,32,32,32
E01001981,EV motorcycles,Number,1,2,3,5,7,10,12,15,18,21,24,27,29,32,34,36,37,39,40,41,41,42,42,42,43,43,43,43,43,43
E01001982,EV motorcycles,Number,0,1,1,2,3,4,6,7,8,10,11,12,14,15,16,17,17,18,18,19,19,19,20,20,20,20,20,20,20,20
E01001983,EV motorcycles,Number,1,1,2,4,6,8,11,13,16,18,21,23,25,27,29,31,32,33,34,35,35,36,36,36,37,37,37,37,37,37
E01001984,EV motorcycles,Number,0,1,2,3,4,6,7,9,11,12,14,16,17,18,20,21,22,22,23,24,24,24,24,25,25,25,25,25,25,25
E01001985,EV motorcycles,Number,0,1,1,2,4,5,6,7,9,10,12,13,14,16,17,17,18,19,19,20,20,20,21,21,21,21,21,21,21,21
E01001986,EV motorcycles,Number,0,1,2,3,4,5,7,8,10,11,13,14,16,17,18,19,20,21,21,22,22,22,23,23,23,23,23,23,23,23
E01001987,EV motorcycles,Number,0,1,2,4,6,7,10,12,14,16,18,21,23,24,26,27,29,30,31,31,32,32,32,33,33,33,33,33,33,33
E01001988,EV motorcycles,Number,0,1,2,3,5,6,8,10,11,13,15,17,18,20,21,22,23,24,25,25,26,26,26,27,27,27,27,27,27,27
E01001989,EV motorcycles,Number,0,1,2,3,5,7,9,11,13,15,17,19,21,23,24,26,27,28,29,29,30,30,30,31,31,31,31,31,31,31
E01001990,EV motorcycles,Number,0,1,2,4,6,7,10,12,14,16,18,21,23,24,26,27,29,30,31,31,32,32,32,33,33,33,33,33,33,33
E01001991,EV motorcycles,Number,0,1,2,3,4,5,7,8,10,11,13,14,16,17,18,19,20,21,21,22,22,22,23,23,23,23,23,23,23,23
E01001992,EV motorcycles,Number,0,1,2,4,5,7,9,11,14,16,18,20,22,24,25,27,28,29,30,30,31,31,31,32,32,32,32,32,32,32
E01001993,EV motorcycles,Number,0,1,2,3,4,6,8,9,11,13,15,16,18,19,20,22,23,23,24,25,25,25,25,26,26,26,26,26,26,26
E01001994,EV motorcycles,Number,0,1,2,4,5,7,9,11,14,16,18,20,22,24,25,27,28,29,30,30,31,31,31,32,32,32,32,32,32,32
E01001995,EV motorcycles,Number,1,1,2,4,6,8,10,13,15,18,20,22,25,27,28,30,31,32,33,34,35,35,35,35,36,36,36,36,36,36
E01001996,EV motorcycles,Number,0,1,1,2,4,5,6,7,9,10,12,13,14,16,17,17,18,19,19,20,20,20,21,21,21,21,21,21,21,21
E01001997,EV motorcycles,Number,0,1,1,2,4,5,6,8,9,11,12,14,15,16,17,18,19,20,20,21,21,21,22,22,22,22,22,22,22,22
E01001998,EV motorcycles,Number,0,1,2,3,5,6,8,10,11,13,15,17,18,20,21,22,23,24,25,25,26,26,26,27,27,27,27,27,27,27
E01001999,EV motorcycles,Number,0,1,2,4,5,7,9,11,14,16,18,20,22,24,25,27,28,29,30,30,31,31,31,32,32,32,32,32,32,32
E01002000,EV motorcycles,Number,0,1,2,4,6,8,10,12,14,17,19,21,23,25,27,28,30,31,31,32,33,33,33,33,34,34,34,34,34,34
E01002001,EV motorcycles,Number,1,1,2,4,6,8,10,13,15,18,20,22,25,27,28,30,31,32,33,34,35,35,35,35,36,36,36,36,36,36
E01002002,EV motorcycles,Number,1,1,3,5,7,9,12,15,17,20,23,26,28,30,32,34,36,37,38,39,39,40,40,40,41,41,41,41,41,41
E01002003,EV motorcycles,Number,0,1,2,3,4,6,8,9,11,13,15,16,18,19,20,22,23,23,24,25,25,25,25,26,26,26,26,26,26,26
E01002004,EV motorcycles,Number,0,1,2,3,5,6,8,10,12,14,16,17,19,21,22,23,24,25,26,26,27,27,27,28,28,28,28,28,28,28
E01002005,EV motorcycles,Number,0,1,2,3,4,6,7,9,11,12,14,16,17,18,20,21,22,22,23,24,24,24,24,25,25,25,25,25,25,25
E01002006,EV motorcycles,Number,0,1,2,3,4,5,7,8,10,11,13,14,16,17,18,19,20,21,21,22,22,22,23,23,23,23,23,23,23,23
E01002007,EV motorcycles,Number,0,1,1,2,3,4,5,7,8,9,11,12,13,14,15,16,17,17,18,18,18,18,19,19,19,19,19,19,19,19
E01002008,EV motorcycles,Number,0,1,1,2,2,3,4,5,6,7,8,9,10,10,11,12,12,13,13,13,13,14,14,14,14,14,14,14,14,14
E01002009,EV motorcycles,Number,0,1,1,2,3,4,5,7,8,9,11,12,13,14,15,16,17,17,18,18,18,18,19,19,19,19,19,19,19,19
E01002010,EV motorcycles,Number,0,1,1,2,3,4,5,6,7,8,10,11,12,13,13,14,15,15,16,16,16,16,17,17,17,17,17,17,17,17
E01002011,EV motorcycles,Number,0,1,1,2,4,5,6,8,9,11,12,14,15,16,17,18,19,20,20,21,21,21,22,22,22,22,22,22,22,22
E01002013,EV motorcycles,Number,0,1,1,2,4,5,6,8,9,11,12,14,15,16,17,18,19,20,20,21,21,21,22,22,22,22,22,22,22,22
E01002014,EV motorcycles,Number,0,1,2,3,4,6,8,9,11,13,15,16,18,19,20,22,23,23,24,25,25,25,25,26,26,26,26,26,26,26
E01002015,EV motorcycles,Number,0,1,1,2,3,4,5,7,8,9,11,12,13,14,15,16,17,17,18,18,18,18,19,19,19,19,19,19,19,19
E01002016,EV motorcycles,Number,0,1,1,2,3,4,5,7,8,9,11,12,13,14,15,16,17,17,18,18,18,18,19,19,19,19,19,19,19,19
E01002017,EV motorcycles,Number,0,1,1,2,4,5,6,8,9,11,12,14,15,16,17,18,19,20,20,21,21,21,22,22,22,22,22,22,22,22
E01002018,EV motorcycles,Number,0,0,0,1,1,2,2,2,3,3,4,4,5,5,6,6,6,6,6,7,7,7,7,7,7,7,7,7,7,7
E01002019,EV motorcycles,Number,0,1,1,2,3,4,5,7,8,9,11,12,13,14,15,16,17,17,18,18,18,18,19,19,19,19,19,19,19,19
E01002020,EV motorcycles,Number,0,1,2,3,4,5,7,9,10,12,13,15,16,18,19,20,21,22,22,23,23,23,23,24,24,24,24,24,24,24
E01002021,EV motorcycles,Number,0,1,2,4,6,7,10,12,14,16,18,21,23,24,26,27,29,30,31,31,32,32,32,33,33,33,33,33,33,33
E01002022,EV motorcycles,Number,1,1,3,4,7,9,11,14,16,19,22,24,27,29,31,32,34,35,36,37,37,38,38,38,39,39,39,39,39,39
E01002023,EV motorcycles,Number,0,1,2,3,4,5,7,9,10,12,13,15,16,18,19,20,21,22,22,23,23,23,23,24,24,24,24,24,24,24
E01002024,EV motorcycles,Number,0,1,2,3,4,5,7,8,10,11,13,14,16,17,18,19,20,21,21,22,22,22,23,23,23,23,23,23,23,23
E01002025,EV motorcycles,Number,0,1,1,2,3,4,6,7,8,10,11,12,14,15,16,17,17,18,18,19,19,19,20,20,20,20,20,20,20,20
E01002026,EV motorcycles,Number,0,1,2,3,5,7,8,10,12,14,16,18,20,21,23,24,25,26,27,27,28,28,28,29,29,29,29,29,29,29
E01002027,EV motorcycles,Number,0,0,1,1,2,3,3,4,5,6,7,7,8,9,9,10,10,11,11,11,12,12,12,12,12,12,12,12,12,12
E01002028,EV motorcycles,Number,0,1,1,2,3,4,6,7,8,10,11,12,14,15,16,17,17,18,18,19,19,19,20,20,20,20,20,20,20,20
E01002029,EV motorcycles,Number,0,1,1,2,3,4,5,7,8,9,11,12,13,14,15,16,17,17,18,18,18,18,19,19,19,19,19,19,19,19
E01002030,EV motorcycles,Number,0,1,1,2,3,4,5,6,7,8,10,11,12,13,13,14,15,15,16,16,16,16,17,17,17,17,17,17,17,17
E01002031,EV motorcycles,Number,0,1,2,3,4,5,7,9,10,12,13,15,16,18,19,20,21,22,22,23,23,23,23,24,24,24,24,24,24,24
E01002032,EV motorcycles,Number,1,2,4,7,10,14,18,22,26,30,35,39,42,46,49,52,54,56,57,59,59,60,61,61,61,62,62,62,62,62
E01002033,EV motorcycles,Number,0,1,1,2,4,5,6,8,9,11,12,14,15,16,17,18,19,20,20,21,21,21,22,22,22,22,22,22,22,22
E01002034,EV motorcycles,Number,0,0,1,1,2,3,3,4,5,6,7,7,8,9,9,10,10,11,11,11,12,12,12,12,12,12,12,12,12,12
E01002036,EV motorcycles,Number,0,1,2,4,6,8,10,12,14,17,19,21,23,25,27,28,30,31,31,32,33,33,33,33,34,34,34,34,34,34
E01002037,EV motorcycles,Number,0,1,1,2,4,5,6,8,9,11,12,14,15,16,17,18,19,20,20,21,21,21,22,22,22,22,22,22,22,22
E01002038,EV motorcycles,Number,0,1,2,3,4,5,7,8,10,11,13,14,16,17,18,19,20,21,21,22,22,22,23,23,23,23,23,23,23,23
E01002039,EV motorcycles,Number,0,0,0,1,1,2,2,2,3,3,4,4,5,5,6,6,6,6,6,7,7,7,7,7,7,7,7,7,7,7
E01002040,EV motorcycles,Number,0,1,2,3,5,6,8,10,11,13,15,17,18,20,21,22,23,24,25,25,26,26,26,27,27,27,27,27,27,27
E01002041,EV motorcycles,Number,1,2,3,5,7,9,12,15,18,21,24,26,29,31,33,35,36,38,39,40,40,41,41,41,42,42,42,42,42,42
E01002042,EV motorcycles,Number,0,1,1,2,3,4,6,7,8,10,11,12,14,15,16,17,17,18,18,19,19,19,20,20,20,20,20,20,20,20
E01002043,EV motorcycles,Number,1,2,3,5,8,11,14,17,20,24,27,30,33,35,38,40,42,43,44,45,46,47,47,47,48,48,48,48,48,48
E01002044,EV motorcycles,Number,1,1,2,4,6,8,10,12,15,17,20,22,24,26,28,29,30,31,32,33,34,34,34,34,35,35,35,35,35,35
E01002045,EV motorcycles,Number,0,1,2,3,4,6,8,9,11,13,15,16,18,19,20,22,23,23,24,25,25,25,25,26,26,26,26,26,26,26
E01002046,EV motorcycles,Number,1,2,3,5,8,10,13,16,19,23,26,29,31,34,36,38,40,41,43,43,44,45,45,45,46,46,46,46,46,46
E01002047,EV motorcycles,Number,0,1,2,3,4,5,7,9,10,12,13,15,16,18,19,20,21,22,22,23,23,23,23,24,24,24,24,24,24,24
E01002048,EV motorcycles,Number,0,1,2,4,6,8,10,12,14,17,19,21,23,25,27,28,30,31,31,32,33,33,33,33,34,34,34,34,34,34
E01002049,EV motorcycles,Number,0,1,2,4,6,8,10,12,14,17,19,21,23,25,27,28,30,31,31,32,33,33,33,33,34,34,34,34,34,34
E01002050,EV motorcycles,Number,0,1,1,2,3,3,4,5,6,7,8,9,10,11,12,12,13,13,14,14,14,15,15,15,15,15,15,15,15,15
E01002051,EV motorcycles,Number,1,2,4,6,10,13,16,20,24,28,32,35,39,42,45,47,50,51,53,54,55,55,56,56,56,57,57,57,57,57
E01002052,EV motorcycles,Number,0,0,1,1,2,2,3,4,5,5,6,7,8,8,9,9,10,10,10,10,11,11,11,11,11,11,11,11,11,11
E01002053,EV motorcycles,Number,0,1,2,4,6,8,10,12,14,17,19,21,23,25,27,28,30,31,31,32,33,33,33,33,34,34,34,34,34,34
E01002054,EV motorcycles,Number,0,1,2,3,4,6,7,9,11,12,14,16,17,18,20,21,22,22,23,24,24,24,24,25,25,25,25,25,25,25
E01002055,EV motorcycles,Number,0,1,2,3,4,6,7,9,11,12,14,16,17,18,20,21,22,22,23,24,24,24,24,25,25,25,25,25,25,25
E01002056,EV motorcycles,Number,1,2,3,6,8,11,14,18,21,25,28,31,34,37,39,42,43,45,46,47,48,49,49,49,49,50,50,50,50,50
E01002057,EV motorcycles,Number,1,1,2,4,6,8,10,13,15,18,20,22,25,27,28,30,31,32,33,34,35,35,35,35,36,36,36,36,36,36
E01002058,EV motorcycles,Number,0,1,1,2,4,5,6,7,9,10,12,13,14,16,17,17,18,19,19,20,20,20,21,21,21,21,21,21,21,21
E01002059,EV motorcycles,Number,0,1,1,2,3,4,5,6,8,9,10,11,12,13,14,15,16,16,17,17,17,17,18,18,18,18,18,18,18,18
E01002060,EV motorcycles,Number,0,1,1,2,3,3,4,5,6,7,8,9,10,11,12,12,13,13,14,14,14,15,15,15,15,15,15,15,15,15
E01002061,EV motorcycles,Number,0,0,1,1,2,2,3,4,4,5,6,6,7,7,8,8,9,9,9,9,10,10,10,10,10,10,10,10,10,10
E01002062,EV motorcycles,Number,0,1,2,3,4,5,7,9,10,12,13,15,16,18,19,20,21,22,22,23,23,23,23,24,24,24,24,24,24,24
E01002063,EV motorcycles,Number,0,1,1,2,3,3,4,5,6,7,8,9,10,11,12,12,13,13,14,14,14,15,15,15,15,15,15,15,15,15
E01002064,EV motorcycles,Number,0,1,1,2,2,3,4,5,6,7,8,9,10,10,11,12,12,13,13,13,13,14,14,14,14,14,14,14,14,14
E01002065,EV motorcycles,Number,1,2,3,6,8,11,14,18,21,25,28,31,34,37,39,42,43,45,46,47,48,49,49,49,49,50,50,50,50,50
E01002066,EV motorcycles,Number,0,1,2,3,4,6,8,9,11,13,15,16,18,19,20,22,23,23,24,25,25,25,25,26,26,26,26,26,26,26
E01002067,EV motorcycles,Number,1,1,2,4,6,8,10,13,15,18,20,22,25,27,28,30,31,32,33,34,35,35,35,35,36,36,36,36,36,36
E01002068,EV motorcycles,Number,1,2,4,7,11,15,20,24,29,33,38,42,46,50,54,57,59,61,63,64,65,66,67,67,67,68,68,68,68,68
E01002069,EV motorcycles,Number,1,2,3,5,8,11,14,17,20,24,27,30,33,35,38,40,42,43,44,45,46,47,47,47,48,48,48,48,48,48
E01002070,EV motorcycles,Number,0,1,2,3,5,7,8,10,12,14,16,18,20,21,23,24,25,26,27,27,28,28,28,29,29,29,29,29,29,29
E01002071,EV motorcycles,Number,1,1,2,4,6,9,11,13,16,19,21,24,26,28,30,32,33,34,35,36,36,37,37,37,38,38,38,38,38,38
E01002072,EV motorcycles,Number,0,1,2,3,5,7,8,10,12,14,16,18,20,21,23,24,25,26,27,27,28,28,28,29,29,29,29,29,29,29
E01002073,EV motorcycles,Number,0,1,2,3,5,7,9,11,13,15,17,19,21,22,24,25,26,27,28,28,29,29,29,30,30,30,30,30,30,30
E01002074,EV motorcycles,Number,0,1,1,2,3,4,5,6,7,8,9,10,11,12,13,13,14,14,15,15,15,16,16,16,16,16,16,16,16,16
E01002075,EV motorcycles,Number,0,1,1,2,3,4,5,6,7,8,10,11,12,13,13,14,15,15,16,16,16,16,17,17,17,17,17,17,17,17
E01002076,EV motorcycles,Number,0,1,2,3,4,6,7,9,11,12,14,16,17,18,20,21,22,22,23,24,24,24,24,25,25,25,25,25,25,25
E01002077,EV motorcycles,Number,0,1,1,2,4,5,6,8,9,11,12,14,15,16,17,18,19,20,20,21,21,21,22,22,22,22,22,22,22,22
E01002078,EV motorcycles,Number,0,1,2,4,6,7,10,12,14,16,18,21,23,24,26,27,29,30,31,31,32,32,32,33,33,33,33,33,33,33
E01002079,EV motorcycles,Number,1,2,3,5,7,10,13,16,19,22,25,27,30,33,35,37,38,40,41,42,42,43,43,43,44,44,44,44,44,44
E01002080,EV motorcycles,Number,1,2,3,6,9,12,15,18,22,26,29,32,36,38,41,43,45,47,48,49,50,50,51,51,51,52,52,52,52,52
E01002081,EV motorcycles,Number,0,1,1,2,3,4,5,6,8,9,10,11,12,13,14,15,16,16,17,17,17,17,18,18,18,18,18,18,18,18
E01002082,EV motorcycles,Number,0,0,0,0,0,0,0,0,0,0,0,0,0,0,0,0,0,0,0,0,0,0,0,0,0,0,0,0,0,0
E01002083,EV motorcycles,Number,0,1,1,2,3,3,4,5,6,7,8,9,10,11,12,12,13,13,14,14,14,15,15,15,15,15,15,15,15,15
E01002084,EV motorcycles,Number,1,1,3,5,7,9,12,15,17,20,23,26,28,30,32,34,36,37,38,39,39,40,40,40,41,41,41,41,41,41
E01002085,EV motorcycles,Number,0,1,2,3,5,7,8,10,12,14,16,18,20,21,23,24,25,26,27,27,28,28,28,29,29,29,29,29,29,29
E01002086,EV motorcycles,Number,0,1,2,3,5,7,8,10,12,14,16,18,20,21,23,24,25,26,27,27,28,28,28,29,29,29,29,29,29,29
E01002087,EV motorcycles,Number,0,1,2,3,5,7,9,11,13,15,17,19,21,23,24,26,27,28,29,29,30,30,30,31,31,31,31,31,31,31
E01002088,EV motorcycles,Number,1,2,3,6,9,11,15,18,22,25,29,32,35,38,40,42,44,46,47,48,49,49,50,50,50,51,51,51,51,51
E01002089,EV motorcycles,Number,0,0,1,1,1,2,2,3,3,4,4,5,5,6,6,7,7,7,7,8,8,8,8,8,8,8,8,8,8,8
E01002090,EV motorcycles,Number,0,1,2,3,4,5,7,8,10,11,13,14,16,17,18,19,20,21,21,22,22,22,23,23,23,23,23,23,23,23
E01002091,EV motorcycles,Number,0,1,1,2,3,4,5,6,7,8,9,10,11,12,13,13,14,14,15,15,15,16,16,16,16,16,16,16,16,16
E01002092,EV motorcycles,Number,0,1,1,2,3,4,6,7,8,10,11,12,14,15,16,17,17,18,18,19,19,19,20,20,20,20,20,20,20,20
E01002093,EV motorcycles,Number,0,1,1,2,3,4,5,6,7,8,10,11,12,13,13,14,15,15,16,16,16,16,17,17,17,17,17,17,17,17
E01002094,EV motorcycles,Number,0,1,1,2,4,5,6,7,9,10,12,13,14,16,17,17,18,19,19,20,20,20,21,21,21,21,21,21,21,21
E01002095,EV motorcycles,Number,0,1,2,4,5,7,9,11,14,16,18,20,22,24,25,27,28,29,30,30,31,31,31,32,32,32,32,32,32,32
E01002096,EV motorcycles,Number,0,1,1,2,3,4,5,7,8,9,11,12,13,14,15,16,17,17,18,18,18,18,19,19,19,19,19,19,19,19
E01002097,EV motorcycles,Number,0,1,1,2,3,4,5,6,8,9,10,11,12,13,14,15,16,16,17,17,17,17,18,18,18,18,18,18,18,18
E01002098,EV motorcycles,Number,0,1,2,3,5,6,8,10,12,14,16,17,19,21,22,23,24,25,26,26,27,27,27,28,28,28,28,28,28,28
E01002099,EV motorcycles,Number,0,1,1,2,3,4,5,6,8,9,10,11,12,13,14,15,16,16,17,17,17,17,18,18,18,18,18,18,18,18
E01002100,EV motorcycles,Number,1,2,4,7,10,13,17,21,25,29,33,37,40,44,47,49,51,53,55,56,57,57,58,58,58,59,59,59,59,59
E01002101,EV motorcycles,Number,0,1,2,4,5,7,9,11,14,16,18,20,22,24,25,27,28,29,30,30,31,31,31,32,32,32,32,32,32,32
E01002102,EV motorcycles,Number,0,1,1,2,3,4,5,7,8,9,11,12,13,14,15,16,17,17,18,18,18,18,19,19,19,19,19,19,19,19
E01002103,EV motorcycles,Number,0,1,2,3,4,5,7,8,10,11,13,14,16,17,18,19,20,21,21,22,22,22,23,23,23,23,23,23,23,23
E01002104,EV motorcycles,Number,0,1,2,3,5,6,8,10,12,14,16,17,19,21,22,23,24,25,26,26,27,27,27,28,28,28,28,28,28,28
E01002105,EV motorcycles,Number,1,1,2,4,6,8,11,13,16,18,21,23,25,27,29,31,32,33,34,35,35,36,36,36,37,37,37,37,37,37
E01002106,EV motorcycles,Number,0,1,1,2,3,3,4,5,6,7,8,9,10,11,12,12,13,13,14,14,14,15,15,15,15,15,15,15,15,15
E01002107,EV motorcycles,Number,0,0,1,1,2,2,3,4,4,5,6,6,7,7,8,8,9,9,9,9,10,10,10,10,10,10,10,10,10,10
E01002108,EV motorcycles,Number,0,0,1,1,2,2,3,3,4,4,5,6,6,7,7,7,8,8,8,8,9,9,9,9,9,9,9,9,9,9
E01002109,EV motorcycles,Number,0,1,2,3,4,5,7,8,10,11,13,14,16,17,18,19,20,21,21,22,22,22,23,23,23,23,23,23,23,23
E01002110,EV motorcycles,Number,0,1,1,2,3,4,5,6,7,8,9,10,11,12,13,13,14,14,15,15,15,16,16,16,16,16,16,16,16,16
E01002111,EV motorcycles,Number,0,1,2,3,4,6,7,9,11,12,14,16,17,18,20,21,22,22,23,24,24,24,24,25,25,25,25,25,25,25
E01002112,EV motorcycles,Number,0,1,1,2,3,4,5,6,7,8,10,11,12,13,13,14,15,15,16,16,16,16,17,17,17,17,17,17,17,17
E01002113,EV motorcycles,Number,0,0,1,1,2,2,3,4,5,5,6,7,8,8,9,9,10,10,10,10,11,11,11,11,11,11,11,11,11,11
E01002114,EV motorcycles,Number,0,1,1,2,3,4,5,6,8,9,10,11,12,13,14,15,16,16,17,17,17,17,18,18,18,18,18,18,18,18
E01002115,EV motorcycles,Number,0,0,1,1,2,2,3,4,5,5,6,7,8,8,9,9,10,10,10,10,11,11,11,11,11,11,11,11,11,11
E01002116,EV motorcycles,Number,0,1,1,2,3,4,5,6,8,9,10,11,12,13,14,15,16,16,17,17,17,17,18,18,18,18,18,18,18,18
E01002117,EV motorcycles,Number,0,1,1,2,4,5,6,8,9,11,12,14,15,16,17,18,19,20,20,21,21,21,22,22,22,22,22,22,22,22
E01002118,EV motorcycles,Number,1,3,6,9,14,19,25,30,36,42,48,53,58,63,67,71,74,76,79,80,82,82,83,84,84,84,85,85,85,85
E01002119,EV motorcycles,Number,0,1,2,3,4,6,8,9,11,13,15,16,18,19,20,22,23,23,24,25,25,25,25,26,26,26,26,26,26,26
E01002120,EV motorcycles,Number,0,0,0,1,1,1,1,2,2,2,3,3,3,4,4,4,4,4,5,5,5,5,5,5,5,5,5,5,5,5
E01002121,EV motorcycles,Number,0,0,1,1,2,2,3,4,5,5,6,7,8,8,9,9,10,10,10,10,11,11,11,11,11,11,11,11,11,11
E01002122,EV motorcycles,Number,0,1,1,2,3,4,5,6,7,8,10,11,12,13,13,14,15,15,16,16,16,16,17,17,17,17,17,17,17,17
E01002123,EV motorcycles,Number,0,1,1,2,4,5,6,8,9,11,12,14,15,16,17,18,19,20,20,21,21,21,22,22,22,22,22,22,22,22
E01002124,EV motorcycles,Number,0,0,1,1,2,3,4,5,5,6,7,8,9,10,10,11,11,12,12,12,12,13,13,13,13,13,13,13,13,13
E01002125,EV motorcycles,Number,0,1,1,2,3,4,6,7,8,10,11,12,14,15,16,17,17,18,18,19,19,19,20,20,20,20,20,20,20,20
E01002126,EV motorcycles,Number,1,1,2,4,6,9,11,13,16,19,21,24,26,28,30,32,33,34,35,36,36,37,37,37,38,38,38,38,38,38
E01002127,EV motorcycles,Number,0,1,1,2,4,5,6,8,9,11,12,14,15,16,17,18,19,20,20,21,21,21,22,22,22,22,22,22,22,22
E01002128,EV motorcycles,Number,0,1,2,3,4,6,8,9,11,13,15,16,18,19,20,22,23,23,24,25,25,25,25,26,26,26,26,26,26,26
E01002129,EV motorcycles,Number,0,1,1,2,3,4,5,6,7,8,9,10,11,12,13,13,14,14,15,15,15,16,16,16,16,16,16,16,16,16
E01002130,EV motorcycles,Number,0,1,2,4,6,8,10,12,14,17,19,21,23,25,27,28,30,31,31,32,33,33,33,33,34,34,34,34,34,34
E01002131,EV motorcycles,Number,0,0,1,1,2,2,3,3,4,4,5,6,6,7,7,7,8,8,8,8,9,9,9,9,9,9,9,9,9,9
E01002132,EV motorcycles,Number,0,1,1,2,3,4,5,7,8,9,11,12,13,14,15,16,17,17,18,18,18,18,19,19,19,19,19,19,19,19
E01002133,EV motorcycles,Number,0,1,1,2,3,4,5,6,8,9,10,11,12,13,14,15,16,16,17,17,17,17,18,18,18,18,18,18,18,18
E01002134,EV motorcycles,Number,0,1,1,2,4,5,6,7,9,10,12,13,14,16,17,17,18,19,19,20,20,20,21,21,21,21,21,21,21,21
E01002135,EV motorcycles,Number,0,1,1,2,3,4,6,7,8,10,11,12,14,15,16,17,17,18,18,19,19,19,20,20,20,20,20,20,20,20
E01002136,EV motorcycles,Number,0,1,2,3,5,6,8,10,11,13,15,17,18,20,21,22,23,24,25,25,26,26,26,27,27,27,27,27,27,27
E01002137,EV motorcycles,Number,0,0,1,1,1,2,2,3,3,4,4,5,5,6,6,7,7,7,7,8,8,8,8,8,8,8,8,8,8,8
E01002138,EV motorcycles,Number,0,1,1,2,3,4,5,6,7,8,10,11,12,13,13,14,15,15,16,16,16,16,17,17,17,17,17,17,17,17
E01002139,EV motorcycles,Number,0,1,1,2,3,4,5,7,8,9,11,12,13,14,15,16,17,17,18,18,18,18,19,19,19,19,19,19,19,19
E01002140,EV motorcycles,Number,0,1,2,3,4,6,7,9,11,12,14,16,17,18,20,21,22,22,23,24,24,24,24,25,25,25,25,25,25,25
E01002141,EV motorcycles,Number,0,1,1,2,3,4,5,6,7,8,9,10,11,12,13,13,14,14,15,15,15,16,16,16,16,16,16,16,16,16
E01002142,EV motorcycles,Number,0,0,1,1,2,3,4,5,5,6,7,8,9,10,10,11,11,12,12,12,12,13,13,13,13,13,13,13,13,13
E01002143,EV motorcycles,Number,0,1,1,2,3,3,4,5,6,7,8,9,10,11,12,12,13,13,14,14,14,15,15,15,15,15,15,15,15,15
E01002144,EV motorcycles,Number,0,0,1,1,2,2,3,3,4,4,5,6,6,7,7,7,8,8,8,8,9,9,9,9,9,9,9,9,9,9
E01002145,EV motorcycles,Number,0,0,1,1,2,2,3,4,4,5,6,6,7,7,8,8,9,9,9,9,10,10,10,10,10,10,10,10,10,10
E01002146,EV motorcycles,Number,0,0,1,1,2,2,3,4,4,5,6,6,7,7,8,8,9,9,9,9,10,10,10,10,10,10,10,10,10,10
E01002147,EV motorcycles,Number,0,0,1,1,2,3,4,5,5,6,7,8,9,10,10,11,11,12,12,12,12,13,13,13,13,13,13,13,13,13
E01002148,EV motorcycles,Number,0,0,1,1,2,2,3,3,4,4,5,6,6,7,7,7,8,8,8,8,9,9,9,9,9,9,9,9,9,9
E01002149,EV motorcycles,Number,0,1,1,2,3,3,4,5,6,7,8,9,10,11,12,12,13,13,14,14,14,15,15,15,15,15,15,15,15,15
E01002150,EV motorcycles,Number,0,1,2,3,4,5,7,8,10,11,13,14,16,17,18,19,20,21,21,22,22,22,23,23,23,23,23,23,23,23
E01002151,EV motorcycles,Number,0,1,1,2,3,3,4,5,6,7,8,9,10,11,12,12,13,13,14,14,14,15,15,15,15,15,15,15,15,15
E01002152,EV motorcycles,Number,0,0,1,1,2,2,3,4,4,5,6,6,7,7,8,8,9,9,9,9,10,10,10,10,10,10,10,10,10,10
E01002153,EV motorcycles,Number,0,0,0,1,1,1,2,2,3,3,3,4,4,4,5,5,5,5,6,6,6,6,6,6,6,6,6,6,6,6
E01002154,EV motorcycles,Number,0,1,2,3,5,6,8,10,12,14,16,17,19,21,22,23,24,25,26,26,27,27,27,28,28,28,28,28,28,28
E01002155,EV motorcycles,Number,0,0,1,1,2,3,4,5,5,6,7,8,9,10,10,11,11,12,12,12,12,13,13,13,13,13,13,13,13,13
E01002156,EV motorcycles,Number,0,0,1,1,1,2,2,3,3,4,4,5,5,6,6,7,7,7,7,8,8,8,8,8,8,8,8,8,8,8
E01002157,EV motorcycles,Number,0,1,1,2,3,4,5,6,7,8,10,11,12,13,13,14,15,15,16,16,16,16,17,17,17,17,17,17,17,17
E01002158,EV motorcycles,Number,0,1,1,2,3,4,5,6,7,8,9,10,11,12,13,13,14,14,15,15,15,16,16,16,16,16,16,16,16,16
E01002159,EV motorcycles,Number,0,1,1,2,3,4,5,6,7,8,10,11,12,13,13,14,15,15,16,16,16,16,17,17,17,17,17,17,17,17
E01002160,EV motorcycles,Number,0,1,2,3,5,6,8,10,12,14,16,17,19,21,22,23,24,25,26,26,27,27,27,28,28,28,28,28,28,28
E01002161,EV motorcycles,Number,0,1,1,2,3,4,5,6,7,8,10,11,12,13,13,14,15,15,16,16,16,16,17,17,17,17,17,17,17,17
E01002162,EV motorcycles,Number,0,1,1,2,4,5,6,8,9,11,12,14,15,16,17,18,19,20,20,21,21,21,22,22,22,22,22,22,22,22
E01002163,EV motorcycles,Number,0,1,1,2,3,4,5,6,8,9,10,11,12,13,14,15,16,16,17,17,17,17,18,18,18,18,18,18,18,18
E01002164,EV motorcycles,Number,0,1,1,2,4,5,6,8,9,11,12,14,15,16,17,18,19,20,20,21,21,21,22,22,22,22,22,22,22,22
E01002165,EV motorcycles,Number,0,1,1,2,3,4,5,6,8,9,10,11,12,13,14,15,16,16,17,17,17,17,18,18,18,18,18,18,18,18
E01002166,EV motorcycles,Number,0,0,0,1,1,1,1,2,2,2,3,3,3,4,4,4,4,4,5,5,5,5,5,5,5,5,5,5,5,5
E01002167,EV motorcycles,Number,0,1,1,2,3,4,5,7,8,9,11,12,13,14,15,16,17,17,18,18,18,18,19,19,19,19,19,19,19,19
E01002168,EV motorcycles,Number,0,1,1,2,3,4,5,6,7,8,10,11,12,13,13,14,15,15,16,16,16,16,17,17,17,17,17,17,17,17
E01002169,EV motorcycles,Number,0,1,1,2,3,4,5,6,7,8,10,11,12,13,13,14,15,15,16,16,16,16,17,17,17,17,17,17,17,17
E01002170,EV motorcycles,Number,0,0,1,1,2,3,4,5,5,6,7,8,9,10,10,11,11,12,12,12,12,13,13,13,13,13,13,13,13,13
E01002171,EV motorcycles,Number,0,0,1,1,2,3,4,5,5,6,7,8,9,10,10,11,11,12,12,12,12,13,13,13,13,13,13,13,13,13
E01002172,EV motorcycles,Number,0,1,1,2,4,5,6,8,9,11,12,14,15,16,17,18,19,20,20,21,21,21,22,22,22,22,22,22,22,22
E01002173,EV motorcycles,Number,0,1,2,3,4,5,7,8,10,11,13,14,16,17,18,19,20,21,21,22,22,22,23,23,23,23,23,23,23,23
E01002174,EV motorcycles,Number,0,0,1,1,2,3,4,5,5,6,7,8,9,10,10,11,11,12,12,12,12,13,13,13,13,13,13,13,13,13
E01002175,EV motorcycles,Number,0,1,1,2,4,5,6,7,9,10,12,13,14,16,17,17,18,19,19,20,20,20,21,21,21,21,21,21,21,21
E01002176,EV motorcycles,Number,0,1,1,2,3,4,6,7,8,10,11,12,14,15,16,17,17,18,18,19,19,19,20,20,20,20,20,20,20,20
E01002177,EV motorcycles,Number,0,1,2,3,4,6,8,9,11,13,15,16,18,19,20,22,23,23,24,25,25,25,25,26,26,26,26,26,26,26
E01002178,EV motorcycles,Number,0,1,2,3,4,5,7,8,10,11,13,14,16,17,18,19,20,21,21,22,22,22,23,23,23,23,23,23,23,23
E01002179,EV motorcycles,Number,1,1,3,4,7,9,11,14,16,19,22,24,27,29,31,32,34,35,36,37,37,38,38,38,39,39,39,39,39,39
E01002180,EV motorcycles,Number,0,1,2,4,6,7,10,12,14,16,18,21,23,24,26,27,29,30,31,31,32,32,32,33,33,33,33,33,33,33
E01002181,EV motorcycles,Number,0,1,2,3,5,7,9,11,13,15,17,19,21,22,24,25,26,27,28,28,29,29,29,30,30,30,30,30,30,30
E01002182,EV motorcycles,Number,0,1,2,3,4,6,7,9,11,12,14,16,17,18,20,21,22,22,23,24,24,24,24,25,25,25,25,25,25,25
E01002183,EV motorcycles,Number,0,1,2,3,4,5,7,8,10,11,13,14,16,17,18,19,20,21,21,22,22,22,23,23,23,23,23,23,23,23
E01002184,EV motorcycles,Number,0,1,2,3,5,7,9,11,13,15,17,19,21,23,24,26,27,28,29,29,30,30,30,31,31,31,31,31,31,31
E01002185,EV motorcycles,Number,0,1,1,2,3,4,5,6,7,8,10,11,12,13,13,14,15,15,16,16,16,16,17,17,17,17,17,17,17,17
E01002186,EV motorcycles,Number,0,1,1,2,3,4,6,7,8,10,11,12,14,15,16,17,17,18,18,19,19,19,20,20,20,20,20,20,20,20
E01002187,EV motorcycles,Number,0,0,1,1,2,2,3,4,4,5,6,6,7,7,8,8,9,9,9,9,10,10,10,10,10,10,10,10,10,10
E01002188,EV motorcycles,Number,0,1,1,2,3,4,5,6,8,9,10,11,12,13,14,15,16,16,17,17,17,17,18,18,18,18,18,18,18,18
E01002189,EV motorcycles,Number,0,0,1,1,2,3,3,4,5,6,7,7,8,9,9,10,10,11,11,11,12,12,12,12,12,12,12,12,12,12
E01002190,EV motorcycles,Number,0,1,1,2,3,3,4,5,6,7,8,9,10,11,12,12,13,13,14,14,14,15,15,15,15,15,15,15,15,15
E01002191,EV motorcycles,Number,0,0,1,1,2,3,3,4,5,6,7,7,8,9,9,10,10,11,11,11,12,12,12,12,12,12,12,12,12,12
E01002192,EV motorcycles,Number,0,1,1,2,2,3,4,5,6,7,8,9,10,10,11,12,12,13,13,13,13,14,14,14,14,14,14,14,14,14
E01002193,EV motorcycles,Number,0,1,1,2,3,4,5,6,7,8,9,10,11,12,13,13,14,14,15,15,15,16,16,16,16,16,16,16,16,16
E01002194,EV motorcycles,Number,0,0,1,1,2,2,3,4,4,5,6,6,7,7,8,8,9,9,9,9,10,10,10,10,10,10,10,10,10,10
E01002195,EV motorcycles,Number,0,1,1,2,3,4,5,6,7,8,9,10,11,12,13,13,14,14,15,15,15,16,16,16,16,16,16,16,16,16
E01002196,EV motorcycles,Number,0,1,1,2,3,4,5,6,8,9,10,11,12,13,14,15,16,16,17,17,17,17,18,18,18,18,18,18,18,18
E01002197,EV motorcycles,Number,0,1,2,3,4,6,8,9,11,13,15,16,18,19,20,22,23,23,24,25,25,25,25,26,26,26,26,26,26,26
E01002198,EV motorcycles,Number,0,1,1,2,3,3,4,5,6,7,8,9,10,11,12,12,13,13,14,14,14,15,15,15,15,15,15,15,15,15
E01002199,EV motorcycles,Number,0,1,1,2,3,4,5,6,8,9,10,11,12,13,14,15,16,16,17,17,17,17,18,18,18,18,18,18,18,18
E01002200,EV motorcycles,Number,0,0,1,1,2,2,3,4,5,5,6,7,8,8,9,9,10,10,10,10,11,11,11,11,11,11,11,11,11,11
E01002201,EV motorcycles,Number,0,0,1,1,2,2,3,4,4,5,6,6,7,7,8,8,9,9,9,9,10,10,10,10,10,10,10,10,10,10
E01002202,EV motorcycles,Number,0,1,2,3,5,6,8,10,12,14,16,17,19,21,22,23,24,25,26,26,27,27,27,28,28,28,28,28,28,28
E01002203,EV motorcycles,Number,0,1,1,2,3,4,5,7,8,9,11,12,13,14,15,16,17,17,18,18,18,18,19,19,19,19,19,19,19,19
E01002204,EV motorcycles,Number,0,1,2,3,5,7,9,11,13,15,17,19,21,23,24,26,27,28,29,29,30,30,30,31,31,31,31,31,31,31
E01002206,EV motorcycles,Number,0,1,1,2,3,4,5,6,7,8,9,10,11,12,13,13,14,14,15,15,15,16,16,16,16,16,16,16,16,16
E01002207,EV motorcycles,Number,0,1,1,2,3,4,6,7,8,10,11,12,14,15,16,17,17,18,18,19,19,19,20,20,20,20,20,20,20,20
E01002208,EV motorcycles,Number,0,0,1,1,2,2,3,4,5,5,6,7,8,8,9,9,10,10,10,10,11,11,11,11,11,11,11,11,11,11
E01002209,EV motorcycles,Number,0,1,2,3,4,6,7,9,11,12,14,16,17,18,20,21,22,22,23,24,24,24,24,25,25,25,25,25,25,25
E01002210,EV motorcycles,Number,0,1,2,3,4,6,7,9,11,12,14,16,17,18,20,21,22,22,23,24,24,24,24,25,25,25,25,25,25,25
E01002211,EV motorcycles,Number,0,1,1,2,4,5,6,7,9,10,12,13,14,16,17,17,18,19,19,20,20,20,21,21,21,21,21,21,21,21
E01002212,EV motorcycles,Number,0,1,2,3,5,6,8,10,11,13,15,17,18,20,21,22,23,24,25,25,26,26,26,27,27,27,27,27,27,27
E01002213,EV motorcycles,Number,0,1,2,4,6,7,10,12,14,16,18,21,23,24,26,27,29,30,31,31,32,32,32,33,33,33,33,33,33,33
E01002214,EV motorcycles,Number,0,1,1,2,3,3,4,5,6,7,8,9,10,11,12,12,13,13,14,14,14,15,15,15,15,15,15,15,15,15
E01002215,EV motorcycles,Number,0,1,1,2,3,4,5,6,7,8,10,11,12,13,13,14,15,15,16,16,16,16,17,17,17,17,17,17,17,17
E01002216,EV motorcycles,Number,0,1,1,2,3,4,5,6,8,9,10,11,12,13,14,15,16,16,17,17,17,17,18,18,18,18,18,18,18,18
E01002217,EV motorcycles,Number,0,1,2,3,4,5,7,8,10,11,13,14,16,17,18,19,20,21,21,22,22,22,23,23,23,23,23,23,23,23
E01002218,EV motorcycles,Number,0,1,1,2,2,3,4,5,6,7,8,9,10,10,11,12,12,13,13,13,13,14,14,14,14,14,14,14,14,14
E01002219,EV motorcycles,Number,0,1,1,2,4,5,6,7,9,10,12,13,14,16,17,17,18,19,19,20,20,20,21,21,21,21,21,21,21,21
E01002220,EV motorcycles,Number,0,1,1,2,3,4,6,7,8,10,11,12,14,15,16,17,17,18,18,19,19,19,20,20,20,20,20,20,20,20
E01002221,EV motorcycles,Number,0,1,1,2,3,4,5,7,8,9,11,12,13,14,15,16,17,17,18,18,18,18,19,19,19,19,19,19,19,19
E01002222,EV motorcycles,Number,0,1,1,2,4,5,6,7,9,10,12,13,14,16,17,17,18,19,19,20,20,20,21,21,21,21,21,21,21,21
E01002223,EV motorcycles,Number,0,1,2,3,4,6,8,9,11,13,15,16,18,19,20,22,23,23,24,25,25,25,25,26,26,26,26,26,26,26
E01002224,EV motorcycles,Number,0,0,1,1,2,2,3,4,4,5,6,6,7,8,8,9,9,9,9,10,10,10,10,10,10,10,10,10,10,10
E01002225,EV motorcycles,Number,0,1,1,2,3,3,4,5,6,7,8,9,10,11,12,12,13,13,14,14,14,15,15,15,15,15,15,15,15,15
E01002226,EV motorcycles,Number,0,1,2,3,4,5,7,9,10,12,13,15,16,18,19,20,21,22,22,23,23,23,23,24,24,24,24,24,24,24
E01002227,EV motorcycles,Number,0,1,2,3,4,5,7,9,10,12,13,15,16,18,19,20,21,22,22,23,23,23,23,24,24,24,24,24,24,24
E01002228,EV motorcycles,Number,0,1,2,3,4,5,7,9,10,12,13,15,16,18,19,20,21,22,22,23,23,23,23,24,24,24,24,24,24,24
E01002229,EV motorcycles,Number,0,0,1,1,2,3,4,5,5,6,7,8,9,10,10,11,11,12,12,12,12,13,13,13,13,13,13,13,13,13
E01002230,EV motorcycles,Number,0,1,1,2,3,4,5,6,7,8,10,11,12,13,13,14,15,15,16,16,16,16,17,17,17,17,17,17,17,17
E01002231,EV motorcycles,Number,0,0,1,1,2,3,3,4,5,6,7,7,8,9,9,10,10,11,11,11,12,12,12,12,12,12,12,12,12,12
E01002232,EV motorcycles,Number,1,2,3,5,8,10,13,16,19,23,26,29,31,34,36,38,40,41,43,43,44,45,45,45,46,46,46,46,46,46
E01002233,EV motorcycles,Number,0,1,2,3,4,6,7,9,11,12,14,16,17,18,20,21,22,22,23,24,24,24,24,25,25,25,25,25,25,25
E01002234,EV motorcycles,Number,0,1,2,4,6,8,10,12,14,17,19,21,23,25,27,28,30,31,31,32,33,33,33,33,34,34,34,34,34,34
E01002235,EV motorcycles,Number,0,1,1,2,4,5,6,8,9,11,12,14,15,16,17,18,19,20,20,21,21,21,22,22,22,22,22,22,22,22
E01002236,EV motorcycles,Number,0,1,2,3,5,6,8,10,11,13,15,17,18,20,21,22,23,24,25,25,26,26,26,27,27,27,27,27,27,27
E01002237,EV motorcycles,Number,0,0,1,1,2,3,4,5,5,6,7,8,9,10,10,11,11,12,12,12,12,13,13,13,13,13,13,13,13,13
E01002238,EV motorcycles,Number,0,1,1,2,3,4,5,6,8,9,10,11,12,13,14,15,16,16,17,17,17,17,18,18,18,18,18,18,18,18
E01002239,EV motorcycles,Number,0,1,2,3,4,5,7,9,10,12,13,15,16,18,19,20,21,22,22,23,23,23,23,24,24,24,24,24,24,24
E01002240,EV motorcycles,Number,0,1,1,2,3,3,4,5,6,7,8,9,10,11,12,12,13,13,14,14,14,15,15,15,15,15,15,15,15,15
E01002241,EV motorcycles,Number,0,1,1,2,3,4,5,6,7,8,9,10,11,12,13,13,14,14,15,15,15,16,16,16,16,16,16,16,16,16
E01002242,EV motorcycles,Number,0,0,1,1,2,3,3,4,5,6,7,7,8,9,9,10,10,11,11,11,12,12,12,12,12,12,12,12,12,12
E01002243,EV motorcycles,Number,0,1,1,2,3,4,5,6,8,9,10,11,12,13,14,15,16,16,17,17,17,17,18,18,18,18,18,18,18,18
E01002244,EV motorcycles,Number,0,1,1,2,3,4,5,6,7,8,9,10,11,12,13,13,14,14,15,15,15,16,16,16,16,16,16,16,16,16
E01002245,EV motorcycles,Number,0,0,1,1,2,2,3,4,4,5,6,6,7,7,8,8,9,9,9,9,10,10,10,10,10,10,10,10,10,10
E01002246,EV motorcycles,Number,1,1,3,5,7,9,12,15,17,20,23,26,28,30,32,34,36,37,38,39,39,40,40,40,41,41,41,41,41,41
E01002247,EV motorcycles,Number,0,1,2,4,5,7,9,11,14,16,18,20,22,24,25,27,28,29,30,30,31,31,31,32,32,32,32,32,32,32
E01002248,EV motorcycles,Number,1,2,3,5,8,10,13,16,19,22,25,28,31,33,35,37,39,40,42,42,43,44,44,44,45,45,45,45,45,45
E01002249,EV motorcycles,Number,1,1,2,4,6,8,10,12,15,17,20,22,24,26,28,29,30,31,32,33,34,34,34,34,35,35,35,35,35,35
E01002250,EV motorcycles,Number,1,1,3,4,7,9,11,14,16,19,22,24,27,29,31,32,34,35,36,37,37,38,38,38,39,39,39,39,39,39
E01002251,EV motorcycles,Number,0,1,1,2,3,4,5,6,7,8,9,10,11,12,13,13,14,14,15,15,15,16,16,16,16,16,16,16,16,16
E01002252,EV motorcycles,Number,0,1,2,3,4,5,7,9,10,12,13,15,16,18,19,20,21,22,22,23,23,23,23,24,24,24,24,24,24,24
E01002253,EV motorcycles,Number,0,0,1,1,2,3,4,5,5,6,7,8,9,10,10,11,11,12,12,12,12,13,13,13,13,13,13,13,13,13
E01002254,EV motorcycles,Number,0,0,1,1,2,3,4,5,5,6,7,8,9,10,10,11,11,12,12,12,12,13,13,13,13,13,13,13,13,13
E01002255,EV motorcycles,Number,0,1,2,3,5,6,8,10,12,14,16,17,19,21,22,23,24,25,26,26,27,27,27,28,28,28,28,28,28,28
E01002256,EV motorcycles,Number,0,1,1,2,3,4,5,6,8,9,10,11,12,13,14,15,16,16,17,17,17,17,18,18,18,18,18,18,18,18
E01002257,EV motorcycles,Number,0,1,2,3,5,7,9,11,13,15,17,19,21,22,24,25,26,27,28,28,29,29,29,30,30,30,30,30,30,30
E01002258,EV motorcycles,Number,0,1,1,2,4,5,6,8,9,11,12,14,15,16,17,18,19,20,20,21,21,21,22,22,22,22,22,22,22,22
E01002259,EV motorcycles,Number,0,1,2,3,4,6,7,9,11,12,14,16,17,18,20,21,22,22,23,24,24,24,24,25,25,25,25,25,25,25
E01002260,EV motorcycles,Number,0,1,2,3,4,6,7,9,11,12,14,16,17,18,20,21,22,22,23,24,24,24,24,25,25,25,25,25,25,25
E01002261,EV motorcycles,Number,0,1,1,2,3,4,5,6,8,9,10,11,12,13,14,15,16,16,17,17,17,17,18,18,18,18,18,18,18,18
E01002262,EV motorcycles,Number,0,1,1,2,3,4,5,6,7,8,10,11,12,13,13,14,15,15,16,16,16,16,17,17,17,17,17,17,17,17
E01002263,EV motorcycles,Number,0,1,2,3,4,6,8,9,11,13,15,16,18,19,20,22,23,23,24,25,25,25,25,26,26,26,26,26,26,26
E01002264,EV motorcycles,Number,0,0,1,1,2,3,3,4,5,6,7,7,8,9,9,10,10,11,11,11,12,12,12,12,12,12,12,12,12,12
E01002265,EV motorcycles,Number,0,1,2,3,4,6,7,9,11,12,14,16,17,18,20,21,22,22,23,24,24,24,24,25,25,25,25,25,25,25
E01002266,EV motorcycles,Number,0,1,1,2,3,4,5,7,8,9,11,12,13,14,15,16,17,17,18,18,18,18,19,19,19,19,19,19,19,19
E01002267,EV motorcycles,Number,0,1,2,3,4,5,7,8,10,11,13,14,16,17,18,19,20,21,21,22,22,22,23,23,23,23,23,23,23,23
E01002268,EV motorcycles,Number,0,1,1,2,3,4,5,7,8,9,11,12,13,14,15,16,17,17,18,18,18,18,19,19,19,19,19,19,19,19
E01002269,EV motorcycles,Number,0,1,2,4,6,8,10,12,14,17,19,21,23,25,27,28,30,31,31,32,33,33,33,33,34,34,34,34,34,34
E01002270,EV motorcycles,Number,0,1,2,3,4,6,7,9,11,12,14,16,17,18,20,21,22,22,23,24,24,24,24,25,25,25,25,25,25,25
E01002271,EV motorcycles,Number,0,1,1,2,3,4,5,6,7,8,10,11,12,13,13,14,15,15,16,16,16,16,17,17,17,17,17,17,17,17
E01002272,EV motorcycles,Number,0,1,2,4,6,7,10,12,14,16,18,21,23,24,26,27,29,30,31,31,32,32,32,33,33,33,33,33,33,33
E01002273,EV motorcycles,Number,0,1,1,2,3,4,5,6,7,8,9,10,11,12,13,13,14,14,15,15,15,16,16,16,16,16,16,16,16,16
E01002274,EV motorcycles,Number,0,1,2,3,4,6,7,9,11,12,14,16,17,18,20,21,22,22,23,24,24,24,24,25,25,25,25,25,25,25
E01002275,EV motorcycles,Number,0,1,2,3,4,6,7,9,11,12,14,16,17,18,20,21,22,22,23,24,24,24,24,25,25,25,25,25,25,25
E01002276,EV motorcycles,Number,0,1,2,4,6,8,10,12,14,17,19,21,23,25,27,28,30,31,31,32,33,33,33,33,34,34,34,34,34,34
E01002277,EV motorcycles,Number,0,1,1,2,4,5,6,7,9,10,12,13,14,16,17,17,18,19,19,20,20,20,21,21,21,21,21,21,21,21
E01002278,EV motorcycles,Number,0,1,2,3,5,7,8,10,12,14,16,18,20,21,23,24,25,26,27,27,28,28,28,29,29,29,29,29,29,29
E01002279,EV motorcycles,Number,0,1,2,3,4,5,7,8,10,11,13,14,16,17,18,19,20,21,21,22,22,22,23,23,23,23,23,23,23,23
E01002280,EV motorcycles,Number,0,1,1,2,2,3,4,5,6,7,8,9,10,10,11,12,12,13,13,13,13,14,14,14,14,14,14,14,14,14
E01002281,EV motorcycles,Number,0,1,1,2,3,4,5,7,8,9,11,12,13,14,15,16,17,17,18,18,18,18,19,19,19,19,19,19,19,19
E01002282,EV motorcycles,Number,0,1,1,2,4,5,6,7,9,10,12,13,14,16,17,17,18,19,19,20,20,20,21,21,21,21,21,21,21,21
E01002283,EV motorcycles,Number,0,1,1,2,4,5,6,8,9,11,12,14,15,16,17,18,19,20,20,21,21,21,22,22,22,22,22,22,22,22
E01002284,EV motorcycles,Number,0,1,1,2,3,4,5,7,8,9,11,12,13,14,15,16,17,17,18,18,18,18,19,19,19,19,19,19,19,19
E01002285,EV motorcycles,Number,0,1,1,2,3,3,4,5,6,7,8,9,10,11,12,12,13,13,14,14,14,15,15,15,15,15,15,15,15,15
E01002286,EV motorcycles,Number,0,1,2,3,4,5,7,8,10,11,13,14,16,17,18,19,20,21,21,22,22,22,23,23,23,23,23,23,23,23
E01002287,EV motorcycles,Number,0,1,2,3,4,5,7,9,10,12,13,15,16,18,19,20,21,22,22,23,23,23,23,24,24,24,24,24,24,24
E01002288,EV motorcycles,Number,0,1,1,2,3,4,5,7,8,9,11,12,13,14,15,16,17,17,18,18,18,18,19,19,19,19,19,19,19,19
E01002289,EV motorcycles,Number,0,1,2,3,4,5,7,8,10,11,13,14,16,17,18,19,20,21,21,22,22,22,23,23,23,23,23,23,23,23
E01002290,EV motorcycles,Number,0,1,2,4,6,8,10,12,14,17,19,21,23,25,27,28,30,31,31,32,33,33,33,33,34,34,34,34,34,34
E01002291,EV motorcycles,Number,0,1,2,3,5,7,8,10,12,14,16,18,20,21,23,24,25,26,27,27,28,28,28,29,29,29,29,29,29,29
E01002292,EV motorcycles,Number,0,1,1,2,3,4,5,7,8,9,11,12,13,14,15,16,17,17,18,18,18,18,19,19,19,19,19,19,19,19
E01002293,EV motorcycles,Number,0,1,2,3,4,5,7,9,10,12,13,15,16,18,19,20,21,22,22,23,23,23,23,24,24,24,24,24,24,24
E01002294,EV motorcycles,Number,0,1,2,3,4,5,7,9,10,12,13,15,16,18,19,20,21,22,22,23,23,23,23,24,24,24,24,24,24,24
E01002295,EV motorcycles,Number,0,1,1,2,4,5,6,8,9,11,12,14,15,16,17,18,19,20,20,21,21,21,22,22,22,22,22,22,22,22
E01002296,EV motorcycles,Number,0,1,2,4,6,8,10,12,14,17,19,21,23,25,27,28,30,31,31,32,33,33,33,33,34,34,34,34,34,34
E01002297,EV motorcycles,Number,0,1,2,3,4,5,7,9,10,12,13,15,16,18,19,20,21,22,22,23,23,23,23,24,24,24,24,24,24,24
E01002298,EV motorcycles,Number,0,1,1,2,3,4,5,7,8,9,11,12,13,14,15,16,17,17,18,18,18,18,19,19,19,19,19,19,19,19
E01002299,EV motorcycles,Number,0,1,2,3,5,6,8,10,11,13,15,17,18,20,21,22,23,24,25,25,26,26,26,27,27,27,27,27,27,27
E01002300,EV motorcycles,Number,0,1,2,3,4,5,7,8,10,11,13,14,16,17,18,19,20,21,21,22,22,22,23,23,23,23,23,23,23,23
E01002301,EV motorcycles,Number,0,1,2,4,6,7,10,12,14,16,18,21,23,24,26,27,29,30,31,31,32,32,32,33,33,33,33,33,33,33
E01002302,EV motorcycles,Number,1,1,2,4,6,8,10,12,15,17,20,22,24,26,28,29,30,31,32,33,34,34,34,34,35,35,35,35,35,35
E01002303,EV motorcycles,Number,0,1,2,4,6,8,10,12,14,17,19,21,23,25,27,28,30,31,31,32,33,33,33,33,34,34,34,34,34,34
E01002304,EV motorcycles,Number,0,1,2,3,5,7,8,10,12,14,16,18,20,21,23,24,25,26,27,27,28,28,28,29,29,29,29,29,29,29
E01002305,EV motorcycles,Number,1,1,3,4,7,9,11,14,16,19,22,24,27,29,31,32,34,35,36,37,37,38,38,38,39,39,39,39,39,39
E01002306,EV motorcycles,Number,0,1,2,3,4,6,8,9,11,13,15,16,18,19,20,22,23,23,24,25,25,25,25,26,26,26,26,26,26,26
E01002307,EV motorcycles,Number,0,1,2,3,4,6,7,9,11,12,14,16,17,18,20,21,22,22,23,24,24,24,24,25,25,25,25,25,25,25
E01002308,EV motorcycles,Number,1,2,3,5,7,9,12,15,18,21,24,26,29,31,33,35,36,38,39,40,40,41,41,41,42,42,42,42,42,42
E01002309,EV motorcycles,Number,0,1,1,2,3,4,5,6,7,8,10,11,12,13,13,14,15,15,16,16,16,16,17,17,17,17,17,17,17,17
E01002310,EV motorcycles,Number,0,1,2,3,4,6,7,9,11,12,14,16,17,18,20,21,22,22,23,24,24,24,24,25,25,25,25,25,25,25
E01002311,EV motorcycles,Number,0,1,2,3,4,5,7,8,10,11,13,14,16,17,18,19,20,21,21,22,22,22,23,23,23,23,23,23,23,23
E01002312,EV motorcycles,Number,0,1,1,2,3,4,5,6,8,9,10,11,12,13,14,15,16,16,17,17,17,17,18,18,18,18,18,18,18,18
E01002313,EV motorcycles,Number,0,1,2,3,5,7,9,11,13,15,17,19,21,23,24,26,27,28,29,29,30,30,30,31,31,31,31,31,31,31
E01002314,EV motorcycles,Number,0,1,2,3,5,7,8,10,12,14,16,18,20,21,23,24,25,26,27,27,28,28,28,29,29,29,29,29,29,29
E01002315,EV motorcycles,Number,0,1,2,3,5,6,8,10,12,14,16,17,19,21,22,23,24,25,26,26,27,27,27,28,28,28,28,28,28,28
E01002316,EV motorcycles,Number,0,0,1,1,2,2,3,4,5,5,6,7,8,8,9,9,10,10,10,10,11,11,11,11,11,11,11,11,11,11
E01002317,EV motorcycles,Number,0,1,2,4,5,7,9,11,14,16,18,20,22,24,25,27,28,29,30,30,31,31,31,32,32,32,32,32,32,32
E01002318,EV motorcycles,Number,0,1,1,2,3,3,4,5,6,7,8,9,10,11,12,12,13,13,14,14,14,15,15,15,15,15,15,15,15,15
E01002319,EV motorcycles,Number,0,1,1,2,4,5,6,8,9,11,12,14,15,16,17,18,19,20,20,21,21,21,22,22,22,22,22,22,22,22
E01002320,EV motorcycles,Number,0,1,1,2,3,4,6,7,8,10,11,12,14,15,16,17,17,18,18,19,19,19,20,20,20,20,20,20,20,20
E01002321,EV motorcycles,Number,0,1,2,3,4,6,7,9,11,12,14,16,17,18,20,21,22,22,23,24,24,24,24,25,25,25,25,25,25,25
E01002322,EV motorcycles,Number,1,2,3,5,7,10,12,15,18,21,24,27,29,32,34,36,37,39,40,41,41,42,42,42,43,43,43,43,43,43
E01002323,EV motorcycles,Number,0,1,1,2,3,4,5,7,8,9,11,12,13,14,15,16,17,17,18,18,18,18,19,19,19,19,19,19,19,19
E01002324,EV motorcycles,Number,0,1,1,2,4,5,6,7,9,10,12,13,14,16,17,17,18,19,19,20,20,20,21,21,21,21,21,21,21,21
E01002325,EV motorcycles,Number,1,2,3,5,7,9,12,15,18,21,24,26,29,31,33,35,36,38,39,40,40,41,41,41,42,42,42,42,42,42
E01002326,EV motorcycles,Number,1,1,3,5,7,9,12,15,17,20,23,26,28,30,32,34,36,37,38,39,39,40,40,40,41,41,41,41,41,41
E01002327,EV motorcycles,Number,0,1,1,2,3,3,4,5,6,7,8,9,10,11,12,12,13,13,14,14,14,15,15,15,15,15,15,15,15,15
E01002328,EV motorcycles,Number,0,1,2,3,4,6,7,9,11,12,14,16,17,18,20,21,22,22,23,24,24,24,24,25,25,25,25,25,25,25
E01002329,EV motorcycles,Number,0,1,2,3,4,5,7,9,10,12,13,15,16,18,19,20,21,22,22,23,23,23,23,24,24,24,24,24,24,24
E01002330,EV motorcycles,Number,0,1,2,4,6,7,10,12,14,16,18,21,23,24,26,27,29,30,31,31,32,32,32,33,33,33,33,33,33,33
E01002331,EV motorcycles,Number,0,1,2,3,5,7,9,11,13,15,17,19,21,23,24,26,27,28,29,29,30,30,30,31,31,31,31,31,31,31
E01002332,EV motorcycles,Number,0,1,2,3,5,7,8,10,12,14,16,18,20,21,23,24,25,26,27,27,28,28,28,29,29,29,29,29,29,29
E01002333,EV motorcycles,Number,0,1,1,2,3,4,5,6,7,8,9,10,11,12,13,13,14,14,15,15,15,16,16,16,16,16,16,16,16,16
E01002334,EV motorcycles,Number,0,1,1,2,4,5,6,8,9,11,12,14,15,16,17,18,19,20,20,21,21,21,22,22,22,22,22,22,22,22
E01002335,EV motorcycles,Number,0,0,1,1,2,2,3,4,5,5,6,7,8,8,9,9,10,10,10,10,11,11,11,11,11,11,11,11,11,11
E01002336,EV motorcycles,Number,0,1,1,2,3,3,4,5,6,7,8,9,10,11,12,12,13,13,14,14,14,15,15,15,15,15,15,15,15,15
E01002337,EV motorcycles,Number,0,0,1,1,2,2,3,3,4,4,5,6,6,7,7,7,8,8,8,8,9,9,9,9,9,9,9,9,9,9
E01002338,EV motorcycles,Number,0,0,0,1,1,1,1,2,2,2,3,3,3,4,4,4,4,4,5,5,5,5,5,5,5,5,5,5,5,5
E01002339,EV motorcycles,Number,0,1,1,2,4,5,6,7,9,10,12,13,14,16,17,17,18,19,19,20,20,20,21,21,21,21,21,21,21,21
E01002340,EV motorcycles,Number,0,1,2,3,5,7,9,11,13,15,17,19,21,22,24,25,26,27,28,28,29,29,29,30,30,30,30,30,30,30
E01002341,EV motorcycles,Number,0,1,2,3,4,5,7,9,10,12,13,15,16,18,19,20,21,22,22,23,23,23,23,24,24,24,24,24,24,24
E01002342,EV motorcycles,Number,0,1,2,3,5,6,8,10,11,13,15,17,18,20,21,22,23,24,25,25,26,26,26,27,27,27,27,27,27,27
E01002343,EV motorcycles,Number,1,2,3,5,8,10,13,16,19,22,25,28,31,33,35,37,39,40,42,42,43,44,44,44,45,45,45,45,45,45
E01002344,EV motorcycles,Number,0,1,2,3,5,7,9,11,13,15,17,19,21,22,24,25,26,27,28,28,29,29,29,30,30,30,30,30,30,30
E01002345,EV motorcycles,Number,0,1,1,2,4,5,6,7,9,10,12,13,14,16,17,17,18,19,19,20,20,20,21,21,21,21,21,21,21,21
E01002346,EV motorcycles,Number,0,1,1,2,2,3,4,5,6,7,8,9,10,10,11,12,12,13,13,13,13,14,14,14,14,14,14,14,14,14
E01002347,EV motorcycles,Number,0,1,1,2,2,3,4,5,6,7,8,9,10,10,11,12,12,13,13,13,13,14,14,14,14,14,14,14,14,14
E01002348,EV motorcycles,Number,0,1,2,3,5,7,8,10,12,14,16,18,20,21,23,24,25,26,27,27,28,28,28,29,29,29,29,29,29,29
E01002349,EV motorcycles,Number,0,1,2,4,6,7,10,12,14,16,18,21,23,24,26,27,29,30,31,31,32,32,32,33,33,33,33,33,33,33
E01002350,EV motorcycles,Number,0,1,1,2,3,4,5,7,8,9,11,12,13,14,15,16,17,17,18,18,18,18,19,19,19,19,19,19,19,19
E01002351,EV motorcycles,Number,0,1,1,2,3,4,5,6,8,9,10,11,12,13,14,15,16,16,17,17,17,17,18,18,18,18,18,18,18,18
E01002352,EV motorcycles,Number,0,1,2,3,5,7,8,10,12,14,16,18,20,21,23,24,25,26,27,27,28,28,28,29,29,29,29,29,29,29
E01002353,EV motorcycles,Number,1,1,2,4,6,8,10,13,15,18,20,22,25,27,28,30,31,32,33,34,35,35,35,35,36,36,36,36,36,36
E01002354,EV motorcycles,Number,0,1,1,2,3,4,5,6,7,8,10,11,12,13,13,14,15,15,16,16,16,16,17,17,17,17,17,17,17,17
E01002355,EV motorcycles,Number,0,1,1,2,3,4,5,6,8,9,10,11,12,13,14,15,16,16,17,17,17,17,18,18,18,18,18,18,18,18
E01002356,EV motorcycles,Number,0,1,2,3,4,6,8,9,11,13,15,16,18,19,20,22,23,23,24,25,25,25,25,26,26,26,26,26,26,26
E01002358,EV motorcycles,Number,0,1,1,2,3,4,5,7,8,9,11,12,13,14,15,16,17,17,18,18,18,18,19,19,19,19,19,19,19,19
E01002359,EV motorcycles,Number,0,1,1,2,3,3,4,5,6,7,8,9,10,11,12,12,13,13,14,14,14,15,15,15,15,15,15,15,15,15
E01002360,EV motorcycles,Number,0,1,2,4,5,7,9,11,14,16,18,20,22,24,25,27,28,29,30,30,31,31,31,32,32,32,32,32,32,32
E01002361,EV motorcycles,Number,0,1,2,3,4,5,7,9,10,12,13,15,16,18,19,20,21,22,22,23,23,23,23,24,24,24,24,24,24,24
E01002362,EV motorcycles,Number,0,1,2,3,4,5,7,8,10,11,13,14,16,17,18,19,20,21,21,22,22,22,23,23,23,23,23,23,23,23
E01002363,EV motorcycles,Number,0,1,1,2,3,4,5,7,8,9,11,12,13,14,15,16,17,17,18,18,18,18,19,19,19,19,19,19,19,19
E01002364,EV motorcycles,Number,0,1,2,4,6,8,10,12,14,17,19,21,23,25,27,28,30,31,31,32,33,33,33,33,34,34,34,34,34,34
E01002365,EV motorcycles,Number,0,1,1,2,3,4,5,6,7,8,10,11,12,13,13,14,15,15,16,16,16,16,17,17,17,17,17,17,17,17
E01002366,EV motorcycles,Number,0,1,1,2,4,5,6,8,9,11,12,14,15,16,17,18,19,20,20,21,21,21,22,22,22,22,22,22,22,22
E01002367,EV motorcycles,Number,0,1,1,2,4,5,6,7,9,10,12,13,14,16,17,17,18,19,19,20,20,20,21,21,21,21,21,21,21,21
E01002368,EV motorcycles,Number,0,1,2,4,5,7,9,11,14,16,18,20,22,24,25,27,28,29,30,30,31,31,31,32,32,32,32,32,32,32
E01002369,EV motorcycles,Number,0,1,2,3,4,5,7,9,10,12,13,15,16,18,19,20,21,22,22,23,23,23,23,24,24,24,24,24,24,24
E01002370,EV motorcycles,Number,1,1,2,4,6,9,11,13,16,19,21,24,26,28,30,32,33,34,35,36,36,37,37,37,38,38,38,38,38,38
E01002371,EV motorcycles,Number,0,1,1,2,3,4,5,7,8,9,11,12,13,14,15,16,17,17,18,18,18,18,19,19,19,19,19,19,19,19
E01002372,EV motorcycles,Number,0,1,2,3,4,5,7,9,10,12,13,15,16,18,19,20,21,22,22,23,23,23,23,24,24,24,24,24,24,24
E01002373,EV motorcycles,Number,0,1,1,2,3,4,5,6,7,8,10,11,12,13,13,14,15,15,16,16,16,16,17,17,17,17,17,17,17,17
E01002374,EV motorcycles,Number,0,1,2,3,4,5,7,9,10,12,13,15,16,18,19,20,21,22,22,23,23,23,23,24,24,24,24,24,24,24
E01002375,EV motorcycles,Number,0,1,2,4,5,7,9,11,14,16,18,20,22,24,25,27,28,29,30,30,31,31,31,32,32,32,32,32,32,32
E01002376,EV motorcycles,Number,0,1,1,2,3,4,5,6,8,9,10,11,12,13,14,15,16,16,17,17,17,17,18,18,18,18,18,18,18,18
E01002377,EV motorcycles,Number,0,0,1,1,2,2,3,4,4,5,6,6,7,7,8,8,9,9,9,9,10,10,10,10,10,10,10,10,10,10
E01002378,EV motorcycles,Number,0,1,2,3,4,6,7,9,11,12,14,16,17,18,20,21,22,22,23,24,24,24,24,25,25,25,25,25,25,25
E01002379,EV motorcycles,Number,0,1,1,2,3,3,4,5,6,7,8,9,10,11,12,12,13,13,14,14,14,15,15,15,15,15,15,15,15,15
E01002380,EV motorcycles,Number,0,1,2,3,5,7,8,10,12,14,16,18,20,21,23,24,25,26,27,27,28,28,28,29,29,29,29,29,29,29
E01002381,EV motorcycles,Number,0,0,1,1,2,3,4,5,5,6,7,8,9,10,10,11,11,12,12,12,12,13,13,13,13,13,13,13,13,13
E01002382,EV motorcycles,Number,0,1,2,3,5,7,8,10,12,14,16,18,20,21,23,24,25,26,27,27,28,28,28,29,29,29,29,29,29,29
E01002383,EV motorcycles,Number,0,0,0,1,1,1,2,2,3,3,3,4,4,4,5,5,5,5,6,6,6,6,6,6,6,6,6,6,6,6
E01002384,EV motorcycles,Number,0,1,1,2,3,3,4,5,6,7,8,9,10,11,12,12,13,13,14,14,14,15,15,15,15,15,15,15,15,15
E01002385,EV motorcycles,Number,0,1,2,3,4,5,7,8,10,11,13,14,16,17,18,19,20,21,21,22,22,22,23,23,23,23,23,23,23,23
E01002386,EV motorcycles,Number,0,1,1,2,4,5,6,8,9,11,12,14,15,16,17,18,19,20,20,21,21,21,22,22,22,22,22,22,22,22
E01002387,EV motorcycles,Number,0,1,1,2,3,4,6,7,8,10,11,12,14,15,16,17,17,18,18,19,19,19,20,20,20,20,20,20,20,20
E01002388,EV motorcycles,Number,0,1,2,3,5,7,8,10,12,14,16,18,20,21,23,24,25,26,27,27,28,28,28,29,29,29,29,29,29,29
E01002389,EV motorcycles,Number,0,1,1,2,3,4,5,7,8,9,11,12,13,14,15,16,17,17,18,18,18,18,19,19,19,19,19,19,19,19
E01002390,EV motorcycles,Number,0,0,1,1,2,2,3,4,4,5,6,6,7,7,8,8,9,9,9,9,10,10,10,10,10,10,10,10,10,10
E01002391,EV motorcycles,Number,1,1,3,4,7,9,11,14,16,19,22,24,27,29,31,32,34,35,36,37,37,38,38,38,39,39,39,39,39,39
E01002415,EV motorcycles,Number,0,1,1,2,4,5,6,7,9,10,12,13,14,16,17,17,18,19,19,20,20,20,21,21,21,21,21,21,21,21
E01002416,EV motorcycles,Number,0,1,2,3,5,6,8,10,12,14,16,17,19,21,22,23,24,25,26,26,27,27,27,28,28,28,28,28,28,28
E01002417,EV motorcycles,Number,0,1,2,3,5,7,9,11,13,15,17,19,21,22,24,25,26,27,28,28,29,29,29,30,30,30,30,30,30,30
E01002418,EV motorcycles,Number,0,1,2,3,5,7,8,10,12,14,16,18,20,21,23,24,25,26,27,27,28,28,28,29,29,29,29,29,29,29
E01002419,EV motorcycles,Number,0,1,2,3,5,7,8,10,12,14,16,18,20,21,23,24,25,26,27,27,28,28,28,29,29,29,29,29,29,29
E01002420,EV motorcycles,Number,0,1,2,3,5,6,8,10,11,13,15,17,18,20,21,22,23,24,25,25,26,26,26,27,27,27,27,27,27,27
E01002421,EV motorcycles,Number,0,1,2,3,5,7,9,11,13,15,17,19,21,22,24,25,26,27,28,28,29,29,29,30,30,30,30,30,30,30
E01002430,EV motorcycles,Number,0,1,2,3,4,5,7,9,10,12,13,15,16,18,19,20,21,22,22,23,23,23,23,24,24,24,24,24,24,24
E01002431,EV motorcycles,Number,0,0,0,1,1,2,2,2,3,3,4,4,5,5,6,6,6,6,6,7,7,7,7,7,7,7,7,7,7,7
E01002432,EV motorcycles,Number,0,1,1,2,4,5,6,7,9,10,12,13,14,16,17,17,18,19,19,20,20,20,21,21,21,21,21,21,21,21
E01002433,EV motorcycles,Number,0,1,1,2,3,4,6,7,8,10,11,12,14,15,16,17,17,18,18,19,19,19,20,20,20,20,20,20,20,20
E01002434,EV motorcycles,Number,0,1,1,2,4,5,6,7,9,10,12,13,14,16,17,17,18,19,19,20,20,20,21,21,21,21,21,21,21,21
E01002435,EV motorcycles,Number,0,1,2,3,4,6,7,9,11,12,14,16,17,18,20,21,22,22,23,24,24,24,24,25,25,25,25,25,25,25
E01002436,EV motorcycles,Number,0,1,1,2,3,4,5,6,8,9,10,11,12,13,14,15,16,16,17,17,17,17,18,18,18,18,18,18,18,18
E01002437,EV motorcycles,Number,0,0,1,1,2,2,3,4,5,5,6,7,8,8,9,9,10,10,10,10,11,11,11,11,11,11,11,11,11,11
E01002438,EV motorcycles,Number,0,0,0,0,0,1,1,1,1,1,1,2,2,2,2,2,2,2,2,2,2,2,2,2,2,2,2,2,2,2
E01002441,EV motorcycles,Number,0,0,0,0,0,0,0,0,0,0,0,0,0,0,1,1,1,1,1,1,1,1,1,1,1,1,1,1,1,1
E01002465,EV motorcycles,Number,0,1,1,2,3,3,4,5,6,7,8,9,10,11,12,12,13,13,14,14,14,15,15,15,15,15,15,15,15,15
E01002466,EV motorcycles,Number,0,1,2,4,6,7,10,12,14,16,18,21,23,24,26,27,29,30,31,31,32,32,32,33,33,33,33,33,33,33
E01002467,EV motorcycles,Number,0,1,1,2,3,4,6,7,8,10,11,12,14,15,16,17,17,18,18,19,19,19,20,20,20,20,20,20,20,20
E01002468,EV motorcycles,Number,0,1,1,2,3,4,5,6,7,8,9,10,11,12,13,13,14,14,15,15,15,16,16,16,16,16,16,16,16,16
E01002469,EV motorcycles,Number,1,2,3,6,9,12,15,18,22,26,29,32,36,38,41,43,45,47,48,49,50,50,51,51,51,52,52,52,52,52
E01002470,EV motorcycles,Number,1,2,3,6,9,12,15,19,22,26,30,33,36,39,42,44,46,48,49,50,51,51,52,52,52,53,53,53,53,53
E01002471,EV motorcycles,Number,0,1,2,3,4,6,8,9,11,13,15,16,18,19,20,22,23,23,24,25,25,25,25,26,26,26,26,26,26,26
E01002472,EV motorcycles,Number,0,1,1,2,4,5,6,8,9,11,12,14,15,16,17,18,19,20,20,21,21,21,22,22,22,22,22,22,22,22
E01002473,EV motorcycles,Number,0,0,1,1,2,3,3,4,5,6,7,7,8,9,9,10,10,11,11,11,11,12,12,12,12,12,12,12,12,12
E01002474,EV motorcycles,Number,0,0,1,1,2,3,4,5,5,6,7,8,9,10,10,11,11,12,12,12,12,13,13,13,13,13,13,13,13,13
E01002475,EV motorcycles,Number,0,1,1,2,3,4,5,7,8,9,11,12,13,14,15,16,17,17,18,18,18,18,19,19,19,19,19,19,19,19
E01002476,EV motorcycles,Number,0,0,1,1,2,2,3,4,4,5,6,6,7,7,8,8,9,9,9,9,10,10,10,10,10,10,10,10,10,10
E01002477,EV motorcycles,Number,0,0,0,1,1,1,1,2,2,2,3,3,3,4,4,4,4,4,5,5,5,5,5,5,5,5,5,5,5,5
E01002478,EV motorcycles,Number,0,1,1,2,3,3,4,5,6,7,8,9,10,11,12,12,13,13,14,14,14,15,15,15,15,15,15,15,15,15
E01002479,EV motorcycles,Number,0,1,1,2,3,4,6,7,8,10,11,12,14,15,16,17,17,18,18,19,19,19,20,20,20,20,20,20,20,20
E01002480,EV motorcycles,Number,0,1,2,3,5,6,8,10,12,14,16,17,19,21,22,23,24,25,26,26,27,27,27,28,28,28,28,28,28,28
E01002481,EV motorcycles,Number,0,1,1,2,4,5,6,8,9,11,12,14,15,16,17,18,19,20,20,21,21,21,22,22,22,22,22,22,22,22
E01002482,EV motorcycles,Number,0,0,0,1,1,2,2,2,3,3,4,4,5,5,6,6,6,6,6,7,7,7,7,7,7,7,7,7,7,7
E01002483,EV motorcycles,Number,0,1,1,2,3,4,5,6,7,8,10,11,12,13,13,14,15,15,16,16,16,16,17,17,17,17,17,17,17,17
E01002484,EV motorcycles,Number,0,1,2,3,4,6,7,9,11,12,14,16,17,18,20,21,22,22,23,24,24,24,24,25,25,25,25,25,25,25
E01002485,EV motorcycles,Number,0,1,2,4,6,8,10,12,14,17,19,21,23,25,27,28,30,31,31,32,33,33,33,33,34,34,34,34,34,34
E01002494,EV motorcycles,Number,0,1,2,3,5,7,9,11,13,15,17,19,21,22,24,25,26,27,28,28,29,29,29,30,30,30,30,30,30,30
E01002495,EV motorcycles,Number,0,1,1,2,4,5,6,7,9,10,12,13,14,16,17,17,18,19,19,20,20,20,21,21,21,21,21,21,21,21
E01002496,EV motorcycles,Number,0,1,1,2,3,4,5,6,8,9,10,11,12,13,14,15,16,16,17,17,17,17,18,18,18,18,18,18,18,18
E01002497,EV motorcycles,Number,1,2,4,6,9,12,16,19,23,27,30,34,37,40,43,45,47,49,50,51,52,52,53,53,53,54,54,54,54,54
E01002498,EV motorcycles,Number,0,1,2,3,4,6,7,9,11,12,14,16,17,18,20,21,22,22,23,24,24,24,24,25,25,25,25,25,25,25
E01002499,EV motorcycles,Number,0,1,1,3,4,5,7,8,10,11,13,14,16,17,18,19,20,21,21,22,22,22,22,23,23,23,23,23,23,23
E01002533,EV motorcycles,Number,0,1,2,3,4,6,7,9,11,13,14,16,18,19,20,21,22,23,24,24,25,25,25,25,26,26,26,26,26,26
E01002534,EV motorcycles,Number,0,1,1,2,4,5,6,7,9,10,12,13,14,16,17,17,18,19,19,20,20,20,21,21,21,21,21,21,21,21
E01002535,EV motorcycles,Number,1,1,2,4,6,8,10,12,15,17,20,22,24,26,28,29,30,31,32,33,34,34,34,34,35,35,35,35,35,35
E01002536,EV motorcycles,Number,0,0,1,1,2,3,4,4,5,6,7,8,9,9,10,11,11,11,12,12,12,12,12,12,13,13,13,13,13,13
E01002537,EV motorcycles,Number,0,0,0,0,0,0,0,0,0,0,0,0,0,0,0,0,0,0,0,0,0,0,0,0,0,0,0,0,0,0
E01002538,EV motorcycles,Number,1,1,3,4,7,9,11,14,16,19,22,24,27,29,31,32,34,35,36,37,37,38,38,38,39,39,39,39,39,39
E01002539,EV motorcycles,Number,0,1,1,2,3,4,5,6,8,9,10,11,12,13,14,15,16,16,17,17,17,17,18,18,18,18,18,18,18,18
E01002573,EV motorcycles,Number,0,0,0,0,0,0,0,0,0,0,0,0,0,0,0,0,0,0,0,0,0,0,0,0,0,0,0,0,0,0
E01002574,EV motorcycles,Number,0,1,2,3,4,5,7,8,10,11,13,14,16,17,18,19,20,21,21,22,22,22,23,23,23,23,23,23,23,23
E01002575,EV motorcycles,Number,0,0,0,0,0,0,0,0,0,0,0,0,0,0,0,0,0,0,0,0,0,0,0,0,0,0,0,0,0,0
E01002672,EV motorcycles,Number,0,0,0,0,0,0,0,0,0,0,0,0,0,0,0,0,0,0,0,0,0,0,0,0,0,0,0,0,0,0
E01002694,EV motorcycles,Number,0,1,1,2,3,4,5,6,7,8,9,10,11,12,13,13,14,14,15,15,15,16,16,16,16,16,16,16,16,16
E01002695,EV motorcycles,Number,0,1,1,2,3,4,6,7,8,10,11,12,14,15,16,17,17,18,18,19,19,19,20,20,20,20,20,20,20,20
E01002696,EV motorcycles,Number,0,1,1,2,4,5,6,7,9,10,12,13,14,16,17,17,18,19,19,20,20,20,21,21,21,21,21,21,21,21
E01002697,EV motorcycles,Number,0,1,1,2,3,4,5,7,8,9,11,12,13,14,15,16,17,17,18,18,18,18,19,19,19,19,19,19,19,19
E01002698,EV motorcycles,Number,0,1,2,3,5,6,8,10,12,14,16,17,19,21,22,23,24,25,26,26,27,27,27,28,28,28,28,28,28,28
E01002699,EV motorcycles,Number,0,0,1,1,2,3,4,5,5,6,7,8,9,10,10,11,11,12,12,12,12,13,13,13,13,13,13,13,13,13
E01002700,EV motorcycles,Number,0,0,1,1,2,2,3,4,5,5,6,7,8,8,9,9,10,10,10,10,11,11,11,11,11,11,11,11,11,11
E01002701,EV motorcycles,Number,0,1,2,3,4,6,8,9,11,13,15,16,18,19,20,22,23,23,24,25,25,25,25,26,26,26,26,26,26,26
E01002702,EV motorcycles,Number,0,0,1,1,2,3,4,5,5,6,7,8,9,10,10,11,11,12,12,12,12,13,13,13,13,13,13,13,13,13
E01002703,EV motorcycles,Number,0,0,1,1,2,3,3,4,5,6,7,7,8,9,9,10,10,11,11,11,12,12,12,12,12,12,12,12,12,12
E01002704,EV motorcycles,Number,0,1,2,3,5,6,8,10,11,13,15,17,18,20,21,22,23,24,25,25,26,26,26,27,27,27,27,27,27,27
E01002706,EV motorcycles,Number,1,1,2,4,6,8,10,12,15,17,20,22,24,26,28,29,30,31,32,33,34,34,34,34,35,35,35,35,35,35
E01002707,EV motorcycles,Number,0,1,1,2,2,3,4,5,6,7,8,9,10,10,11,12,12,13,13,13,13,14,14,14,14,14,14,14,14,14
E01002708,EV motorcycles,Number,0,1,2,3,4,6,8,9,11,13,15,16,18,19,20,22,23,23,24,25,25,25,25,26,26,26,26,26,26,26
E01002709,EV motorcycles,Number,0,1,1,2,2,3,4,5,6,7,8,9,10,10,11,12,12,13,13,13,13,14,14,14,14,14,14,14,14,14
E01002710,EV motorcycles,Number,0,1,2,4,6,8,10,12,14,17,19,21,23,25,27,28,30,31,31,32,33,33,33,33,34,34,34,34,34,34
E01002711,EV motorcycles,Number,0,1,2,3,5,6,8,10,11,13,15,17,18,20,21,22,23,24,25,25,26,26,26,27,27,27,27,27,27,27
E01002712,EV motorcycles,Number,0,1,2,3,4,5,7,8,10,11,13,14,16,17,18,19,20,21,21,22,22,22,23,23,23,23,23,23,23,23
E01002713,EV motorcycles,Number,0,1,2,3,5,7,9,11,13,15,17,19,21,22,24,25,26,27,28,28,29,29,29,30,30,30,30,30,30,30
E01002714,EV motorcycles,Number,0,1,1,2,3,4,5,6,7,8,10,11,12,13,13,14,15,15,16,16,16,16,17,17,17,17,17,17,17,17
E01002715,EV motorcycles,Number,0,1,1,2,3,3,4,5,6,7,8,9,10,11,12,12,13,13,14,14,14,15,15,15,15,15,15,15,15,15
E01002716,EV motorcycles,Number,0,1,1,2,2,3,4,5,6,7,8,9,10,10,11,12,12,13,13,13,13,14,14,14,14,14,14,14,14,14
E01002717,EV motorcycles,Number,0,0,1,1,2,2,3,4,4,5,6,6,7,7,8,8,9,9,9,9,10,10,10,10,10,10,10,10,10,10
E01002718,EV motorcycles,Number,0,1,1,2,3,4,5,6,8,9,10,11,12,13,14,15,16,16,17,17,17,17,18,18,18,18,18,18,18,18
E01002719,EV motorcycles,Number,0,0,1,1,2,3,3,4,5,6,7,7,8,9,9,10,10,11,11,11,12,12,12,12,12,12,12,12,12,12
E01002720,EV motorcycles,Number,0,1,2,3,5,7,9,11,13,15,17,19,21,22,24,25,26,27,28,28,29,29,29,30,30,30,30,30,30,30
E01002721,EV motorcycles,Number,0,1,1,2,3,4,5,6,7,8,9,10,11,12,13,13,14,14,15,15,15,16,16,16,16,16,16,16,16,16
E01002722,EV motorcycles,Number,0,0,0,1,1,2,2,2,3,3,4,4,5,5,6,6,6,6,6,7,7,7,7,7,7,7,7,7,7,7
E01002723,EV motorcycles,Number,0,1,1,2,3,4,5,6,8,9,10,11,12,13,14,15,16,16,17,17,17,17,18,18,18,18,18,18,18,18
E01002724,EV motorcycles,Number,0,1,2,3,5,7,9,11,13,15,17,19,21,22,24,25,26,27,28,28,29,29,29,30,30,30,30,30,30,30
E01002725,EV motorcycles,Number,0,0,1,1,2,2,3,3,4,4,5,6,6,7,7,7,8,8,8,8,9,9,9,9,9,9,9,9,9,9
E01002726,EV motorcycles,Number,0,1,2,3,5,7,9,11,13,15,17,19,21,22,24,25,26,27,28,28,29,29,29,30,30,30,30,30,30,30
E01002727,EV motorcycles,Number,0,1,1,2,2,3,4,5,6,7,8,9,10,10,11,12,12,13,13,13,13,14,14,14,14,14,14,14,14,14
E01002728,EV motorcycles,Number,0,0,1,1,2,3,3,4,5,6,7,7,8,9,9,10,10,11,11,11,12,12,12,12,12,12,12,12,12,12
E01002729,EV motorcycles,Number,0,1,2,3,5,6,8,10,11,13,15,17,18,20,21,22,23,24,25,25,26,26,26,27,27,27,27,27,27,27
E01002730,EV motorcycles,Number,1,2,3,5,7,9,12,15,18,21,24,26,29,31,33,35,36,38,39,40,40,41,41,41,42,42,42,42,42,42
E01002731,EV motorcycles,Number,1,2,3,5,7,10,13,16,19,22,25,27,30,33,35,37,38,40,41,42,42,43,43,43,44,44,44,44,44,44
E01002732,EV motorcycles,Number,0,0,1,1,1,2,2,3,3,4,4,5,5,6,6,7,7,7,7,8,8,8,8,8,8,8,8,8,8,8
E01002733,EV motorcycles,Number,0,0,1,1,2,3,4,5,5,6,7,8,9,10,10,11,11,12,12,12,12,13,13,13,13,13,13,13,13,13
E01002734,EV motorcycles,Number,0,1,1,2,4,5,6,7,9,10,12,13,14,16,17,17,18,19,19,20,20,20,21,21,21,21,21,21,21,21
E01002735,EV motorcycles,Number,0,1,2,3,5,6,8,10,11,13,15,17,18,20,21,22,23,24,25,25,26,26,26,27,27,27,27,27,27,27
E01002736,EV motorcycles,Number,0,1,1,2,3,4,5,6,7,8,9,10,11,12,13,13,14,14,15,15,15,16,16,16,16,16,16,16,16,16
E01002737,EV motorcycles,Number,0,1,1,2,2,3,4,5,6,7,8,9,10,10,11,12,12,13,13,13,13,14,14,14,14,14,14,14,14,14
E01002738,EV motorcycles,Number,0,1,1,2,3,4,5,7,8,9,11,12,13,14,15,16,17,17,18,18,18,18,19,19,19,19,19,19,19,19
E01002739,EV motorcycles,Number,0,1,1,2,3,4,5,6,8,9,10,11,12,13,14,15,16,16,17,17,17,17,18,18,18,18,18,18,18,18
E01002740,EV motorcycles,Number,0,1,2,3,5,6,8,10,11,13,15,17,18,20,21,22,23,24,25,25,26,26,26,27,27,27,27,27,27,27
E01002741,EV motorcycles,Number,0,0,1,1,2,2,3,3,4,4,5,6,6,7,7,7,8,8,8,8,9,9,9,9,9,9,9,9,9,9
E01002742,EV motorcycles,Number,0,1,1,2,4,5,6,8,9,11,12,14,15,16,17,18,19,20,20,21,21,21,22,22,22,22,22,22,22,22
E01002743,EV motorcycles,Number,0,1,1,2,3,4,5,6,7,8,9,10,11,12,13,13,14,14,15,15,15,16,16,16,16,16,16,16,16,16
E01002744,EV motorcycles,Number,0,1,1,2,3,4,5,6,7,8,10,11,12,13,13,14,15,15,16,16,16,16,17,17,17,17,17,17,17,17
E01002745,EV motorcycles,Number,0,1,2,3,4,5,7,8,10,11,13,14,16,17,18,19,20,21,21,22,22,22,23,23,23,23,23,23,23,23
E01002747,EV motorcycles,Number,0,1,1,2,3,4,5,7,8,9,11,12,13,14,15,16,17,17,18,18,18,18,19,19,19,19,19,19,19,19
E01002748,EV motorcycles,Number,0,1,1,2,2,3,4,5,6,7,8,9,10,10,11,12,12,13,13,13,13,14,14,14,14,14,14,14,14,14
E01002749,EV motorcycles,Number,0,1,1,2,4,5,6,7,9,10,12,13,14,16,17,17,18,19,19,20,20,20,21,21,21,21,21,21,21,21
E01002751,EV motorcycles,Number,0,1,2,3,4,6,8,9,11,13,15,16,18,19,20,22,23,23,24,25,25,25,25,26,26,26,26,26,26,26
E01002752,EV motorcycles,Number,0,1,1,2,2,3,4,5,6,7,8,9,10,10,11,12,12,13,13,13,13,14,14,14,14,14,14,14,14,14
E01002753,EV motorcycles,Number,0,1,1,2,4,5,6,7,9,10,12,13,14,16,17,17,18,19,19,20,20,20,21,21,21,21,21,21,21,21
E01002754,EV motorcycles,Number,0,1,1,2,3,4,5,6,7,8,9,10,11,12,13,13,14,14,15,15,15,16,16,16,16,16,16,16,16,16
E01002755,EV motorcycles,Number,0,1,1,2,3,4,5,6,7,8,9,10,11,12,13,13,14,14,15,15,15,16,16,16,16,16,16,16,16,16
E01002756,EV motorcycles,Number,0,1,1,2,2,3,4,5,6,7,8,9,10,10,11,12,12,13,13,13,13,14,14,14,14,14,14,14,14,14
E01002757,EV motorcycles,Number,0,1,1,2,3,4,5,7,8,9,11,12,13,14,15,16,17,17,18,18,18,18,19,19,19,19,19,19,19,19
E01002758,EV motorcycles,Number,0,1,2,3,4,5,7,9,10,12,13,15,16,18,19,20,21,22,22,23,23,23,23,24,24,24,24,24,24,24
E01002759,EV motorcycles,Number,0,0,1,1,2,3,3,4,5,6,7,7,8,9,9,10,10,11,11,11,12,12,12,12,12,12,12,12,12,12
E01002760,EV motorcycles,Number,0,1,1,2,4,5,6,8,9,11,12,14,15,16,17,18,19,20,20,21,21,21,22,22,22,22,22,22,22,22
E01002762,EV motorcycles,Number,0,1,2,3,4,5,7,9,10,12,13,15,16,18,19,20,21,22,22,23,23,23,23,24,24,24,24,24,24,24
E01002763,EV motorcycles,Number,0,1,1,2,3,4,5,6,7,8,9,10,11,12,13,13,14,14,15,15,15,16,16,16,16,16,16,16,16,16
E01002764,EV motorcycles,Number,0,1,1,2,4,5,6,8,9,11,12,14,15,16,17,18,19,20,20,21,21,21,22,22,22,22,22,22,22,22
E01002765,EV motorcycles,Number,0,1,2,3,4,5,7,8,10,11,13,14,16,17,18,19,20,21,21,22,22,22,23,23,23,23,23,23,23,23
E01002766,EV motorcycles,Number,0,1,2,4,5,7,9,11,14,16,18,20,22,24,25,27,28,29,30,30,31,31,31,32,32,32,32,32,32,32
E01002767,EV motorcycles,Number,0,1,1,2,3,4,5,7,8,9,11,12,13,14,15,16,17,17,18,18,18,18,19,19,19,19,19,19,19,19
E01002768,EV motorcycles,Number,0,1,1,2,4,5,6,7,9,10,12,13,14,16,17,17,18,19,19,20,20,20,21,21,21,21,21,21,21,21
E01002769,EV motorcycles,Number,0,0,1,1,1,2,2,3,3,4,4,5,5,6,6,7,7,7,7,8,8,8,8,8,8,8,8,8,8,8
E01002770,EV motorcycles,Number,0,1,2,3,5,7,9,11,13,15,17,19,21,23,24,26,27,28,29,29,30,30,30,31,31,31,31,31,31,31
E01002771,EV motorcycles,Number,0,1,1,2,3,4,5,6,7,8,10,11,12,13,13,14,15,15,16,16,16,16,17,17,17,17,17,17,17,17
E01002772,EV motorcycles,Number,0,1,2,3,4,6,7,9,11,12,14,16,17,18,20,21,22,22,23,24,24,24,24,25,25,25,25,25,25,25
E01002773,EV motorcycles,Number,0,1,1,2,3,4,5,6,7,8,9,10,11,12,13,13,14,14,15,15,15,16,16,16,16,16,16,16,16,16
E01002774,EV motorcycles,Number,0,1,2,3,4,5,7,8,10,11,13,14,16,17,18,19,20,21,21,22,22,22,23,23,23,23,23,23,23,23
E01002775,EV motorcycles,Number,0,1,1,2,3,4,5,6,7,8,9,10,11,12,13,13,14,14,15,15,15,16,16,16,16,16,16,16,16,16
E01002776,EV motorcycles,Number,0,1,1,2,3,3,4,5,6,7,8,9,10,11,12,12,13,13,14,14,14,15,15,15,15,15,15,15,15,15
E01002777,EV motorcycles,Number,0,1,1,2,3,3,4,5,6,7,8,9,10,11,12,12,13,13,14,14,14,15,15,15,15,15,15,15,15,15
E01002778,EV motorcycles,Number,0,1,2,3,4,6,7,9,11,12,14,16,17,18,20,21,22,22,23,24,24,24,24,25,25,25,25,25,25,25
E01002779,EV motorcycles,Number,0,1,1,2,3,4,5,7,8,9,11,12,13,14,15,16,17,17,18,18,18,18,19,19,19,19,19,19,19,19
E01002780,EV motorcycles,Number,0,1,1,2,3,4,5,6,8,9,10,11,12,13,14,15,16,16,17,17,17,17,18,18,18,18,18,18,18,18
E01002781,EV motorcycles,Number,0,0,1,1,2,3,4,5,5,6,7,8,9,10,10,11,11,12,12,12,12,13,13,13,13,13,13,13,13,13
E01002782,EV motorcycles,Number,0,0,1,1,2,3,4,5,5,6,7,8,9,10,10,11,11,12,12,12,12,13,13,13,13,13,13,13,13,13
E01002783,EV motorcycles,Number,0,1,1,2,3,4,5,7,8,9,11,12,13,14,15,16,17,17,18,18,18,18,19,19,19,19,19,19,19,19
E01002784,EV motorcycles,Number,0,1,1,2,3,4,5,6,8,9,10,11,12,13,14,15,16,16,17,17,17,17,18,18,18,18,18,18,18,18
E01002785,EV motorcycles,Number,0,1,1,2,3,3,4,5,6,7,8,9,10,11,12,12,13,13,14,14,14,15,15,15,15,15,15,15,15,15
E01002786,EV motorcycles,Number,0,1,1,2,3,4,5,6,8,9,10,11,12,13,14,15,16,16,17,17,17,17,18,18,18,18,18,18,18,18
E01002787,EV motorcycles,Number,1,1,3,5,7,9,12,15,17,20,23,26,28,30,32,34,36,37,38,39,39,40,40,40,41,41,41,41,41,41
E01002788,EV motorcycles,Number,0,1,2,3,4,6,7,9,11,12,14,16,17,18,20,21,22,22,23,24,24,24,24,25,25,25,25,25,25,25
E01002789,EV motorcycles,Number,0,1,1,2,3,3,4,5,6,7,8,9,10,11,12,12,13,13,14,14,14,15,15,15,15,15,15,15,15,15
E01002790,EV motorcycles,Number,0,0,1,1,2,2,3,4,5,5,6,7,8,8,9,9,10,10,10,10,11,11,11,11,11,11,11,11,11,11
E01002791,EV motorcycles,Number,0,0,1,1,2,2,3,3,4,4,5,6,6,7,7,7,8,8,8,8,9,9,9,9,9,9,9,9,9,9
E01002792,EV motorcycles,Number,0,1,2,3,5,6,8,10,12,14,16,17,19,21,22,23,24,25,26,26,27,27,27,28,28,28,28,28,28,28
E01002793,EV motorcycles,Number,0,0,1,1,2,2,3,4,5,5,6,7,8,8,9,9,10,10,10,10,11,11,11,11,11,11,11,11,11,11
E01002794,EV motorcycles,Number,0,1,1,2,3,4,5,7,8,9,11,12,13,14,15,16,17,17,18,18,18,18,19,19,19,19,19,19,19,19
E01002795,EV motorcycles,Number,0,1,1,2,3,4,6,7,8,10,11,12,14,15,16,17,17,18,18,19,19,19,20,20,20,20,20,20,20,20
E01002796,EV motorcycles,Number,0,0,1,1,2,2,3,4,4,5,6,6,7,7,8,8,9,9,9,9,10,10,10,10,10,10,10,10,10,10
E01002797,EV motorcycles,Number,0,1,2,3,4,6,8,9,11,13,15,16,18,19,20,22,23,23,24,25,25,25,25,26,26,26,26,26,26,26
E01002798,EV motorcycles,Number,1,1,2,4,6,8,11,13,16,18,21,23,25,27,29,31,32,33,34,35,35,36,36,36,37,37,37,37,37,37
E01002799,EV motorcycles,Number,0,1,1,2,3,3,4,5,6,7,8,9,10,11,12,12,13,13,14,14,14,15,15,15,15,15,15,15,15,15
E01002800,EV motorcycles,Number,0,1,1,2,3,4,5,6,7,8,10,11,12,13,13,14,15,15,16,16,16,16,17,17,17,17,17,17,17,17
E01002801,EV motorcycles,Number,0,0,0,1,1,2,2,2,3,3,4,4,5,5,6,6,6,6,6,7,7,7,7,7,7,7,7,7,7,7
E01002802,EV motorcycles,Number,0,1,1,2,4,5,6,7,9,10,12,13,14,16,17,17,18,19,19,20,20,20,21,21,21,21,21,21,21,21
E01002803,EV motorcycles,Number,0,1,2,3,4,6,8,9,11,13,15,16,18,19,20,22,23,23,24,25,25,25,25,26,26,26,26,26,26,26
E01002804,EV motorcycles,Number,0,1,2,3,5,6,8,10,12,14,16,17,19,21,22,23,24,25,26,26,27,27,27,28,28,28,28,28,28,28
E01002805,EV motorcycles,Number,0,1,1,2,4,5,6,7,9,10,12,13,14,16,17,17,18,19,19,20,20,20,21,21,21,21,21,21,21,21
E01002806,EV motorcycles,Number,0,0,1,1,2,3,4,5,5,6,7,8,9,10,10,11,11,12,12,12,12,13,13,13,13,13,13,13,13,13
E01002807,EV motorcycles,Number,1,1,2,4,6,8,10,12,15,17,20,22,24,26,28,29,30,31,32,33,34,34,34,34,35,35,35,35,35,35
E01002808,EV motorcycles,Number,0,1,2,3,5,7,9,11,13,15,17,19,21,22,24,25,26,27,28,28,29,29,29,30,30,30,30,30,30,30
E01002809,EV motorcycles,Number,0,1,2,3,4,5,7,8,10,11,13,14,16,17,18,19,20,21,21,22,22,22,23,23,23,23,23,23,23,23
E01002810,EV motorcycles,Number,2,5,9,15,23,31,40,49,58,67,77,85,94,101,108,114,119,123,127,129,131,133,134,135,136,136,137,137,137,137
E01002811,EV motorcycles,Number,0,1,1,2,3,3,4,5,6,7,8,9,10,11,12,12,13,13,14,14,14,15,15,15,15,15,15,15,15,15
E01002812,EV motorcycles,Number,0,1,1,2,4,5,6,8,9,11,12,14,15,16,17,18,19,20,20,21,21,21,22,22,22,22,22,22,22,22
E01002813,EV motorcycles,Number,0,1,1,2,3,3,4,5,6,7,8,9,10,11,12,12,13,13,14,14,14,15,15,15,15,15,15,15,15,15
E01002814,EV motorcycles,Number,0,1,2,3,5,6,8,10,12,14,16,17,19,21,22,23,24,25,26,26,27,27,27,28,28,28,28,28,28,28
E01002815,EV motorcycles,Number,0,0,1,1,2,3,3,4,5,6,7,7,8,9,9,10,10,11,11,11,12,12,12,12,12,12,12,12,12,12
E01002816,EV motorcycles,Number,0,1,1,2,3,4,5,6,7,8,9,10,11,12,13,13,14,14,15,15,15,16,16,16,16,16,16,16,16,16
E01002817,EV motorcycles,Number,0,1,2,3,4,5,7,9,10,12,13,15,16,18,19,20,21,22,22,23,23,23,23,24,24,24,24,24,24,24
E01002818,EV motorcycles,Number,0,1,1,2,3,3,4,5,6,7,8,9,10,11,12,12,13,13,14,14,14,15,15,15,15,15,15,15,15,15
E01002819,EV motorcycles,Number,0,1,2,4,6,7,10,12,14,16,18,21,23,24,26,27,29,30,31,31,32,32,32,33,33,33,33,33,33,33
E01002820,EV motorcycles,Number,1,2,4,6,9,12,16,19,23,27,30,34,37,40,43,45,47,49,50,51,52,52,53,53,53,54,54,54,54,54
E01002821,EV motorcycles,Number,0,1,1,2,4,5,6,7,9,10,12,13,14,16,17,17,18,19,19,20,20,20,21,21,21,21,21,21,21,21
E01002822,EV motorcycles,Number,0,1,1,2,3,4,5,6,7,8,10,11,12,13,13,14,15,15,16,16,16,16,17,17,17,17,17,17,17,17
E01002823,EV motorcycles,Number,0,1,1,2,3,4,5,6,7,8,10,11,12,13,13,14,15,15,16,16,16,16,17,17,17,17,17,17,17,17
E01002824,EV motorcycles,Number,0,1,1,2,3,3,4,5,6,7,8,9,10,11,12,12,13,13,14,14,14,15,15,15,15,15,15,15,15,15
E01002825,EV motorcycles,Number,0,1,1,2,3,4,5,6,8,9,10,11,12,13,14,15,16,16,17,17,17,17,18,18,18,18,18,18,18,18
E01002826,EV motorcycles,Number,0,1,1,2,4,5,6,8,9,11,12,14,15,16,17,18,19,20,20,21,21,21,22,22,22,22,22,22,22,22
E01002827,EV motorcycles,Number,0,1,2,3,4,5,7,9,10,12,13,15,16,18,19,20,21,22,22,23,23,23,23,24,24,24,24,24,24,24
E01002828,EV motorcycles,Number,0,1,1,2,3,4,5,6,7,8,10,11,12,13,13,14,15,15,16,16,16,16,17,17,17,17,17,17,17,17
E01002829,EV motorcycles,Number,0,1,2,3,4,5,7,8,10,11,13,14,16,17,18,19,20,21,21,22,22,22,23,23,23,23,23,23,23,23
E01002830,EV motorcycles,Number,0,1,1,2,3,4,5,6,7,8,9,10,11,12,13,13,14,14,15,15,15,16,16,16,16,16,16,16,16,16
E01002831,EV motorcycles,Number,0,1,2,3,5,7,8,10,12,14,16,18,20,21,23,24,25,26,27,27,28,28,28,29,29,29,29,29,29,29
E01002832,EV motorcycles,Number,0,1,1,2,4,5,6,7,9,10,12,13,14,16,17,17,18,19,19,20,20,20,21,21,21,21,21,21,21,21
E01002833,EV motorcycles,Number,0,0,1,1,2,3,4,5,5,6,7,8,9,10,10,11,11,12,12,12,12,13,13,13,13,13,13,13,13,13
E01002834,EV motorcycles,Number,0,1,2,3,5,6,8,10,11,13,15,17,18,20,21,22,23,24,25,25,26,26,26,27,27,27,27,27,27,27
E01002835,EV motorcycles,Number,0,1,1,2,4,5,6,7,9,10,12,13,14,16,17,17,18,19,19,20,20,20,21,21,21,21,21,21,21,21
E01002836,EV motorcycles,Number,0,1,2,3,4,6,8,9,11,13,15,16,18,19,20,22,23,23,24,25,25,25,25,26,26,26,26,26,26,26
E01002837,EV motorcycles,Number,0,1,1,2,3,3,4,5,6,7,8,9,10,11,12,12,13,13,14,14,14,15,15,15,15,15,15,15,15,15
E01002838,EV motorcycles,Number,0,1,1,2,3,4,5,6,8,9,10,11,12,13,14,15,16,16,17,17,17,17,18,18,18,18,18,18,18,18
E01002839,EV motorcycles,Number,0,1,1,2,3,3,4,5,6,7,8,9,10,11,12,12,13,13,14,14,14,15,15,15,15,15,15,15,15,15
E01002840,EV motorcycles,Number,0,1,1,2,3,4,6,7,8,10,11,12,14,15,16,17,17,18,18,19,19,19,20,20,20,20,20,20,20,20
E01002841,EV motorcycles,Number,0,1,2,4,6,7,10,12,14,16,18,21,23,24,26,27,29,30,31,31,32,32,32,33,33,33,33,33,33,33
E01002842,EV motorcycles,Number,0,1,1,2,3,3,4,5,6,7,8,9,10,11,12,12,13,13,14,14,14,15,15,15,15,15,15,15,15,15
E01002843,EV motorcycles,Number,0,1,2,3,4,6,8,9,11,13,15,16,18,19,20,22,23,23,24,25,25,25,25,26,26,26,26,26,26,26
E01002844,EV motorcycles,Number,0,1,2,3,4,6,7,9,11,12,14,16,17,18,20,21,22,22,23,24,24,24,24,25,25,25,25,25,25,25
E01002845,EV motorcycles,Number,0,1,2,3,4,6,7,9,11,12,14,16,17,18,20,21,22,22,23,24,24,24,24,25,25,25,25,25,25,25
E01002846,EV motorcycles,Number,0,0,1,1,2,3,4,5,5,6,7,8,9,10,10,11,11,12,12,12,12,13,13,13,13,13,13,13,13,13
E01002847,EV motorcycles,Number,0,1,2,3,5,7,8,10,12,14,16,18,20,21,23,24,25,26,27,27,28,28,28,29,29,29,29,29,29,29
E01002848,EV motorcycles,Number,0,0,0,1,1,2,2,2,3,3,4,4,5,5,6,6,6,6,6,7,7,7,7,7,7,7,7,7,7,7
E01002849,EV motorcycles,Number,0,1,2,3,5,6,8,10,11,13,15,17,18,20,21,22,23,24,25,25,26,26,26,27,27,27,27,27,27,27
E01002850,EV motorcycles,Number,0,1,1,2,3,3,4,5,6,7,8,9,10,11,12,12,13,13,14,14,14,15,15,15,15,15,15,15,15,15
E01002851,EV motorcycles,Number,0,0,1,1,2,2,3,3,4,4,5,6,6,7,7,7,8,8,8,8,9,9,9,9,9,9,9,9,9,9
E01002852,EV motorcycles,Number,1,1,2,4,6,8,10,12,15,17,20,22,24,26,28,29,30,31,32,33,34,34,34,34,35,35,35,35,35,35
E01002853,EV motorcycles,Number,0,1,1,2,3,4,6,7,8,10,11,12,14,15,16,17,17,18,18,19,19,19,20,20,20,20,20,20,20,20
E01002854,EV motorcycles,Number,0,0,0,1,1,1,1,2,2,2,3,3,3,4,4,4,4,4,5,5,5,5,5,5,5,5,5,5,5,5
E01002855,EV motorcycles,Number,0,1,1,2,3,4,5,6,8,9,10,11,12,13,14,15,16,16,17,17,17,17,18,18,18,18,18,18,18,18
E01002856,EV motorcycles,Number,0,0,1,1,2,2,3,4,5,5,6,7,8,8,9,9,10,10,10,10,11,11,11,11,11,11,11,11,11,11
E01002857,EV motorcycles,Number,0,1,1,2,4,5,6,7,9,10,12,13,14,16,17,17,18,19,19,20,20,20,21,21,21,21,21,21,21,21
E01002858,EV motorcycles,Number,0,1,2,3,4,6,8,9,11,13,15,16,18,19,20,22,23,23,24,25,25,25,25,26,26,26,26,26,26,26
E01002859,EV motorcycles,Number,0,1,1,2,3,4,5,6,7,8,10,11,12,13,13,14,15,15,16,16,16,16,17,17,17,17,17,17,17,17
E01002860,EV motorcycles,Number,0,1,2,3,4,5,7,9,10,12,13,15,16,18,19,20,21,22,22,23,23,23,23,24,24,24,24,24,24,24
E01002861,EV motorcycles,Number,0,1,2,3,4,5,7,9,10,12,13,15,16,18,19,20,21,22,22,23,23,23,23,24,24,24,24,24,24,24
E01002862,EV motorcycles,Number,0,0,1,1,2,2,3,4,4,5,6,6,7,7,8,8,9,9,9,9,10,10,10,10,10,10,10,10,10,10
E01002863,EV motorcycles,Number,0,1,1,2,3,4,5,6,7,8,9,10,11,12,13,13,14,14,15,15,15,16,16,16,16,16,16,16,16,16
E01002864,EV motorcycles,Number,0,1,2,3,4,6,7,9,11,12,14,16,17,18,20,21,22,22,23,24,24,24,24,25,25,25,25,25,25,25
E01002865,EV motorcycles,Number,0,0,1,1,2,2,3,3,4,4,5,6,6,7,7,7,8,8,8,8,9,9,9,9,9,9,9,9,9,9
E01002866,EV motorcycles,Number,0,1,1,2,3,4,5,7,8,9,11,12,13,14,15,16,17,17,18,18,18,18,19,19,19,19,19,19,19,19
E01002867,EV motorcycles,Number,0,1,2,3,5,7,8,10,12,14,16,18,20,21,23,24,25,26,27,27,28,28,28,29,29,29,29,29,29,29
E01002868,EV motorcycles,Number,0,1,1,2,4,5,6,8,9,11,12,14,15,16,17,18,19,20,20,21,21,21,22,22,22,22,22,22,22,22
E01002869,EV motorcycles,Number,0,1,2,3,5,6,8,10,11,13,15,17,18,20,21,22,23,24,25,25,26,26,26,27,27,27,27,27,27,27
E01002870,EV motorcycles,Number,0,1,1,2,4,5,6,7,9,10,12,13,14,16,17,17,18,19,19,20,20,20,21,21,21,21,21,21,21,21
E01002871,EV motorcycles,Number,0,1,1,2,4,5,6,7,9,10,12,13,14,16,17,17,18,19,19,20,20,20,21,21,21,21,21,21,21,21
E01002872,EV motorcycles,Number,0,0,1,1,2,3,3,4,5,6,7,7,8,9,9,10,10,11,11,11,12,12,12,12,12,12,12,12,12,12
E01002873,EV motorcycles,Number,0,1,1,2,3,4,5,6,7,8,9,10,11,12,13,13,14,14,15,15,15,16,16,16,16,16,16,16,16,16
E01002874,EV motorcycles,Number,0,1,2,3,4,5,7,9,10,12,13,15,16,18,19,20,21,22,22,23,23,23,23,24,24,24,24,24,24,24
E01002875,EV motorcycles,Number,0,1,1,2,3,4,5,6,7,8,10,11,12,13,13,14,15,15,16,16,16,16,17,17,17,17,17,17,17,17
E01002876,EV motorcycles,Number,0,1,2,3,4,5,7,8,10,11,13,14,16,17,18,19,20,21,21,22,22,22,23,23,23,23,23,23,23,23
E01002877,EV motorcycles,Number,0,1,2,3,5,6,8,10,12,14,16,17,19,21,22,23,24,25,26,26,27,27,27,28,28,28,28,28,28,28
E01002878,EV motorcycles,Number,1,2,3,5,7,10,13,16,19,22,25,27,30,33,35,37,38,40,41,42,42,43,43,43,44,44,44,44,44,44
E01002879,EV motorcycles,Number,0,1,1,2,4,5,6,7,9,10,12,13,14,16,17,17,18,19,19,20,20,20,21,21,21,21,21,21,21,21
E01002880,EV motorcycles,Number,0,0,1,1,2,3,4,5,5,6,7,8,9,10,10,11,11,12,12,12,12,13,13,13,13,13,13,13,13,13
E01002881,EV motorcycles,Number,0,1,1,2,3,3,4,5,6,7,8,9,10,11,12,12,13,13,14,14,14,15,15,15,15,15,15,15,15,15
E01002882,EV motorcycles,Number,0,1,1,2,3,4,6,7,8,10,11,12,14,15,16,17,17,18,18,19,19,19,20,20,20,20,20,20,20,20
E01002883,EV motorcycles,Number,0,1,1,2,3,4,5,6,7,8,9,10,11,12,13,13,14,14,15,15,15,16,16,16,16,16,16,16,16,16
E01002884,EV motorcycles,Number,0,1,1,2,4,5,6,7,9,10,12,13,14,16,17,17,18,19,19,20,20,20,21,21,21,21,21,21,21,21
E01002885,EV motorcycles,Number,0,1,2,3,4,5,7,8,10,11,13,14,16,17,18,19,20,21,21,22,22,22,23,23,23,23,23,23,23,23
E01002886,EV motorcycles,Number,0,1,2,3,5,7,8,10,12,14,16,18,20,21,23,24,25,26,27,27,28,28,28,29,29,29,29,29,29,29
E01002887,EV motorcycles,Number,0,1,1,2,3,4,5,6,7,8,9,10,11,12,13,13,14,14,15,15,15,16,16,16,16,16,16,16,16,16
E01002888,EV motorcycles,Number,0,1,2,3,4,5,7,8,10,11,13,14,16,17,18,19,20,21,21,22,22,22,23,23,23,23,23,23,23,23
E01002889,EV motorcycles,Number,0,1,2,3,4,6,7,9,11,12,14,16,17,18,20,21,22,22,23,24,24,24,24,25,25,25,25,25,25,25
E01002890,EV motorcycles,Number,0,1,2,3,4,5,7,9,10,12,13,15,16,18,19,20,21,22,22,23,23,23,23,24,24,24,24,24,24,24
E01002891,EV motorcycles,Number,0,1,1,2,3,4,5,6,7,8,10,11,12,13,13,14,15,15,16,16,16,16,17,17,17,17,17,17,17,17
E01002892,EV motorcycles,Number,1,1,2,4,6,9,11,13,16,19,21,24,26,28,30,32,33,34,35,36,36,37,37,37,38,38,38,38,38,38
E01002893,EV motorcycles,Number,0,1,2,3,4,6,8,9,11,13,15,16,18,19,20,22,23,23,24,25,25,25,25,26,26,26,26,26,26,26
E01002894,EV motorcycles,Number,0,1,1,2,3,4,5,6,7,8,10,11,12,13,13,14,15,15,16,16,16,16,17,17,17,17,17,17,17,17
E01002895,EV motorcycles,Number,0,1,1,2,3,4,6,7,8,10,11,12,14,15,16,17,17,18,18,19,19,19,20,20,20,20,20,20,20,20
E01002896,EV motorcycles,Number,0,1,2,3,5,6,8,10,11,13,15,17,18,20,21,22,23,24,25,25,26,26,26,27,27,27,27,27,27,27
E01002897,EV motorcycles,Number,0,1,2,3,4,6,7,9,11,12,14,16,17,18,20,21,22,22,23,24,24,24,24,25,25,25,25,25,25,25
E01002898,EV motorcycles,Number,0,1,2,3,5,7,9,11,13,15,17,19,21,23,24,26,27,28,29,29,30,30,30,31,31,31,31,31,31,31
E01002899,EV motorcycles,Number,0,1,2,3,4,5,7,8,10,11,13,14,16,17,18,19,20,21,21,22,22,22,23,23,23,23,23,23,23,23
E01002900,EV motorcycles,Number,0,1,1,2,4,5,6,7,9,10,12,13,14,16,17,17,18,19,19,20,20,20,21,21,21,21,21,21,21,21
E01002901,EV motorcycles,Number,0,1,1,2,3,4,5,6,7,8,10,11,12,13,13,14,15,15,16,16,16,16,17,17,17,17,17,17,17,17
E01002902,EV motorcycles,Number,0,1,1,2,3,4,5,6,7,8,9,10,11,12,13,13,14,14,15,15,15,16,16,16,16,16,16,16,16,16
E01002903,EV motorcycles,Number,0,1,1,2,3,4,5,6,7,8,9,10,11,12,13,13,14,14,15,15,15,16,16,16,16,16,16,16,16,16
E01002904,EV motorcycles,Number,0,1,1,2,3,4,5,6,7,8,9,10,11,12,13,13,14,14,15,15,15,16,16,16,16,16,16,16,16,16
E01002905,EV motorcycles,Number,0,1,2,3,4,6,7,9,11,12,14,16,17,18,20,21,22,22,23,24,24,24,24,25,25,25,25,25,25,25
E01002906,EV motorcycles,Number,0,1,2,3,4,5,7,9,10,12,13,15,16,18,19,20,21,22,22,23,23,23,23,24,24,24,24,24,24,24
E01002907,EV motorcycles,Number,0,1,1,2,3,4,6,7,8,10,11,12,14,15,16,17,17,18,18,19,19,19,20,20,20,20,20,20,20,20
E01002908,EV motorcycles,Number,0,1,1,2,4,5,6,8,9,11,12,14,15,16,17,18,19,20,20,21,21,21,22,22,22,22,22,22,22,22
E01002909,EV motorcycles,Number,0,1,2,3,4,6,8,9,11,13,15,16,18,19,20,22,23,23,24,25,25,25,25,26,26,26,26,26,26,26
E01002910,EV motorcycles,Number,0,1,1,2,3,4,5,6,7,8,10,11,12,13,13,14,15,15,16,16,16,16,17,17,17,17,17,17,17,17
E01002911,EV motorcycles,Number,0,1,2,3,5,6,8,10,12,14,16,17,19,21,22,23,24,25,26,26,27,27,27,28,28,28,28,28,28,28
E01002912,EV motorcycles,Number,0,1,2,3,5,7,9,11,13,15,17,19,21,22,24,25,26,27,28,28,29,29,29,30,30,30,30,30,30,30
E01002913,EV motorcycles,Number,1,1,2,4,6,8,11,13,16,18,21,23,25,27,29,31,32,33,34,35,35,36,36,36,37,37,37,37,37,37
E01002914,EV motorcycles,Number,0,1,1,2,3,4,5,6,7,8,9,10,11,12,13,13,14,14,15,15,15,16,16,16,16,16,16,16,16,16
E01002915,EV motorcycles,Number,1,1,2,4,6,9,11,13,16,19,21,24,26,28,30,32,33,34,35,36,36,37,37,37,38,38,38,38,38,38
E01002916,EV motorcycles,Number,0,1,2,4,5,7,9,11,14,16,18,20,22,24,25,27,28,29,30,30,31,31,31,32,32,32,32,32,32,32
E01002917,EV motorcycles,Number,0,1,2,3,4,6,7,9,11,12,14,16,17,18,20,21,22,22,23,24,24,24,24,25,25,25,25,25,25,25
E01002918,EV motorcycles,Number,0,1,1,2,3,4,6,7,8,10,11,12,14,15,16,17,17,18,18,19,19,19,20,20,20,20,20,20,20,20
E01002919,EV motorcycles,Number,0,1,2,4,6,7,10,12,14,16,18,21,23,24,26,27,29,30,31,31,32,32,32,33,33,33,33,33,33,33
E01002920,EV motorcycles,Number,1,1,2,4,6,8,11,13,16,18,21,23,25,27,29,31,32,33,34,35,35,36,36,36,37,37,37,37,37,37
E01002921,EV motorcycles,Number,0,1,1,2,3,4,5,6,7,8,10,11,12,13,13,14,15,15,16,16,16,16,17,17,17,17,17,17,17,17
E01002922,EV motorcycles,Number,0,1,2,4,6,7,10,12,14,16,18,21,23,24,26,27,29,30,31,31,32,32,32,33,33,33,33,33,33,33
E01002923,EV motorcycles,Number,0,1,2,3,5,7,9,11,13,15,17,19,21,22,24,25,26,27,28,28,29,29,29,30,30,30,30,30,30,30
E01002924,EV motorcycles,Number,0,1,2,3,4,6,8,9,11,13,15,16,18,19,20,22,23,23,24,25,25,25,25,26,26,26,26,26,26,26
E01002925,EV motorcycles,Number,0,1,2,3,4,6,7,9,11,12,14,16,17,18,20,21,22,22,23,24,24,24,24,25,25,25,25,25,25,25
E01002926,EV motorcycles,Number,0,1,1,2,3,3,4,5,6,7,8,9,10,11,12,12,13,13,14,14,14,15,15,15,15,15,15,15,15,15
E01002927,EV motorcycles,Number,0,1,2,3,4,6,8,9,11,13,15,16,18,19,20,22,23,23,24,25,25,25,25,26,26,26,26,26,26,26
E01002928,EV motorcycles,Number,0,1,2,3,4,6,8,9,11,13,15,16,18,19,20,22,23,23,24,25,25,25,25,26,26,26,26,26,26,26
E01002929,EV motorcycles,Number,0,1,2,3,5,7,8,10,12,14,16,18,20,21,23,24,25,26,27,27,28,28,28,29,29,29,29,29,29,29
E01002930,EV motorcycles,Number,1,2,4,7,10,13,17,21,25,29,33,37,40,44,47,49,51,53,55,56,57,57,58,58,58,59,59,59,59,59
E01002931,EV motorcycles,Number,0,1,2,3,4,5,7,9,10,12,13,15,16,18,19,20,21,22,22,23,23,23,23,24,24,24,24,24,24,24
E01002932,EV motorcycles,Number,1,1,3,5,7,9,12,15,17,20,23,26,28,30,32,34,36,37,38,39,39,40,40,40,41,41,41,41,41,41
E01002933,EV motorcycles,Number,0,1,2,3,5,7,9,11,13,15,17,19,21,23,24,26,27,28,29,29,30,30,30,31,31,31,31,31,31,31
E01002934,EV motorcycles,Number,0,1,2,3,4,6,7,9,11,12,14,16,17,18,20,21,22,22,23,24,24,24,24,25,25,25,25,25,25,25
E01002935,EV motorcycles,Number,0,1,2,4,6,8,10,12,14,17,19,21,23,25,27,28,30,31,31,32,33,33,33,33,34,34,34,34,34,34
E01002937,EV motorcycles,Number,1,2,3,5,7,10,13,16,19,22,25,27,30,33,35,37,38,40,41,42,42,43,43,43,44,44,44,44,44,44
E01002938,EV motorcycles,Number,1,1,3,5,7,9,12,15,17,20,23,26,28,30,32,34,36,37,38,39,39,40,40,40,41,41,41,41,41,41
E01002939,EV motorcycles,Number,1,2,4,7,10,13,17,21,25,30,34,37,41,44,47,50,52,54,55,57,58,58,59,59,59,60,60,60,60,60
E01002940,EV motorcycles,Number,0,1,2,3,5,7,9,11,13,15,17,19,21,23,24,26,27,28,29,29,30,30,30,31,31,31,31,31,31,31
E01002941,EV motorcycles,Number,1,3,5,8,12,16,21,25,30,35,40,44,49,52,56,59,62,64,66,67,68,69,70,70,70,71,71,71,71,71
E01002942,EV motorcycles,Number,1,1,3,4,7,9,12,14,17,20,22,25,27,30,32,33,35,36,37,38,38,39,39,39,40,40,40,40,40,40
E01002943,EV motorcycles,Number,0,1,2,4,5,7,9,11,14,16,18,20,22,24,25,27,28,29,30,30,31,31,31,32,32,32,32,32,32,32
E01002944,EV motorcycles,Number,0,1,2,3,5,7,9,11,13,15,17,19,21,22,24,25,26,27,28,28,29,29,29,30,30,30,30,30,30,30
E01002945,EV motorcycles,Number,1,2,4,6,10,13,17,21,25,29,32,36,40,43,46,48,50,52,54,55,56,56,57,57,57,58,58,58,58,58
E01002946,EV motorcycles,Number,0,1,2,3,5,7,8,10,12,14,16,18,20,21,23,24,25,26,27,27,28,28,28,29,29,29,29,29,29,29
E01002947,EV motorcycles,Number,1,2,3,5,8,10,13,16,19,23,26,29,31,34,36,38,40,41,43,43,44,45,45,45,46,46,46,46,46,46
E01002948,EV motorcycles,Number,1,3,5,8,13,17,22,27,32,37,42,47,51,55,59,62,65,67,69,71,72,73,73,74,74,74,75,75,75,75
E01002949,EV motorcycles,Number,1,2,3,5,8,11,14,17,20,24,27,30,33,35,38,40,42,43,44,45,46,47,47,47,48,48,48,48,48,48
E01002950,EV motorcycles,Number,1,1,3,4,7,9,12,14,17,20,22,25,27,30,32,33,35,36,37,38,38,39,39,39,40,40,40,40,40,40
E01002951,EV motorcycles,Number,0,1,2,3,5,6,8,10,12,14,16,17,19,21,22,23,24,25,26,26,27,27,27,28,28,28,28,28,28,28
E01002952,EV motorcycles,Number,0,1,1,2,3,4,5,6,7,8,9,10,11,12,13,13,14,14,15,15,15,16,16,16,16,16,16,16,16,16
E01002953,EV motorcycles,Number,0,1,1,2,3,4,5,6,7,8,10,11,12,13,13,14,15,15,16,16,16,16,17,17,17,17,17,17,17,17
E01002954,EV motorcycles,Number,0,1,1,2,4,5,6,8,9,11,12,14,15,16,17,18,19,20,20,21,21,21,22,22,22,22,22,22,22,22
E01002955,EV motorcycles,Number,1,2,4,6,9,13,16,20,24,28,31,35,38,41,44,47,49,50,52,53,54,54,55,55,55,56,56,56,56,56
E01002956,EV motorcycles,Number,0,1,2,3,5,7,9,11,13,15,17,19,21,22,24,25,26,27,28,28,29,29,29,30,30,30,30,30,30,30
E01002957,EV motorcycles,Number,0,1,2,3,4,5,7,9,10,12,13,15,16,18,19,20,21,22,22,23,23,23,23,24,24,24,24,24,24,24
E01002958,EV motorcycles,Number,0,1,1,2,3,4,6,7,8,10,11,12,14,15,16,17,17,18,18,19,19,19,20,20,20,20,20,20,20,20
E01002959,EV motorcycles,Number,0,1,1,2,3,4,5,6,7,8,10,11,12,13,13,14,15,15,16,16,16,16,17,17,17,17,17,17,17,17
E01002960,EV motorcycles,Number,0,1,1,2,4,5,6,7,9,10,12,13,14,16,17,17,18,19,19,20,20,20,21,21,21,21,21,21,21,21
E01002961,EV motorcycles,Number,0,1,2,3,4,6,7,9,11,12,14,16,17,18,20,21,22,22,23,24,24,24,24,25,25,25,25,25,25,25
E01002962,EV motorcycles,Number,1,1,3,5,7,9,12,15,17,20,23,26,28,30,32,34,36,37,38,39,39,40,40,40,41,41,41,41,41,41
E01002963,EV motorcycles,Number,0,1,2,3,4,6,7,9,11,12,14,16,17,18,20,21,22,22,23,24,24,24,24,25,25,25,25,25,25,25
E01002964,EV motorcycles,Number,0,1,2,3,5,7,8,10,12,14,16,18,20,21,23,24,25,26,27,27,28,28,28,29,29,29,29,29,29,29
E01002965,EV motorcycles,Number,0,1,2,3,4,6,7,9,11,12,14,16,17,18,20,21,22,22,23,24,24,24,24,25,25,25,25,25,25,25
E01002966,EV motorcycles,Number,1,2,3,5,7,10,12,15,18,21,24,27,29,32,34,36,37,39,40,41,41,42,42,42,43,43,43,43,43,43
E01002967,EV motorcycles,Number,0,1,2,3,5,7,9,11,13,15,17,19,21,22,24,25,26,27,28,28,29,29,29,30,30,30,30,30,30,30
E01002968,EV motorcycles,Number,1,2,3,5,7,10,12,15,18,21,24,27,29,32,34,36,37,39,40,41,41,42,42,42,43,43,43,43,43,43
E01002969,EV motorcycles,Number,0,1,1,2,3,4,5,6,8,9,10,11,12,13,14,15,16,16,17,17,17,17,18,18,18,18,18,18,18,18
E01002970,EV motorcycles,Number,1,2,3,5,7,9,12,15,18,21,24,26,29,31,33,35,36,38,39,40,40,41,41,41,42,42,42,42,42,42
E01002971,EV motorcycles,Number,0,1,2,4,5,7,9,11,14,16,18,20,22,24,25,27,28,29,30,30,31,31,31,32,32,32,32,32,32,32
E01002972,EV motorcycles,Number,0,1,2,3,5,6,8,10,11,13,15,17,18,20,21,22,23,24,25,25,26,26,26,27,27,27,27,27,27,27
E01002973,EV motorcycles,Number,0,1,2,4,6,8,10,12,14,17,19,21,23,25,27,28,30,31,31,32,33,33,33,33,34,34,34,34,34,34
E01002974,EV motorcycles,Number,0,1,2,4,5,7,9,11,14,16,18,20,22,24,25,27,28,29,30,30,31,31,31,32,32,32,32,32,32,32
E01002975,EV motorcycles,Number,0,1,1,2,3,4,6,7,8,10,11,12,14,15,16,17,17,18,18,19,19,19,20,20,20,20,20,20,20,20
E01002976,EV motorcycles,Number,0,1,2,3,5,6,8,10,12,14,16,17,19,21,22,23,24,25,26,26,27,27,27,28,28,28,28,28,28,28
E01002977,EV motorcycles,Number,1,2,3,5,7,10,13,16,19,22,25,27,30,33,35,37,38,40,41,42,42,43,43,43,44,44,44,44,44,44
E01002978,EV motorcycles,Number,0,1,2,4,5,7,9,11,14,16,18,20,22,24,25,27,28,29,30,30,31,31,31,32,32,32,32,32,32,32
E01002979,EV motorcycles,Number,0,1,2,3,4,6,7,9,11,12,14,16,17,18,20,21,22,22,23,24,24,24,24,25,25,25,25,25,25,25
E01002980,EV motorcycles,Number,0,1,2,3,5,6,8,10,12,14,16,17,19,21,22,23,24,25,26,26,27,27,27,28,28,28,28,28,28,28
E01002981,EV motorcycles,Number,0,1,2,3,4,5,7,9,10,12,13,15,16,18,19,20,21,22,22,23,23,23,23,24,24,24,24,24,24,24
E01002982,EV motorcycles,Number,0,1,2,3,4,5,7,9,10,12,13,15,16,18,19,20,21,22,22,23,23,23,23,24,24,24,24,24,24,24
E01002983,EV motorcycles,Number,1,2,3,5,8,10,13,16,19,22,25,28,31,33,35,37,39,40,42,42,43,44,44,44,45,45,45,45,45,45
E01002984,EV motorcycles,Number,0,1,2,3,4,6,8,9,11,13,15,16,18,19,20,22,23,23,24,25,25,25,25,26,26,26,26,26,26,26
E01002985,EV motorcycles,Number,1,2,3,5,8,11,14,17,21,24,27,31,33,36,39,41,43,44,45,46,47,48,48,48,48,49,49,49,49,49
E01002986,EV motorcycles,Number,0,1,1,2,3,4,5,7,8,9,11,12,13,14,15,16,17,17,18,18,18,18,19,19,19,19,19,19,19,19
E01002987,EV motorcycles,Number,0,1,2,4,5,7,9,11,14,16,18,20,22,24,25,27,28,29,30,30,31,31,31,32,32,32,32,32,32,32
E01002988,EV motorcycles,Number,0,1,1,2,3,4,5,6,7,8,9,10,11,12,13,13,14,14,15,15,15,16,16,16,16,16,16,16,16,16
E01002989,EV motorcycles,Number,1,1,2,4,6,8,10,12,15,17,20,22,24,26,28,29,30,31,32,33,34,34,34,34,35,35,35,35,35,35
E01002990,EV motorcycles,Number,0,1,1,2,3,4,5,7,8,9,11,12,13,14,15,16,17,17,18,18,18,18,19,19,19,19,19,19,19,19
E01002991,EV motorcycles,Number,0,1,1,2,4,5,6,8,9,11,12,14,15,16,17,18,19,20,20,21,21,21,22,22,22,22,22,22,22,22
E01002992,EV motorcycles,Number,0,1,2,3,5,6,8,10,11,13,15,17,18,20,21,22,23,24,25,25,26,26,26,27,27,27,27,27,27,27
E01002993,EV motorcycles,Number,0,1,2,3,5,6,8,10,11,13,15,17,18,20,21,22,23,24,25,25,26,26,26,27,27,27,27,27,27,27
E01002994,EV motorcycles,Number,1,1,2,4,6,8,10,13,15,18,20,22,25,27,28,30,31,32,33,34,35,35,35,35,36,36,36,36,36,36
E01002995,EV motorcycles,Number,0,1,2,3,5,7,8,10,12,14,16,18,20,21,23,24,25,26,27,27,28,28,28,29,29,29,29,29,29,29
E01002996,EV motorcycles,Number,0,1,2,3,5,7,8,10,12,14,16,18,20,21,23,24,25,26,27,27,28,28,28,29,29,29,29,29,29,29
E01002997,EV motorcycles,Number,0,1,2,4,5,7,9,11,14,16,18,20,22,24,25,27,28,29,30,30,31,31,31,32,32,32,32,32,32,32
E01002998,EV motorcycles,Number,0,1,1,2,4,5,6,8,9,11,12,14,15,16,17,18,19,20,20,21,21,21,22,22,22,22,22,22,22,22
E01002999,EV motorcycles,Number,0,1,2,3,4,5,7,9,10,12,13,15,16,18,19,20,21,22,22,23,23,23,23,24,24,24,24,24,24,24
E01003000,EV motorcycles,Number,1,2,3,5,8,10,13,16,19,22,25,28,31,33,35,37,39,40,42,42,43,44,44,44,45,45,45,45,45,45
E01003001,EV motorcycles,Number,1,2,3,5,7,9,12,15,18,21,24,26,29,31,33,35,36,38,39,40,40,41,41,41,42,42,42,42,42,42
E01003002,EV motorcycles,Number,0,1,2,3,5,7,9,11,13,15,17,19,21,22,24,25,26,27,28,28,29,29,29,30,30,30,30,30,30,30
E01003003,EV motorcycles,Number,0,1,2,3,4,6,8,9,11,13,15,16,18,19,20,22,23,23,24,25,25,25,25,26,26,26,26,26,26,26
E01003004,EV motorcycles,Number,1,1,2,4,6,8,10,12,15,17,20,22,24,26,28,29,30,31,32,33,34,34,34,34,35,35,35,35,35,35
E01003005,EV motorcycles,Number,1,1,3,5,7,9,12,15,17,20,23,26,28,30,32,34,36,37,38,39,39,40,40,40,41,41,41,41,41,41
E01003006,EV motorcycles,Number,0,1,2,3,5,7,8,10,12,14,16,18,20,21,23,24,25,26,27,27,28,28,28,29,29,29,29,29,29,29
E01003007,EV motorcycles,Number,1,2,3,5,7,10,13,16,19,22,25,27,30,33,35,37,38,40,41,42,42,43,43,43,44,44,44,44,44,44
E01003008,EV motorcycles,Number,0,1,2,3,5,7,9,11,13,15,17,19,21,22,24,25,26,27,28,28,29,29,29,30,30,30,30,30,30,30
E01003009,EV motorcycles,Number,1,2,3,6,9,12,15,18,22,26,29,32,36,38,41,43,45,47,48,49,50,50,51,51,51,52,52,52,52,52
E01003010,EV motorcycles,Number,0,1,2,4,5,7,9,11,14,16,18,20,22,24,25,27,28,29,30,30,31,31,31,32,32,32,32,32,32,32
E01003011,EV motorcycles,Number,0,0,1,1,2,3,4,5,5,6,7,8,9,10,10,11,11,12,12,12,12,13,13,13,13,13,13,13,13,13
E01003013,EV motorcycles,Number,0,0,1,1,2,3,4,5,5,6,7,8,9,10,10,11,11,12,12,12,12,13,13,13,13,13,13,13,13,13
E01003014,EV motorcycles,Number,0,1,1,2,3,4,5,7,8,9,11,12,13,14,15,16,17,17,18,18,18,18,19,19,19,19,19,19,19,19
E01003015,EV motorcycles,Number,0,1,1,2,4,5,6,8,9,11,12,14,15,16,17,18,19,20,20,21,21,21,22,22,22,22,22,22,22,22
E01003016,EV motorcycles,Number,0,0,0,1,1,1,1,2,2,2,3,3,3,4,4,4,4,4,5,5,5,5,5,5,5,5,5,5,5,5
E01003017,EV motorcycles,Number,0,0,1,1,2,2,3,3,4,4,5,6,6,7,7,7,8,8,8,8,9,9,9,9,9,9,9,9,9,9
E01003018,EV motorcycles,Number,0,1,2,3,4,6,7,9,11,12,14,16,17,18,20,21,22,22,23,24,24,24,24,25,25,25,25,25,25,25
E01003019,EV motorcycles,Number,0,1,2,3,4,5,7,8,10,11,13,14,16,17,18,19,20,21,21,22,22,22,23,23,23,23,23,23,23,23
E01003020,EV motorcycles,Number,0,0,1,1,2,3,3,4,5,6,7,7,8,9,9,10,10,11,11,11,12,12,12,12,12,12,12,12,12,12
E01003021,EV motorcycles,Number,0,1,1,2,3,3,4,5,6,7,8,9,10,11,12,12,13,13,14,14,14,15,15,15,15,15,15,15,15,15
E01003022,EV motorcycles,Number,0,1,2,3,5,7,9,11,13,15,17,19,21,22,24,25,26,27,28,28,29,29,29,30,30,30,30,30,30,30
E01003023,EV motorcycles,Number,1,2,3,5,8,10,13,16,19,22,25,28,31,33,35,37,39,40,42,42,43,44,44,44,45,45,45,45,45,45
E01003024,EV motorcycles,Number,0,1,1,2,3,4,5,6,8,9,10,11,12,13,14,15,16,16,17,17,17,17,18,18,18,18,18,18,18,18
E01003025,EV motorcycles,Number,0,1,2,4,5,7,9,11,14,16,18,20,22,24,25,27,28,29,30,30,31,31,31,32,32,32,32,32,32,32
E01003026,EV motorcycles,Number,0,1,1,2,3,4,5,6,8,9,10,11,12,13,14,15,16,16,17,17,17,17,18,18,18,18,18,18,18,18
E01003027,EV motorcycles,Number,0,1,1,2,3,4,5,7,8,9,11,12,13,14,15,16,17,17,18,18,18,18,19,19,19,19,19,19,19,19
E01003028,EV motorcycles,Number,0,1,1,2,3,4,5,6,7,8,10,11,12,13,13,14,15,15,16,16,16,16,17,17,17,17,17,17,17,17
E01003029,EV motorcycles,Number,0,1,2,3,4,5,7,9,10,12,13,15,16,18,19,20,21,22,22,23,23,23,23,24,24,24,24,24,24,24
E01003030,EV motorcycles,Number,0,1,1,2,4,5,6,7,9,10,12,13,14,16,17,17,18,19,19,20,20,20,21,21,21,21,21,21,21,21
E01003031,EV motorcycles,Number,0,1,2,3,4,5,7,8,10,11,13,14,16,17,18,19,20,21,21,22,22,22,23,23,23,23,23,23,23,23
E01003032,EV motorcycles,Number,0,1,1,2,3,4,5,6,7,8,10,11,12,13,13,14,15,15,16,16,16,16,17,17,17,17,17,17,17,17
E01003033,EV motorcycles,Number,1,1,2,4,6,8,10,12,15,17,20,22,24,26,28,29,30,31,32,33,34,34,34,34,35,35,35,35,35,35
E01003034,EV motorcycles,Number,0,1,2,3,5,7,8,10,12,14,16,18,20,21,23,24,25,26,27,27,28,28,28,29,29,29,29,29,29,29
E01003035,EV motorcycles,Number,1,2,4,6,9,12,16,19,23,27,30,34,37,40,43,45,47,49,50,51,52,52,53,53,53,54,54,54,54,54
E01003036,EV motorcycles,Number,0,1,2,3,4,5,7,9,10,12,13,15,16,18,19,20,21,22,22,23,23,23,23,24,24,24,24,24,24,24
E01003037,EV motorcycles,Number,0,1,2,3,5,6,8,10,11,13,15,17,18,20,21,22,23,24,25,25,26,26,26,27,27,27,27,27,27,27
E01003038,EV motorcycles,Number,0,1,2,4,6,7,10,12,14,16,18,21,23,24,26,27,29,30,31,31,32,32,32,33,33,33,33,33,33,33
E01003039,EV motorcycles,Number,1,2,3,5,7,9,12,15,18,21,24,26,29,31,33,35,36,38,39,40,40,41,41,41,42,42,42,42,42,42
E01003040,EV motorcycles,Number,0,1,1,2,4,5,6,7,9,10,12,13,14,16,17,17,18,19,19,20,20,20,21,21,21,21,21,21,21,21
E01003041,EV motorcycles,Number,0,1,1,2,3,4,5,7,8,9,11,12,13,14,15,16,17,17,18,18,18,18,19,19,19,19,19,19,19,19
E01003042,EV motorcycles,Number,0,1,1,2,3,4,5,6,7,8,9,10,11,12,13,13,14,14,15,15,15,16,16,16,16,16,16,16,16,16
E01003043,EV motorcycles,Number,0,1,1,2,2,3,4,5,6,7,8,9,10,10,11,12,12,13,13,13,13,14,14,14,14,14,14,14,14,14
E01003044,EV motorcycles,Number,0,0,0,1,1,2,2,2,3,3,4,4,5,5,6,6,6,6,6,7,7,7,7,7,7,7,7,7,7,7
E01003045,EV motorcycles,Number,0,1,1,2,3,4,5,6,7,8,9,10,11,12,13,13,14,14,15,15,15,16,16,16,16,16,16,16,16,16
E01003046,EV motorcycles,Number,0,1,1,2,4,5,6,7,9,10,12,13,14,16,17,17,18,19,19,20,20,20,21,21,21,21,21,21,21,21
E01003047,EV motorcycles,Number,0,1,2,3,4,5,7,8,10,11,13,14,16,17,18,19,20,21,21,22,22,22,23,23,23,23,23,23,23,23
E01003048,EV motorcycles,Number,1,2,4,7,10,14,18,22,26,30,35,39,42,46,49,52,54,56,57,59,59,60,61,61,61,62,62,62,62,62
E01003049,EV motorcycles,Number,0,1,2,3,4,6,8,9,11,13,15,16,18,19,20,22,23,23,24,25,25,25,25,26,26,26,26,26,26,26
E01003050,EV motorcycles,Number,0,0,1,1,2,2,3,3,4,4,5,6,6,7,7,7,8,8,8,8,9,9,9,9,9,9,9,9,9,9
E01003051,EV motorcycles,Number,0,1,1,2,3,4,5,7,8,9,11,12,13,14,15,16,17,17,18,18,18,18,19,19,19,19,19,19,19,19
E01003052,EV motorcycles,Number,0,1,1,2,3,3,4,5,6,7,8,9,10,11,12,12,13,13,14,14,14,15,15,15,15,15,15,15,15,15
E01003053,EV motorcycles,Number,0,1,2,3,5,7,9,11,13,15,17,19,21,22,24,25,26,27,28,28,29,29,29,30,30,30,30,30,30,30
E01003054,EV motorcycles,Number,0,0,1,1,2,3,3,4,5,6,7,7,8,9,9,10,10,11,11,11,12,12,12,12,12,12,12,12,12,12
E01003055,EV motorcycles,Number,0,1,1,2,4,5,6,8,9,11,12,14,15,16,17,18,19,20,20,21,21,21,22,22,22,22,22,22,22,22
E01003056,EV motorcycles,Number,0,1,1,2,3,4,5,6,8,9,10,11,12,13,14,15,16,16,17,17,17,17,18,18,18,18,18,18,18,18
E01003057,EV motorcycles,Number,0,1,1,2,4,5,6,7,9,10,12,13,14,16,17,17,18,19,19,20,20,20,21,21,21,21,21,21,21,21
E01003058,EV motorcycles,Number,0,1,1,2,3,4,5,7,8,9,11,12,13,14,15,16,17,17,18,18,18,18,19,19,19,19,19,19,19,19
E01003059,EV motorcycles,Number,0,1,1,2,3,4,6,7,8,10,11,12,14,15,16,17,17,18,18,19,19,19,20,20,20,20,20,20,20,20
E01003060,EV motorcycles,Number,0,1,1,2,3,4,6,7,8,10,11,12,14,15,16,17,17,18,18,19,19,19,20,20,20,20,20,20,20,20
E01003061,EV motorcycles,Number,0,1,1,2,3,4,5,6,8,9,10,11,12,13,14,15,16,16,17,17,17,17,18,18,18,18,18,18,18,18
E01003062,EV motorcycles,Number,0,1,2,3,4,5,7,9,10,12,13,15,16,18,19,20,21,22,22,23,23,23,23,24,24,24,24,24,24,24
E01003063,EV motorcycles,Number,0,1,1,2,4,5,6,8,9,11,12,14,15,16,17,18,19,20,20,21,21,21,22,22,22,22,22,22,22,22
E01003064,EV motorcycles,Number,0,0,1,1,2,3,4,5,5,6,7,8,9,10,10,11,11,12,12,12,12,13,13,13,13,13,13,13,13,13
E01003065,EV motorcycles,Number,0,1,1,2,3,4,6,7,8,10,11,12,14,15,16,17,17,18,18,19,19,19,20,20,20,20,20,20,20,20
E01003066,EV motorcycles,Number,0,1,2,3,5,6,8,10,11,13,15,17,18,20,21,22,23,24,25,25,26,26,26,27,27,27,27,27,27,27
E01003067,EV motorcycles,Number,0,1,2,3,5,6,8,10,12,14,16,17,19,21,22,23,24,25,26,26,27,27,27,28,28,28,28,28,28,28
E01003068,EV motorcycles,Number,0,1,2,4,6,8,10,12,14,17,19,21,23,25,27,28,30,31,31,32,33,33,33,33,34,34,34,34,34,34
E01003069,EV motorcycles,Number,0,1,2,3,4,6,8,9,11,13,15,16,18,19,20,22,23,23,24,25,25,25,25,26,26,26,26,26,26,26
E01003070,EV motorcycles,Number,0,1,2,3,4,5,7,8,10,11,13,14,16,17,18,19,20,21,21,22,22,22,23,23,23,23,23,23,23,23
E01003071,EV motorcycles,Number,0,1,1,2,3,4,5,7,8,9,11,12,13,14,15,16,17,17,18,18,18,18,19,19,19,19,19,19,19,19
E01003072,EV motorcycles,Number,0,1,2,4,6,8,10,12,14,17,19,21,23,25,27,28,30,31,31,32,33,33,33,33,34,34,34,34,34,34
E01003073,EV motorcycles,Number,0,1,1,2,2,3,4,5,6,7,8,9,10,10,11,12,12,13,13,13,13,14,14,14,14,14,14,14,14,14
E01003074,EV motorcycles,Number,0,1,2,3,5,7,9,11,13,15,17,19,21,22,24,25,26,27,28,28,29,29,29,30,30,30,30,30,30,30
E01003075,EV motorcycles,Number,0,1,1,2,3,4,5,6,7,8,9,10,11,12,13,13,14,14,15,15,15,16,16,16,16,16,16,16,16,16
E01003076,EV motorcycles,Number,0,1,2,3,5,6,8,10,11,13,15,17,18,20,21,22,23,24,25,25,26,26,26,27,27,27,27,27,27,27
E01003077,EV motorcycles,Number,0,1,2,3,5,6,8,10,12,14,16,17,19,21,22,23,24,25,26,26,27,27,27,28,28,28,28,28,28,28
E01003078,EV motorcycles,Number,0,0,1,1,2,3,4,5,5,6,7,8,9,10,10,11,11,12,12,12,12,13,13,13,13,13,13,13,13,13
E01003079,EV motorcycles,Number,1,2,3,5,8,10,13,16,19,22,25,28,31,33,35,37,39,40,42,42,43,44,44,44,45,45,45,45,45,45
E01003080,EV motorcycles,Number,0,1,2,3,4,5,7,8,10,11,13,14,16,17,18,19,20,21,21,22,22,22,23,23,23,23,23,23,23,23
E01003081,EV motorcycles,Number,1,1,3,4,7,9,12,14,17,20,22,25,27,30,32,33,35,36,37,38,38,39,39,39,40,40,40,40,40,40
E01003082,EV motorcycles,Number,0,1,2,3,4,5,7,9,10,12,13,15,16,18,19,20,21,22,22,23,23,23,23,24,24,24,24,24,24,24
E01003083,EV motorcycles,Number,1,1,2,4,6,9,11,13,16,19,21,24,26,28,30,32,33,34,35,36,36,37,37,37,38,38,38,38,38,38
E01003084,EV motorcycles,Number,0,1,1,2,3,4,5,6,7,8,9,10,11,12,13,13,14,14,15,15,15,16,16,16,16,16,16,16,16,16
E01003085,EV motorcycles,Number,1,1,2,4,6,8,10,12,15,17,20,22,24,26,28,29,30,31,32,33,34,34,34,34,35,35,35,35,35,35
E01003086,EV motorcycles,Number,0,1,2,3,4,6,8,9,11,13,15,16,18,19,20,22,23,23,24,25,25,25,25,26,26,26,26,26,26,26
E01003087,EV motorcycles,Number,0,1,2,4,6,8,10,12,14,17,19,21,23,25,27,28,30,31,31,32,33,33,33,33,34,34,34,34,34,34
E01003088,EV motorcycles,Number,0,1,2,3,4,5,7,8,10,11,13,14,16,17,18,19,20,21,21,22,22,22,23,23,23,23,23,23,23,23
E01003089,EV motorcycles,Number,1,1,3,4,7,9,12,14,17,20,22,25,27,30,32,33,35,36,37,38,38,39,39,39,40,40,40,40,40,40
E01003090,EV motorcycles,Number,1,1,3,4,7,9,12,14,17,20,22,25,27,30,32,33,35,36,37,38,38,39,39,39,40,40,40,40,40,40
E01003091,EV motorcycles,Number,0,1,2,3,4,5,7,8,10,11,13,14,16,17,18,19,20,21,21,22,22,22,23,23,23,23,23,23,23,23
E01003092,EV motorcycles,Number,1,1,2,4,6,8,10,12,15,17,20,22,24,26,28,29,30,31,32,33,34,34,34,34,35,35,35,35,35,35
E01003093,EV motorcycles,Number,0,1,2,3,4,6,7,9,11,12,14,16,17,18,20,21,22,22,23,24,24,24,24,25,25,25,25,25,25,25
E01003094,EV motorcycles,Number,0,1,2,3,4,5,7,8,10,11,13,14,16,17,18,19,20,21,21,22,22,22,23,23,23,23,23,23,23,23
E01003095,EV motorcycles,Number,1,1,2,4,6,8,10,12,15,17,20,22,24,26,28,29,30,31,32,33,34,34,34,34,35,35,35,35,35,35
E01003096,EV motorcycles,Number,0,1,1,2,4,5,6,8,9,11,12,14,15,16,17,18,19,20,20,21,21,21,22,22,22,22,22,22,22,22
E01003097,EV motorcycles,Number,0,1,1,2,3,4,5,6,8,9,10,11,12,13,14,15,16,16,17,17,17,17,18,18,18,18,18,18,18,18
E01003098,EV motorcycles,Number,0,0,1,1,2,2,3,4,4,5,6,6,7,7,8,8,9,9,9,9,10,10,10,10,10,10,10,10,10,10
E01003099,EV motorcycles,Number,0,1,1,2,4,5,6,7,9,10,12,13,14,16,17,17,18,19,19,20,20,20,21,21,21,21,21,21,21,21
E01003100,EV motorcycles,Number,0,0,1,1,2,2,3,4,4,5,6,6,7,7,8,8,9,9,9,9,10,10,10,10,10,10,10,10,10,10
E01003101,EV motorcycles,Number,0,1,2,3,4,5,7,8,10,11,13,14,16,17,18,19,20,21,21,22,22,22,23,23,23,23,23,23,23,23
E01003102,EV motorcycles,Number,0,1,1,2,4,5,6,8,9,11,12,14,15,16,17,18,19,20,20,21,21,21,22,22,22,22,22,22,22,22
E01003104,EV motorcycles,Number,0,1,2,3,4,5,7,8,10,11,13,14,16,17,18,19,20,21,21,22,22,22,23,23,23,23,23,23,23,23
E01003105,EV motorcycles,Number,0,1,1,2,3,4,5,6,8,9,10,11,12,13,14,15,16,16,17,17,17,17,18,18,18,18,18,18,18,18
E01003106,EV motorcycles,Number,0,1,2,3,4,5,7,9,10,12,13,15,16,18,19,20,21,22,22,23,23,23,23,24,24,24,24,24,24,24
E01003107,EV motorcycles,Number,1,1,2,4,6,8,10,12,15,17,20,22,24,26,28,29,30,31,32,33,34,34,34,34,35,35,35,35,35,35
E01003108,EV motorcycles,Number,0,1,1,2,3,4,5,6,8,9,10,11,12,13,14,15,16,16,17,17,17,17,18,18,18,18,18,18,18,18
E01003109,EV motorcycles,Number,1,1,3,5,7,9,12,15,17,20,23,26,28,30,32,34,36,37,38,39,39,40,40,40,41,41,41,41,41,41
E01003110,EV motorcycles,Number,1,1,3,4,7,9,12,14,17,20,22,25,27,30,32,33,35,36,37,38,38,39,39,39,40,40,40,40,40,40
E01003111,EV motorcycles,Number,0,1,2,3,5,6,8,10,12,14,16,17,19,21,22,23,24,25,26,26,27,27,27,28,28,28,28,28,28,28
E01003112,EV motorcycles,Number,0,1,1,2,4,5,6,7,9,10,12,13,14,16,17,17,18,19,19,20,20,20,21,21,21,21,21,21,21,21
E01003113,EV motorcycles,Number,0,1,2,3,5,6,8,10,11,13,15,17,18,20,21,22,23,24,25,25,26,26,26,27,27,27,27,27,27,27
E01003114,EV motorcycles,Number,0,1,2,4,6,8,10,12,14,17,19,21,23,25,27,28,30,31,31,32,33,33,33,33,34,34,34,34,34,34
E01003115,EV motorcycles,Number,0,1,1,2,3,4,5,6,8,9,10,11,12,13,14,15,16,16,17,17,17,17,18,18,18,18,18,18,18,18
E01003116,EV motorcycles,Number,1,1,3,4,7,9,11,14,16,19,22,24,27,29,31,32,34,35,36,37,37,38,38,38,39,39,39,39,39,39
E01003117,EV motorcycles,Number,0,1,2,3,5,6,8,10,12,14,16,17,19,21,22,23,24,25,26,26,27,27,27,28,28,28,28,28,28,28
E01003118,EV motorcycles,Number,1,2,3,5,7,9,12,15,18,21,24,26,29,31,33,35,36,38,39,40,40,41,41,41,42,42,42,42,42,42
E01003119,EV motorcycles,Number,1,2,3,6,8,11,14,18,21,25,28,31,34,37,39,42,43,45,46,47,48,49,49,49,49,50,50,50,50,50
E01003120,EV motorcycles,Number,1,3,5,8,12,16,21,26,30,35,40,45,49,53,57,60,63,65,67,68,69,70,70,71,71,71,72,72,72,72
E01003121,EV motorcycles,Number,0,1,1,2,3,4,5,6,8,9,10,11,12,13,14,15,16,16,17,17,17,17,18,18,18,18,18,18,18,18
E01003122,EV motorcycles,Number,0,1,2,3,5,6,8,10,12,14,16,17,19,21,22,23,24,25,26,26,27,27,27,28,28,28,28,28,28,28
E01003123,EV motorcycles,Number,0,1,2,3,4,6,8,9,11,13,15,16,18,19,20,22,23,23,24,25,25,25,25,26,26,26,26,26,26,26
E01003124,EV motorcycles,Number,0,1,2,3,4,5,7,9,10,12,13,15,16,18,19,20,21,22,22,23,23,23,23,24,24,24,24,24,24,24
E01003125,EV motorcycles,Number,0,1,2,3,5,7,9,11,13,15,17,19,21,22,24,25,26,27,28,28,29,29,29,30,30,30,30,30,30,30
E01003126,EV motorcycles,Number,0,1,2,3,4,6,7,9,11,12,14,16,17,18,20,21,22,22,23,24,24,24,24,25,25,25,25,25,25,25
E01003127,EV motorcycles,Number,0,1,1,2,3,4,5,7,8,9,11,12,13,14,15,16,17,17,18,18,18,18,19,19,19,19,19,19,19,19
E01003128,EV motorcycles,Number,0,1,2,3,5,7,9,11,13,15,17,19,21,22,24,25,26,27,28,28,29,29,29,30,30,30,30,30,30,30
E01003129,EV motorcycles,Number,0,1,2,3,5,7,8,10,12,14,16,18,20,21,23,24,25,26,27,27,28,28,28,29,29,29,29,29,29,29
E01003130,EV motorcycles,Number,0,1,2,3,5,7,8,10,12,14,16,18,20,21,23,24,25,26,27,27,28,28,28,29,29,29,29,29,29,29
E01003131,EV motorcycles,Number,1,1,2,4,6,9,11,13,16,19,21,24,26,28,30,32,33,34,35,36,36,37,37,37,38,38,38,38,38,38
E01003132,EV motorcycles,Number,0,1,1,2,3,4,5,7,8,9,11,12,13,14,15,16,17,17,18,18,18,18,19,19,19,19,19,19,19,19
E01003133,EV motorcycles,Number,0,1,2,3,5,6,8,10,11,13,15,17,18,20,21,22,23,24,25,25,26,26,26,27,27,27,27,27,27,27
E01003134,EV motorcycles,Number,0,1,2,3,4,6,8,9,11,13,15,16,18,19,20,22,23,23,24,25,25,25,25,26,26,26,26,26,26,26
E01003135,EV motorcycles,Number,0,1,2,3,4,5,7,8,10,11,13,14,16,17,18,19,20,21,21,22,22,22,23,23,23,23,23,23,23,23
E01003136,EV motorcycles,Number,0,1,2,3,5,6,8,10,11,13,15,17,18,20,21,22,23,24,25,25,26,26,26,27,27,27,27,27,27,27
E01003137,EV motorcycles,Number,0,1,2,3,5,7,9,11,13,15,17,19,21,23,24,26,27,28,29,29,30,30,30,31,31,31,31,31,31,31
E01003138,EV motorcycles,Number,0,1,1,2,4,5,6,8,9,11,12,14,15,16,17,18,19,20,20,21,21,21,22,22,22,22,22,22,22,22
E01003139,EV motorcycles,Number,1,1,3,5,7,9,12,15,17,20,23,26,28,30,32,34,36,37,38,39,39,40,40,40,41,41,41,41,41,41
E01003140,EV motorcycles,Number,0,1,2,4,6,8,10,12,14,17,19,21,23,25,27,28,30,31,31,32,33,33,33,33,34,34,34,34,34,34
E01003141,EV motorcycles,Number,0,1,2,4,6,7,10,12,14,16,18,21,23,24,26,27,29,30,31,31,32,32,32,33,33,33,33,33,33,33
E01003142,EV motorcycles,Number,0,1,2,3,4,5,7,9,10,12,13,15,16,18,19,20,21,22,22,23,23,23,23,24,24,24,24,24,24,24
E01003143,EV motorcycles,Number,0,1,1,2,3,4,5,6,7,8,10,11,12,13,13,14,15,15,16,16,16,16,17,17,17,17,17,17,17,17
E01003144,EV motorcycles,Number,0,1,2,3,4,5,7,9,10,12,13,15,16,18,19,20,21,22,22,23,23,23,23,24,24,24,24,24,24,24
E01003145,EV motorcycles,Number,1,1,2,4,6,8,10,12,15,17,20,22,24,26,28,29,30,31,32,33,34,34,34,34,35,35,35,35,35,35
E01003146,EV motorcycles,Number,0,1,2,3,4,5,7,9,10,12,13,15,16,18,19,20,21,22,22,23,23,23,23,24,24,24,24,24,24,24
E01003147,EV motorcycles,Number,1,2,4,6,9,12,16,19,23,27,30,34,37,40,43,45,47,49,50,51,52,52,53,53,53,54,54,54,54,54
E01003148,EV motorcycles,Number,1,2,3,5,8,11,14,17,20,23,26,29,32,35,37,39,41,42,43,44,45,46,46,46,47,47,47,47,47,47
E01003149,EV motorcycles,Number,1,1,2,4,6,8,10,13,15,18,20,22,25,27,28,30,31,32,33,34,35,35,35,35,36,36,36,36,36,36
E01003150,EV motorcycles,Number,1,1,2,4,6,8,11,13,16,18,21,23,25,27,29,31,32,33,34,35,35,36,36,36,37,37,37,37,37,37
E01003151,EV motorcycles,Number,0,1,2,4,5,7,9,11,14,16,18,20,22,24,25,27,28,29,30,30,31,31,31,32,32,32,32,32,32,32
E01003152,EV motorcycles,Number,1,2,3,5,8,11,14,17,20,24,27,30,33,35,38,40,42,43,44,45,46,47,47,47,48,48,48,48,48,48
E01003153,EV motorcycles,Number,1,1,3,4,7,9,12,14,17,20,22,25,27,30,32,33,35,36,37,38,38,39,39,39,40,40,40,40,40,40
E01003154,EV motorcycles,Number,1,2,3,6,9,12,15,19,22,26,30,33,36,39,42,44,46,48,49,50,51,51,52,52,52,53,53,53,53,53
E01003155,EV motorcycles,Number,0,1,2,4,6,7,10,12,14,16,18,21,23,24,26,27,29,30,31,31,32,32,32,33,33,33,33,33,33,33
E01003156,EV motorcycles,Number,0,1,1,2,3,4,5,6,7,8,10,11,12,13,13,14,15,15,16,16,16,16,17,17,17,17,17,17,17,17
E01003157,EV motorcycles,Number,0,1,1,2,4,5,6,7,9,10,12,13,14,16,17,17,18,19,19,20,20,20,21,21,21,21,21,21,21,21
E01003158,EV motorcycles,Number,0,1,1,2,4,5,6,8,9,11,12,14,15,16,17,18,19,20,20,21,21,21,22,22,22,22,22,22,22,22
E01003159,EV motorcycles,Number,1,1,2,4,6,9,11,13,16,19,21,24,26,28,30,32,33,34,35,36,36,37,37,37,38,38,38,38,38,38
E01003160,EV motorcycles,Number,0,1,1,2,2,3,4,5,6,7,8,9,10,10,11,12,12,13,13,13,13,14,14,14,14,14,14,14,14,14
E01003161,EV motorcycles,Number,0,1,1,2,3,4,5,6,8,9,10,11,12,13,14,15,16,16,17,17,17,17,18,18,18,18,18,18,18,18
E01003162,EV motorcycles,Number,0,1,1,2,3,4,5,6,8,9,10,11,12,13,14,15,16,16,17,17,17,17,18,18,18,18,18,18,18,18
E01003163,EV motorcycles,Number,0,1,2,3,5,7,9,11,13,15,17,19,21,23,24,26,27,28,29,29,30,30,30,31,31,31,31,31,31,31
E01003164,EV motorcycles,Number,0,1,2,3,5,7,9,11,13,15,17,19,21,23,24,26,27,28,29,29,30,30,30,31,31,31,31,31,31,31
E01003165,EV motorcycles,Number,0,0,1,1,2,2,3,4,4,5,6,6,7,7,8,8,9,9,9,9,10,10,10,10,10,10,10,10,10,10
E01003166,EV motorcycles,Number,1,2,3,6,9,12,15,19,22,26,30,33,36,39,42,44,46,48,49,50,51,51,52,52,52,53,53,53,53,53
E01003167,EV motorcycles,Number,0,1,2,3,5,7,9,11,13,15,17,19,21,22,24,25,26,27,28,28,29,29,29,30,30,30,30,30,30,30
E01003168,EV motorcycles,Number,0,1,2,3,4,6,7,9,11,12,14,16,17,18,20,21,22,22,23,24,24,24,24,25,25,25,25,25,25,25
E01003169,EV motorcycles,Number,1,1,2,4,6,8,10,12,15,17,20,22,24,26,28,29,30,31,32,33,34,34,34,34,35,35,35,35,35,35
E01003170,EV motorcycles,Number,0,0,1,1,2,3,4,5,5,6,7,8,9,10,10,11,11,12,12,12,12,13,13,13,13,13,13,13,13,13
E01003171,EV motorcycles,Number,0,1,2,3,4,5,7,9,10,12,13,15,16,18,19,20,21,22,22,23,23,23,23,24,24,24,24,24,24,24
E01003172,EV motorcycles,Number,0,1,1,2,4,5,6,7,9,10,12,13,14,16,17,17,18,19,19,20,20,20,21,21,21,21,21,21,21,21
E01003173,EV motorcycles,Number,0,1,2,3,5,6,8,10,11,13,15,17,18,20,21,22,23,24,25,25,26,26,26,27,27,27,27,27,27,27
E01003174,EV motorcycles,Number,0,1,2,3,5,6,8,10,11,13,15,17,18,20,21,22,23,24,25,25,26,26,26,27,27,27,27,27,27,27
E01003175,EV motorcycles,Number,0,1,1,2,4,5,6,7,9,10,12,13,14,16,17,17,18,19,19,20,20,20,21,21,21,21,21,21,21,21
E01003176,EV motorcycles,Number,0,1,1,2,2,3,4,5,6,7,8,9,10,10,11,12,12,13,13,13,13,14,14,14,14,14,14,14,14,14
E01003177,EV motorcycles,Number,0,1,1,2,3,4,5,6,7,8,9,10,11,12,13,13,14,14,15,15,15,16,16,16,16,16,16,16,16,16
E01003178,EV motorcycles,Number,0,0,1,1,2,3,4,5,5,6,7,8,9,10,10,11,11,12,12,12,12,13,13,13,13,13,13,13,13,13
E01003179,EV motorcycles,Number,0,1,1,2,4,5,6,8,9,11,12,14,15,16,17,18,19,20,20,21,21,21,22,22,22,22,22,22,22,22
E01003180,EV motorcycles,Number,0,1,1,2,3,4,5,6,8,9,10,11,12,13,14,15,16,16,17,17,17,17,18,18,18,18,18,18,18,18
E01003181,EV motorcycles,Number,0,1,1,2,4,5,6,8,9,11,12,14,15,16,17,18,19,20,20,21,21,21,22,22,22,22,22,22,22,22
E01003182,EV motorcycles,Number,1,1,2,4,6,9,11,13,16,19,21,24,26,28,30,32,33,34,35,36,36,37,37,37,38,38,38,38,38,38
E01003183,EV motorcycles,Number,0,1,2,3,4,5,7,9,10,12,13,15,16,18,19,20,21,22,22,23,23,23,23,24,24,24,24,24,24,24
E01003184,EV motorcycles,Number,0,1,1,2,3,4,5,6,8,9,10,11,12,13,14,15,16,16,17,17,17,17,18,18,18,18,18,18,18,18
E01003185,EV motorcycles,Number,0,1,1,2,3,4,5,6,7,8,10,11,12,13,13,14,15,15,16,16,16,16,17,17,17,17,17,17,17,17
E01003186,EV motorcycles,Number,0,1,2,3,5,7,8,10,12,14,16,18,20,21,23,24,25,26,27,27,28,28,28,29,29,29,29,29,29,29
E01003187,EV motorcycles,Number,0,1,2,3,5,7,9,11,13,15,17,19,21,22,24,25,26,27,28,28,29,29,29,30,30,30,30,30,30,30
E01003188,EV motorcycles,Number,0,0,1,1,2,3,4,5,5,6,7,8,9,10,10,11,11,12,12,12,12,13,13,13,13,13,13,13,13,13
E01003189,EV motorcycles,Number,0,1,1,2,3,4,5,6,7,8,9,10,11,12,13,13,14,14,15,15,15,16,16,16,16,16,16,16,16,16
E01003190,EV motorcycles,Number,0,1,2,3,4,5,7,9,10,12,13,15,16,18,19,20,21,22,22,23,23,23,23,24,24,24,24,24,24,24
E01003191,EV motorcycles,Number,0,1,1,2,3,4,6,7,8,10,11,12,14,15,16,17,17,18,18,19,19,19,20,20,20,20,20,20,20,20
E01003192,EV motorcycles,Number,0,1,1,2,3,4,5,6,8,9,10,11,12,13,14,15,16,16,17,17,17,17,18,18,18,18,18,18,18,18
E01003193,EV motorcycles,Number,0,0,1,1,2,3,4,5,5,6,7,8,9,10,10,11,11,12,12,12,12,13,13,13,13,13,13,13,13,13
E01003194,EV motorcycles,Number,0,1,2,3,4,5,7,8,10,11,13,14,16,17,18,19,20,21,21,22,22,22,23,23,23,23,23,23,23,23
E01003195,EV motorcycles,Number,0,1,1,2,3,4,5,6,7,8,9,10,11,12,13,13,14,14,15,15,15,16,16,16,16,16,16,16,16,16
E01003196,EV motorcycles,Number,0,1,1,2,4,5,6,8,9,11,12,14,15,16,17,18,19,20,20,21,21,21,22,22,22,22,22,22,22,22
E01003197,EV motorcycles,Number,0,1,1,2,4,5,6,8,9,11,12,14,15,16,17,18,19,20,20,21,21,21,22,22,22,22,22,22,22,22
E01003198,EV motorcycles,Number,0,1,1,2,3,3,4,5,6,7,8,9,10,11,12,12,13,13,14,14,14,15,15,15,15,15,15,15,15,15
E01003199,EV motorcycles,Number,0,1,1,2,3,3,4,5,6,7,8,9,10,11,12,12,13,13,14,14,14,15,15,15,15,15,15,15,15,15
E01003200,EV motorcycles,Number,0,1,1,2,3,3,4,5,6,7,8,9,10,11,12,12,13,13,14,14,14,15,15,15,15,15,15,15,15,15
E01003201,EV motorcycles,Number,0,1,1,2,4,5,6,7,9,10,12,13,14,16,17,17,18,19,19,20,20,20,21,21,21,21,21,21,21,21
E01003202,EV motorcycles,Number,0,1,1,2,3,3,4,5,6,7,8,9,10,11,12,12,13,13,14,14,14,15,15,15,15,15,15,15,15,15
E01003203,EV motorcycles,Number,0,0,1,1,2,3,3,4,5,6,7,7,8,9,9,10,10,11,11,11,12,12,12,12,12,12,12,12,12,12
E01003204,EV motorcycles,Number,0,1,1,2,3,4,5,7,8,9,11,12,13,14,15,16,17,17,18,18,18,18,19,19,19,19,19,19,19,19
E01003205,EV motorcycles,Number,0,1,1,2,3,4,5,6,7,8,9,10,11,12,13,13,14,14,15,15,15,16,16,16,16,16,16,16,16,16
E01003206,EV motorcycles,Number,0,1,1,2,3,4,5,6,8,9,10,11,12,13,14,15,16,16,17,17,17,17,18,18,18,18,18,18,18,18
E01003207,EV motorcycles,Number,0,1,2,3,4,5,7,8,10,11,13,14,16,17,18,19,20,21,21,22,22,22,23,23,23,23,23,23,23,23
E01003209,EV motorcycles,Number,0,1,1,2,3,3,4,5,6,7,8,9,10,11,12,12,13,13,14,14,14,15,15,15,15,15,15,15,15,15
E01003210,EV motorcycles,Number,0,1,1,2,2,3,4,5,6,7,8,9,10,10,11,12,12,13,13,13,13,14,14,14,14,14,14,14,14,14
E01003211,EV motorcycles,Number,0,1,1,2,4,5,6,7,9,10,12,13,14,16,17,17,18,19,19,20,20,20,21,21,21,21,21,21,21,21
E01003212,EV motorcycles,Number,0,1,2,3,4,5,7,9,10,12,13,15,16,18,19,20,21,22,22,23,23,23,23,24,24,24,24,24,24,24
E01003213,EV motorcycles,Number,0,1,2,3,4,5,7,9,10,12,13,15,16,18,19,20,21,22,22,23,23,23,23,24,24,24,24,24,24,24
E01003214,EV motorcycles,Number,0,1,2,3,5,7,8,10,12,14,16,18,20,21,23,24,25,26,27,27,28,28,28,29,29,29,29,29,29,29
E01003215,EV motorcycles,Number,0,1,1,2,4,5,6,7,9,10,12,13,14,16,17,17,18,19,19,20,20,20,21,21,21,21,21,21,21,21
E01003216,EV motorcycles,Number,0,1,2,3,4,5,7,9,10,12,13,15,16,18,19,20,21,22,22,23,23,23,23,24,24,24,24,24,24,24
E01003217,EV motorcycles,Number,0,1,1,2,3,4,5,6,7,8,9,10,11,12,13,13,14,14,15,15,15,16,16,16,16,16,16,16,16,16
E01003218,EV motorcycles,Number,0,1,1,2,3,4,5,7,8,9,11,12,13,14,15,16,17,17,18,18,18,18,19,19,19,19,19,19,19,19
E01003219,EV motorcycles,Number,0,1,1,2,3,4,5,7,8,9,11,12,13,14,15,16,17,17,18,18,18,18,19,19,19,19,19,19,19,19
E01003220,EV motorcycles,Number,0,0,1,1,2,3,4,5,5,6,7,8,9,10,10,11,11,12,12,12,12,13,13,13,13,13,13,13,13,13
E01003221,EV motorcycles,Number,0,1,2,3,4,5,7,9,10,12,13,15,16,18,19,20,21,22,22,23,23,23,23,24,24,24,24,24,24,24
E01003222,EV motorcycles,Number,0,1,1,2,3,4,5,7,8,9,11,12,13,14,15,16,17,17,18,18,18,18,19,19,19,19,19,19,19,19
E01003223,EV motorcycles,Number,1,2,3,5,7,10,12,15,18,21,24,27,29,32,34,36,37,39,40,41,41,42,42,42,43,43,43,43,43,43
E01003224,EV motorcycles,Number,0,1,2,3,4,6,8,9,11,13,15,16,18,19,20,22,23,23,24,25,25,25,25,26,26,26,26,26,26,26
E01003225,EV motorcycles,Number,0,1,1,2,3,4,5,7,8,9,11,12,13,14,15,16,17,17,18,18,18,18,19,19,19,19,19,19,19,19
E01003226,EV motorcycles,Number,0,1,2,3,5,6,8,10,12,14,16,17,19,21,22,23,24,25,26,26,27,27,27,28,28,28,28,28,28,28
E01003227,EV motorcycles,Number,0,1,2,3,5,7,8,10,12,14,16,18,20,21,23,24,25,26,27,27,28,28,28,29,29,29,29,29,29,29
E01003228,EV motorcycles,Number,0,1,1,2,2,3,4,5,6,7,8,9,10,10,11,12,12,13,13,13,13,14,14,14,14,14,14,14,14,14
E01003229,EV motorcycles,Number,0,1,2,4,5,7,9,11,14,16,18,20,22,24,25,27,28,29,30,30,31,31,31,32,32,32,32,32,32,32
E01003230,EV motorcycles,Number,1,1,2,4,6,8,10,12,15,17,20,22,24,26,28,29,30,31,32,33,34,34,34,34,35,35,35,35,35,35
E01003231,EV motorcycles,Number,0,1,1,2,3,4,5,6,7,8,9,10,11,12,13,13,14,14,15,15,15,16,16,16,16,16,16,16,16,16
E01003232,EV motorcycles,Number,0,1,1,2,3,3,4,5,6,7,8,9,10,11,12,12,13,13,14,14,14,15,15,15,15,15,15,15,15,15
E01003233,EV motorcycles,Number,0,1,2,3,4,5,7,9,10,12,13,15,16,18,19,20,21,22,22,23,23,23,23,24,24,24,24,24,24,24
E01003235,EV motorcycles,Number,1,1,2,4,6,8,11,13,16,18,21,23,25,27,29,31,32,33,34,35,35,36,36,36,37,37,37,37,37,37
E01003236,EV motorcycles,Number,0,1,2,3,4,6,8,9,11,13,15,16,18,19,20,22,23,23,24,25,25,25,25,26,26,26,26,26,26,26
E01003237,EV motorcycles,Number,0,1,1,2,3,4,6,7,8,10,11,12,14,15,16,17,17,18,18,19,19,19,20,20,20,20,20,20,20,20
E01003238,EV motorcycles,Number,0,1,2,3,4,5,7,8,10,11,13,14,16,17,18,19,20,21,21,22,22,22,23,23,23,23,23,23,23,23
E01003239,EV motorcycles,Number,0,1,1,2,3,4,5,6,8,9,10,11,12,13,14,15,16,16,17,17,17,17,18,18,18,18,18,18,18,18
E01003240,EV motorcycles,Number,0,1,2,4,6,8,10,12,14,17,19,21,23,25,27,28,30,31,31,32,33,33,33,33,34,34,34,34,34,34
E01003241,EV motorcycles,Number,0,1,1,2,4,5,6,7,9,10,12,13,14,16,17,17,18,19,19,20,20,20,21,21,21,21,21,21,21,21
E01003243,EV motorcycles,Number,0,1,2,3,4,5,7,8,10,11,13,14,16,17,18,19,20,21,21,22,22,22,23,23,23,23,23,23,23,23
E01003244,EV motorcycles,Number,0,0,1,1,2,2,3,4,5,5,6,7,8,8,9,9,10,10,10,10,11,11,11,11,11,11,11,11,11,11
E01003245,EV motorcycles,Number,0,0,1,1,2,3,4,5,5,6,7,8,9,10,10,11,11,12,12,12,12,13,13,13,13,13,13,13,13,13
E01003246,EV motorcycles,Number,0,1,2,3,4,6,8,9,11,13,15,16,18,19,20,22,23,23,24,25,25,25,25,26,26,26,26,26,26,26
E01003247,EV motorcycles,Number,0,1,2,3,4,6,8,9,11,13,15,16,18,19,20,22,23,23,24,25,25,25,25,26,26,26,26,26,26,26
E01003248,EV motorcycles,Number,0,1,1,2,2,3,4,5,6,7,8,9,10,10,11,12,12,13,13,13,13,14,14,14,14,14,14,14,14,14
E01003249,EV motorcycles,Number,0,1,2,3,4,5,7,8,10,11,13,14,16,17,18,19,20,21,21,22,22,22,23,23,23,23,23,23,23,23
E01003250,EV motorcycles,Number,1,2,3,5,8,10,13,16,19,23,26,29,31,34,36,38,40,41,43,43,44,45,45,45,46,46,46,46,46,46
E01003251,EV motorcycles,Number,0,0,1,1,2,3,4,5,5,6,7,8,9,10,10,11,11,12,12,12,12,13,13,13,13,13,13,13,13,13
E01003252,EV motorcycles,Number,0,0,1,1,1,2,2,3,3,4,4,5,5,6,6,7,7,7,7,8,8,8,8,8,8,8,8,8,8,8
E01003253,EV motorcycles,Number,1,1,2,4,6,8,10,12,15,17,20,22,24,26,28,29,30,31,32,33,34,34,34,34,35,35,35,35,35,35
E01003254,EV motorcycles,Number,0,1,1,2,4,5,6,8,9,11,12,14,15,16,17,18,19,20,20,21,21,21,22,22,22,22,22,22,22,22
E01003255,EV motorcycles,Number,1,1,2,4,6,8,11,13,16,18,21,23,25,27,29,31,32,33,34,35,35,36,36,36,37,37,37,37,37,37
E01003256,EV motorcycles,Number,0,1,1,2,4,5,6,7,9,10,12,13,14,16,17,17,18,19,19,20,20,20,21,21,21,21,21,21,21,21
E01003257,EV motorcycles,Number,0,1,1,2,3,4,5,6,7,8,9,10,11,12,13,13,14,14,15,15,15,16,16,16,16,16,16,16,16,16
E01003258,EV motorcycles,Number,0,1,2,3,4,6,8,9,11,13,15,16,18,19,20,22,23,23,24,25,25,25,25,26,26,26,26,26,26,26
E01003259,EV motorcycles,Number,1,1,2,4,6,9,11,13,16,19,21,24,26,28,30,32,33,34,35,36,36,37,37,37,38,38,38,38,38,38
E01003260,EV motorcycles,Number,0,1,1,2,3,4,5,6,8,9,10,11,12,13,14,15,16,16,17,17,17,17,18,18,18,18,18,18,18,18
E01003261,EV motorcycles,Number,0,1,2,3,5,6,8,10,11,13,15,17,18,20,21,22,23,24,25,25,26,26,26,27,27,27,27,27,27,27
E01003262,EV motorcycles,Number,0,0,1,1,2,3,4,5,5,6,7,8,9,10,10,11,11,12,12,12,12,13,13,13,13,13,13,13,13,13
E01003263,EV motorcycles,Number,1,1,2,4,6,8,10,12,15,17,20,22,24,26,28,29,30,31,32,33,34,34,34,34,35,35,35,35,35,35
E01003264,EV motorcycles,Number,0,1,2,3,4,5,7,9,10,12,13,15,16,18,19,20,21,22,22,23,23,23,23,24,24,24,24,24,24,24
E01003265,EV motorcycles,Number,0,1,1,2,3,4,6,7,8,10,11,12,14,15,16,17,17,18,18,19,19,19,20,20,20,20,20,20,20,20
E01003266,EV motorcycles,Number,0,1,1,2,3,4,5,6,7,8,10,11,12,13,13,14,15,15,16,16,16,16,17,17,17,17,17,17,17,17
E01003267,EV motorcycles,Number,0,1,2,4,6,7,10,12,14,16,18,21,23,24,26,27,29,30,31,31,32,32,32,33,33,33,33,33,33,33
E01003268,EV motorcycles,Number,0,1,1,2,3,4,6,7,8,10,11,12,14,15,16,17,17,18,18,19,19,19,20,20,20,20,20,20,20,20
E01003269,EV motorcycles,Number,0,1,2,3,4,5,7,8,10,11,13,14,16,17,18,19,20,21,21,22,22,22,23,23,23,23,23,23,23,23
E01003270,EV motorcycles,Number,0,1,2,4,6,8,10,12,14,17,19,21,23,25,27,28,30,31,31,32,33,33,33,33,34,34,34,34,34,34
E01003271,EV motorcycles,Number,1,2,3,5,7,10,12,15,18,21,24,27,29,32,34,36,37,39,40,41,41,42,42,42,43,43,43,43,43,43
E01003272,EV motorcycles,Number,0,1,2,3,4,6,8,9,11,13,15,16,18,19,20,22,23,23,24,25,25,25,25,26,26,26,26,26,26,26
E01003273,EV motorcycles,Number,0,1,1,2,3,4,5,6,8,9,10,11,12,13,14,15,16,16,17,17,17,17,18,18,18,18,18,18,18,18
E01003274,EV motorcycles,Number,0,0,0,1,1,2,2,2,3,3,4,4,5,5,6,6,6,6,6,7,7,7,7,7,7,7,7,7,7,7
E01003275,EV motorcycles,Number,0,0,0,1,1,2,2,2,3,3,4,4,5,5,6,6,6,6,6,7,7,7,7,7,7,7,7,7,7,7
E01003276,EV motorcycles,Number,0,1,1,2,4,5,6,7,9,10,12,13,14,16,17,17,18,19,19,20,20,20,21,21,21,21,21,21,21,21
E01003277,EV motorcycles,Number,0,1,2,3,5,6,8,10,12,14,16,17,19,21,22,23,24,25,26,26,27,27,27,28,28,28,28,28,28,28
E01003278,EV motorcycles,Number,0,1,1,2,3,3,4,5,6,7,8,9,10,11,12,12,13,13,14,14,14,15,15,15,15,15,15,15,15,15
E01003279,EV motorcycles,Number,0,1,2,3,4,6,7,9,11,12,14,16,17,18,20,21,22,22,23,24,24,24,24,25,25,25,25,25,25,25
E01003280,EV motorcycles,Number,0,1,2,3,5,7,9,11,13,15,17,19,21,22,24,25,26,27,28,28,29,29,29,30,30,30,30,30,30,30
E01003281,EV motorcycles,Number,0,1,1,2,3,3,4,5,6,7,8,9,10,11,12,12,13,13,14,14,14,15,15,15,15,15,15,15,15,15
E01003282,EV motorcycles,Number,0,1,2,3,4,6,8,9,11,13,15,16,18,19,20,22,23,23,24,25,25,25,25,26,26,26,26,26,26,26
E01003283,EV motorcycles,Number,0,1,1,2,3,4,5,6,8,9,10,11,12,13,14,15,16,16,17,17,17,17,18,18,18,18,18,18,18,18
E01003284,EV motorcycles,Number,0,1,1,2,3,4,6,7,8,10,11,12,14,15,16,17,17,18,18,19,19,19,20,20,20,20,20,20,20,20
E01003285,EV motorcycles,Number,0,1,2,3,5,7,9,11,13,15,17,19,21,22,24,25,26,27,28,28,29,29,29,30,30,30,30,30,30,30
E01003286,EV motorcycles,Number,0,1,1,2,4,5,6,8,9,11,12,14,15,16,17,18,19,20,20,21,21,21,22,22,22,22,22,22,22,22
E01003287,EV motorcycles,Number,0,1,1,2,4,5,6,7,9,10,12,13,14,16,17,17,18,19,19,20,20,20,21,21,21,21,21,21,21,21
E01003288,EV motorcycles,Number,0,1,2,3,5,6,8,10,12,14,16,17,19,21,22,23,24,25,26,26,27,27,27,28,28,28,28,28,28,28
E01003290,EV motorcycles,Number,0,1,2,3,5,7,9,11,13,15,17,19,21,22,24,25,26,27,28,28,29,29,29,30,30,30,30,30,30,30
E01003291,EV motorcycles,Number,0,1,1,2,3,4,5,6,7,8,10,11,12,13,13,14,15,15,16,16,16,16,17,17,17,17,17,17,17,17
E01003292,EV motorcycles,Number,0,1,2,3,5,7,8,10,12,14,16,18,20,21,23,24,25,26,27,27,28,28,28,29,29,29,29,29,29,29
E01003293,EV motorcycles,Number,0,1,2,3,4,6,8,9,11,13,15,16,18,19,20,22,23,23,24,25,25,25,25,26,26,26,26,26,26,26
E01003295,EV motorcycles,Number,1,2,3,5,7,9,12,15,18,21,24,26,29,31,33,35,36,38,39,40,40,41,41,41,42,42,42,42,42,42
E01003296,EV motorcycles,Number,0,1,2,3,5,6,8,10,11,13,15,17,18,20,21,22,23,24,25,25,26,26,26,27,27,27,27,27,27,27
E01003297,EV motorcycles,Number,0,1,2,3,4,6,8,9,11,13,15,16,18,19,20,22,23,23,24,25,25,25,25,26,26,26,26,26,26,26
E01003298,EV motorcycles,Number,0,1,1,2,3,4,6,7,8,10,11,12,14,15,16,17,17,18,18,19,19,19,20,20,20,20,20,20,20,20
E01003299,EV motorcycles,Number,0,1,1,2,4,5,6,7,9,10,12,13,14,16,17,17,18,19,19,20,20,20,21,21,21,21,21,21,21,21
E01003300,EV motorcycles,Number,0,1,1,2,2,3,4,5,6,7,8,9,10,10,11,12,12,13,13,13,13,14,14,14,14,14,14,14,14,14
E01003301,EV motorcycles,Number,0,1,1,2,3,4,5,6,8,9,10,11,12,13,14,15,16,16,17,17,17,17,18,18,18,18,18,18,18,18
E01003302,EV motorcycles,Number,0,1,2,3,5,6,8,10,11,13,15,17,18,20,21,22,23,24,25,25,26,26,26,27,27,27,27,27,27,27
E01003303,EV motorcycles,Number,0,1,1,2,3,4,5,6,7,8,10,11,12,13,13,14,15,15,16,16,16,16,17,17,17,17,17,17,17,17
E01003304,EV motorcycles,Number,0,1,1,2,3,4,6,7,8,10,11,12,14,15,16,17,17,18,18,19,19,19,20,20,20,20,20,20,20,20
E01003305,EV motorcycles,Number,0,1,1,2,3,4,5,6,7,8,10,11,12,13,13,14,15,15,16,16,16,16,17,17,17,17,17,17,17,17
E01003307,EV motorcycles,Number,0,0,1,1,2,3,4,5,5,6,7,8,9,10,10,11,11,12,12,12,12,13,13,13,13,13,13,13,13,13
E01003308,EV motorcycles,Number,0,1,1,2,4,5,6,7,9,10,12,13,14,16,17,17,18,19,19,20,20,20,21,21,21,21,21,21,21,21
E01003309,EV motorcycles,Number,0,1,1,2,3,4,5,6,7,8,9,10,11,12,13,13,14,14,15,15,15,16,16,16,16,16,16,16,16,16
E01003310,EV motorcycles,Number,0,1,1,2,4,5,6,7,9,10,12,13,14,16,17,17,18,19,19,20,20,20,21,21,21,21,21,21,21,21
E01003311,EV motorcycles,Number,0,1,1,2,3,4,5,7,8,9,11,12,13,14,15,16,17,17,18,18,18,18,19,19,19,19,19,19,19,19
E01003312,EV motorcycles,Number,0,1,2,3,5,7,9,11,13,15,17,19,21,23,24,26,27,28,29,29,30,30,30,31,31,31,31,31,31,31
E01003313,EV motorcycles,Number,0,1,1,2,3,4,5,7,8,9,11,12,13,14,15,16,17,17,18,18,18,18,19,19,19,19,19,19,19,19
E01003314,EV motorcycles,Number,0,1,2,3,4,5,7,9,10,12,13,15,16,18,19,20,21,22,22,23,23,23,23,24,24,24,24,24,24,24
E01003315,EV motorcycles,Number,0,0,1,1,2,3,3,4,5,6,7,7,8,9,9,10,10,11,11,11,12,12,12,12,12,12,12,12,12,12
E01003316,EV motorcycles,Number,0,1,1,2,3,4,5,6,8,9,10,11,12,13,14,15,16,16,17,17,17,17,18,18,18,18,18,18,18,18
E01003317,EV motorcycles,Number,1,2,3,5,7,9,12,15,18,21,24,26,29,31,33,35,36,38,39,40,40,41,41,41,42,42,42,42,42,42
E01003318,EV motorcycles,Number,0,1,1,2,4,5,6,7,9,10,12,13,14,16,17,17,18,19,19,20,20,20,21,21,21,21,21,21,21,21
E01003319,EV motorcycles,Number,0,1,1,2,3,4,5,7,8,9,11,12,13,14,15,16,17,17,18,18,18,18,19,19,19,19,19,19,19,19
E01003320,EV motorcycles,Number,0,1,1,2,3,4,6,7,8,10,11,12,14,15,16,17,17,18,18,19,19,19,20,20,20,20,20,20,20,20
E01003321,EV motorcycles,Number,0,1,1,2,2,3,4,5,6,7,8,9,10,10,11,12,12,13,13,13,13,14,14,14,14,14,14,14,14,14
E01003322,EV motorcycles,Number,0,1,2,3,5,7,9,11,13,15,17,19,21,23,24,26,27,28,29,29,30,30,30,31,31,31,31,31,31,31
E01003323,EV motorcycles,Number,0,0,1,1,2,3,3,4,5,6,7,7,8,9,9,10,10,11,11,11,12,12,12,12,12,12,12,12,12,12
E01003324,EV motorcycles,Number,1,1,2,4,6,9,11,13,16,19,21,24,26,28,30,32,33,34,35,36,36,37,37,37,38,38,38,38,38,38
E01003325,EV motorcycles,Number,0,1,2,3,4,5,7,9,10,12,13,15,16,18,19,20,21,22,22,23,23,23,23,24,24,24,24,24,24,24
E01003326,EV motorcycles,Number,0,1,1,2,3,3,4,5,6,7,8,9,10,11,12,12,13,13,14,14,14,15,15,15,15,15,15,15,15,15
E01003327,EV motorcycles,Number,0,1,2,3,4,6,8,9,11,13,15,16,18,19,20,22,23,23,24,25,25,25,25,26,26,26,26,26,26,26
E01003328,EV motorcycles,Number,0,1,1,2,3,4,5,6,8,9,10,11,12,13,14,15,16,16,17,17,17,17,18,18,18,18,18,18,18,18
E01003329,EV motorcycles,Number,0,1,2,3,4,5,7,9,10,12,13,15,16,18,19,20,21,22,22,23,23,23,23,24,24,24,24,24,24,24
E01003330,EV motorcycles,Number,0,1,2,3,4,5,7,8,10,11,13,14,16,17,18,19,20,21,21,22,22,22,23,23,23,23,23,23,23,23
E01003331,EV motorcycles,Number,0,1,1,2,3,4,6,7,8,10,11,12,14,15,16,17,17,18,18,19,19,19,20,20,20,20,20,20,20,20
E01003332,EV motorcycles,Number,0,1,1,2,3,3,4,5,6,7,8,9,10,11,12,12,13,13,14,14,14,15,15,15,15,15,15,15,15,15
E01003333,EV motorcycles,Number,0,1,1,2,4,5,6,7,9,10,12,13,14,16,17,17,18,19,19,20,20,20,21,21,21,21,21,21,21,21
E01003334,EV motorcycles,Number,0,1,1,2,3,4,5,6,8,9,10,11,12,13,14,15,16,16,17,17,17,17,18,18,18,18,18,18,18,18
E01003335,EV motorcycles,Number,0,0,1,1,2,3,4,5,5,6,7,8,9,10,10,11,11,12,12,12,12,13,13,13,13,13,13,13,13,13
E01003336,EV motorcycles,Number,0,1,1,2,2,3,4,5,6,7,8,9,10,10,11,12,12,13,13,13,13,14,14,14,14,14,14,14,14,14
E01003337,EV motorcycles,Number,0,0,1,1,1,2,2,3,3,4,4,5,5,6,6,7,7,7,7,8,8,8,8,8,8,8,8,8,8,8
E01003338,EV motorcycles,Number,0,1,2,3,5,7,8,10,12,14,16,18,20,21,23,24,25,26,27,27,28,28,28,29,29,29,29,29,29,29
E01003339,EV motorcycles,Number,0,1,1,2,3,4,5,6,8,9,10,11,12,13,14,15,16,16,17,17,17,17,18,18,18,18,18,18,18,18
E01003340,EV motorcycles,Number,1,2,3,5,7,9,12,15,18,21,24,26,29,31,33,35,36,38,39,40,40,41,41,41,42,42,42,42,42,42
E01003341,EV motorcycles,Number,0,1,2,3,4,5,7,8,10,11,13,14,16,17,18,19,20,21,21,22,22,22,23,23,23,23,23,23,23,23
E01003342,EV motorcycles,Number,0,1,1,2,3,4,5,6,7,8,9,10,11,12,13,13,14,14,15,15,15,16,16,16,16,16,16,16,16,16
E01003343,EV motorcycles,Number,0,1,1,2,3,4,5,6,8,9,10,11,12,13,14,15,16,16,17,17,17,17,18,18,18,18,18,18,18,18
E01003344,EV motorcycles,Number,0,1,2,3,4,6,8,9,11,13,15,16,18,19,20,22,23,23,24,25,25,25,25,26,26,26,26,26,26,26
E01003345,EV motorcycles,Number,0,1,1,2,4,5,6,7,9,10,12,13,14,16,17,17,18,19,19,20,20,20,21,21,21,21,21,21,21,21
E01003346,EV motorcycles,Number,0,1,1,2,3,4,6,7,8,10,11,12,14,15,16,17,17,18,18,19,19,19,20,20,20,20,20,20,20,20
E01003347,EV motorcycles,Number,0,1,1,2,3,4,6,7,8,10,11,12,14,15,16,17,17,18,18,19,19,19,20,20,20,20,20,20,20,20
E01003348,EV motorcycles,Number,0,1,1,2,4,5,6,7,9,10,12,13,14,16,17,17,18,19,19,20,20,20,21,21,21,21,21,21,21,21
E01003349,EV motorcycles,Number,0,1,1,2,3,4,5,6,8,9,10,11,12,13,14,15,16,16,17,17,17,17,18,18,18,18,18,18,18,18
E01003350,EV motorcycles,Number,0,0,1,1,2,3,3,4,5,6,7,7,8,9,9,10,10,11,11,11,12,12,12,12,12,12,12,12,12,12
E01003351,EV motorcycles,Number,0,1,1,2,4,5,6,7,9,10,12,13,14,16,17,17,18,19,19,20,20,20,21,21,21,21,21,21,21,21
E01003352,EV motorcycles,Number,0,1,1,2,3,4,5,7,8,9,11,12,13,14,15,16,17,17,18,18,18,18,19,19,19,19,19,19,19,19
E01003353,EV motorcycles,Number,1,3,5,8,12,17,21,26,31,36,41,46,51,55,58,62,64,67,68,70,71,72,72,73,73,73,74,74,74,74
E01003354,EV motorcycles,Number,1,1,3,4,7,9,12,14,17,20,22,25,27,30,32,33,35,36,37,38,38,39,39,39,40,40,40,40,40,40
E01003355,EV motorcycles,Number,0,1,2,3,4,6,8,9,11,13,15,16,18,19,20,22,23,23,24,25,25,25,25,26,26,26,26,26,26,26
E01003356,EV motorcycles,Number,0,1,1,2,4,5,6,8,9,11,12,14,15,16,17,18,19,20,20,21,21,21,22,22,22,22,22,22,22,22
E01003357,EV motorcycles,Number,0,1,2,4,6,7,10,12,14,16,18,21,23,24,26,27,29,30,31,31,32,32,32,33,33,33,33,33,33,33
E01003358,EV motorcycles,Number,0,0,1,1,2,2,3,3,4,4,5,6,6,7,7,7,8,8,8,8,9,9,9,9,9,9,9,9,9,9
E01003359,EV motorcycles,Number,0,1,2,3,5,6,8,10,11,13,15,17,18,20,21,22,23,24,25,25,26,26,26,27,27,27,27,27,27,27
E01003360,EV motorcycles,Number,0,1,2,4,5,7,9,11,14,16,18,20,22,24,25,27,28,29,30,30,31,31,31,32,32,32,32,32,32,32
E01003361,EV motorcycles,Number,2,6,10,17,26,35,45,55,65,76,86,96,105,114,121,128,134,138,142,145,148,149,151,152,152,153,154,154,154,154
E01003362,EV motorcycles,Number,0,1,2,3,5,6,8,10,12,14,16,17,19,21,22,23,24,25,26,26,27,27,27,28,28,28,28,28,28,28
E01003363,EV motorcycles,Number,0,1,2,4,6,7,10,12,14,16,18,21,23,24,26,27,29,30,31,31,32,32,32,33,33,33,33,33,33,33
E01003364,EV motorcycles,Number,0,1,2,3,5,7,9,11,13,15,17,19,21,23,24,26,27,28,29,29,30,30,30,31,31,31,31,31,31,31
E01003365,EV motorcycles,Number,0,1,1,2,3,4,6,7,8,10,11,12,14,15,16,17,17,18,18,19,19,19,20,20,20,20,20,20,20,20
E01003366,EV motorcycles,Number,1,1,2,4,6,9,11,13,16,19,21,24,26,28,30,32,33,34,35,36,36,37,37,37,38,38,38,38,38,38
E01003367,EV motorcycles,Number,0,1,2,3,5,7,9,11,13,15,17,19,21,23,24,26,27,28,29,29,30,30,30,31,31,31,31,31,31,31
E01003368,EV motorcycles,Number,0,1,2,3,5,7,8,10,12,14,16,18,20,21,23,24,25,26,27,27,28,28,28,29,29,29,29,29,29,29
E01003369,EV motorcycles,Number,0,1,2,3,4,6,7,9,11,12,14,16,17,18,20,21,22,22,23,24,24,24,24,25,25,25,25,25,25,25
E01003370,EV motorcycles,Number,1,2,4,6,9,12,16,20,23,27,31,34,38,41,43,46,48,49,51,52,53,53,54,54,54,55,55,55,55,55
E01003371,EV motorcycles,Number,1,1,3,4,7,9,12,14,17,20,22,25,27,30,32,33,35,36,37,38,38,39,39,39,40,40,40,40,40,40
E01003372,EV motorcycles,Number,0,1,2,4,6,7,10,12,14,16,18,21,23,24,26,27,29,30,31,31,32,32,32,33,33,33,33,33,33,33
E01003373,EV motorcycles,Number,0,1,1,2,3,4,5,6,8,9,10,11,12,13,14,15,16,16,17,17,17,17,18,18,18,18,18,18,18,18
E01003374,EV motorcycles,Number,1,1,3,4,7,9,11,14,16,19,22,24,27,29,31,32,34,35,36,37,37,38,38,38,39,39,39,39,39,39
E01003375,EV motorcycles,Number,1,2,4,7,10,13,17,21,25,29,33,37,40,44,47,49,51,53,55,56,57,57,58,58,58,59,59,59,59,59
E01003376,EV motorcycles,Number,0,1,2,3,4,6,8,9,11,13,15,16,18,19,20,22,23,23,24,25,25,25,25,26,26,26,26,26,26,26
E01003377,EV motorcycles,Number,0,1,1,2,3,3,4,5,6,7,8,9,10,11,12,12,13,13,14,14,14,15,15,15,15,15,15,15,15,15
E01003378,EV motorcycles,Number,1,2,3,5,8,11,14,17,21,24,27,31,33,36,39,41,43,44,45,46,47,48,48,48,48,49,49,49,49,49
E01003379,EV motorcycles,Number,1,1,2,4,6,9,11,13,16,19,21,24,26,28,30,32,33,34,35,36,36,37,37,37,38,38,38,38,38,38
E01003380,EV motorcycles,Number,0,1,1,2,2,3,4,5,6,7,8,9,10,10,11,12,12,13,13,13,13,14,14,14,14,14,14,14,14,14
E01003381,EV motorcycles,Number,0,1,2,3,4,5,7,8,10,11,13,14,16,17,18,19,20,21,21,22,22,22,23,23,23,23,23,23,23,23
E01003382,EV motorcycles,Number,0,1,1,2,3,4,5,7,8,9,11,12,13,14,15,16,17,17,18,18,18,18,19,19,19,19,19,19,19,19
E01003383,EV motorcycles,Number,0,1,1,2,4,5,6,8,9,11,12,14,15,16,17,18,19,20,20,21,21,21,22,22,22,22,22,22,22,22
E01003384,EV motorcycles,Number,0,1,2,3,4,6,8,9,11,13,15,16,18,19,20,22,23,23,24,25,25,25,25,26,26,26,26,26,26,26
E01003385,EV motorcycles,Number,0,0,1,1,2,2,3,4,5,5,6,7,8,8,9,9,10,10,10,10,11,11,11,11,11,11,11,11,11,11
E01003386,EV motorcycles,Number,1,2,4,7,11,15,19,24,28,33,37,42,46,50,53,56,58,60,62,63,64,65,66,66,66,67,67,67,67,67
E01003387,EV motorcycles,Number,1,1,3,4,7,9,12,14,17,20,22,25,27,30,32,33,35,36,37,38,38,39,39,39,40,40,40,40,40,40
E01003388,EV motorcycles,Number,0,1,2,3,5,7,8,10,12,14,16,18,20,21,23,24,25,26,27,27,28,28,28,29,29,29,29,29,29,29
E01003389,EV motorcycles,Number,1,2,4,6,9,13,16,20,24,28,31,35,38,41,44,47,49,50,52,53,54,54,55,55,55,56,56,56,56,56
E01003390,EV motorcycles,Number,0,1,2,3,4,6,8,9,11,13,15,16,18,19,20,22,23,23,24,25,25,25,25,26,26,26,26,26,26,26
E01003391,EV motorcycles,Number,0,1,2,3,4,5,7,8,10,11,13,14,16,17,18,19,20,21,21,22,22,22,23,23,23,23,23,23,23,23
E01003392,EV motorcycles,Number,0,1,2,3,5,6,8,10,11,13,15,17,18,20,21,22,23,24,25,25,26,26,26,27,27,27,27,27,27,27
E01003393,EV motorcycles,Number,0,1,2,4,6,7,10,12,14,16,18,21,23,24,26,27,29,30,31,31,32,32,32,33,33,33,33,33,33,33
E01003394,EV motorcycles,Number,1,2,5,8,12,15,20,25,29,34,39,43,47,51,54,57,60,62,64,65,66,67,68,68,68,69,69,69,69,69
E01003395,EV motorcycles,Number,1,1,3,4,7,9,11,14,16,19,22,24,27,29,31,32,34,35,36,37,37,38,38,38,39,39,39,39,39,39
E01003396,EV motorcycles,Number,0,0,1,1,2,3,4,5,5,6,7,8,9,10,10,11,11,12,12,12,12,13,13,13,13,13,13,13,13,13
E01003397,EV motorcycles,Number,0,1,1,2,3,4,6,7,8,10,11,12,14,15,16,17,17,18,18,19,19,19,20,20,20,20,20,20,20,20
E01003398,EV motorcycles,Number,1,1,3,4,7,9,11,14,16,19,22,24,27,29,31,32,34,35,36,37,37,38,38,38,39,39,39,39,39,39
E01003399,EV motorcycles,Number,0,1,1,2,4,5,6,8,9,11,12,14,15,16,17,18,19,20,20,21,21,21,22,22,22,22,22,22,22,22
E01003400,EV motorcycles,Number,0,1,1,2,3,4,5,6,7,8,9,10,11,12,13,13,14,14,15,15,15,16,16,16,16,16,16,16,16,16
E01003401,EV motorcycles,Number,0,1,1,2,2,3,4,5,6,7,8,9,10,10,11,12,12,13,13,13,13,14,14,14,14,14,14,14,14,14
E01003402,EV motorcycles,Number,0,0,1,1,2,3,3,4,5,6,7,7,8,9,9,10,10,11,11,11,12,12,12,12,12,12,12,12,12,12
E01003403,EV motorcycles,Number,0,1,1,2,3,4,5,6,8,9,10,11,12,13,14,15,16,16,17,17,17,17,18,18,18,18,18,18,18,18
E01003404,EV motorcycles,Number,0,1,1,2,3,4,6,7,8,10,11,12,14,15,16,17,17,18,18,19,19,19,20,20,20,20,20,20,20,20
E01003405,EV motorcycles,Number,1,2,3,5,8,10,13,16,19,23,26,29,31,34,36,38,40,41,43,43,44,45,45,45,46,46,46,46,46,46
E01003406,EV motorcycles,Number,0,1,2,3,5,7,8,10,12,14,16,18,20,21,23,24,25,26,27,27,28,28,28,29,29,29,29,29,29,29
E01003407,EV motorcycles,Number,0,1,2,4,6,7,10,12,14,16,18,21,23,24,26,27,29,30,31,31,32,32,32,33,33,33,33,33,33,33
E01003408,EV motorcycles,Number,1,2,3,5,7,10,12,15,18,21,24,27,29,32,34,36,37,39,40,41,41,42,42,42,43,43,43,43,43,43
E01003409,EV motorcycles,Number,1,1,3,4,7,9,12,14,17,20,22,25,27,30,32,33,35,36,37,38,38,39,39,39,40,40,40,40,40,40
E01003410,EV motorcycles,Number,0,1,2,3,5,7,8,10,12,14,16,18,20,21,23,24,25,26,27,27,28,28,28,29,29,29,29,29,29,29
E01003411,EV motorcycles,Number,1,2,3,6,9,11,15,18,22,25,29,32,35,38,40,42,44,46,47,48,49,49,50,50,50,51,51,51,51,51
E01003412,EV motorcycles,Number,1,2,3,5,8,10,13,16,19,23,26,29,31,34,36,38,40,41,43,43,44,45,45,45,46,46,46,46,46,46
E01003413,EV motorcycles,Number,1,2,3,5,8,11,14,17,20,23,26,29,32,35,37,39,41,42,43,44,45,46,46,46,47,47,47,47,47,47
E01003414,EV motorcycles,Number,1,1,2,4,6,9,11,13,16,19,21,24,26,28,30,32,33,34,35,36,36,37,37,37,38,38,38,38,38,38
E01003415,EV motorcycles,Number,1,2,4,7,11,15,19,23,27,32,36,40,44,48,51,54,56,58,60,61,62,63,64,64,64,65,65,65,65,65
E01003416,EV motorcycles,Number,1,2,3,5,8,10,13,16,19,23,26,29,31,34,36,38,40,41,43,43,44,45,45,45,46,46,46,46,46,46
E01003417,EV motorcycles,Number,1,1,3,4,7,9,11,14,16,19,22,24,27,29,31,32,34,35,36,37,37,38,38,38,39,39,39,39,39,39
E01003418,EV motorcycles,Number,0,1,2,3,5,7,9,11,13,15,17,19,21,23,24,26,27,28,29,29,30,30,30,31,31,31,31,31,31,31
E01003419,EV motorcycles,Number,1,2,3,5,8,11,14,17,20,23,26,29,32,35,37,39,41,42,43,44,45,46,46,46,47,47,47,47,47,47
E01003420,EV motorcycles,Number,0,1,2,3,5,6,8,10,11,13,15,17,18,20,21,22,23,24,25,25,26,26,26,27,27,27,27,27,27,27
E01003421,EV motorcycles,Number,0,1,1,2,4,5,6,7,9,10,12,13,14,16,17,17,18,19,19,20,20,20,21,21,21,21,21,21,21,21
E01003422,EV motorcycles,Number,0,1,2,3,5,6,8,10,12,14,16,17,19,21,22,23,24,25,26,26,27,27,27,28,28,28,28,28,28,28
E01003423,EV motorcycles,Number,0,1,1,2,2,3,4,5,6,7,8,9,10,10,11,12,12,13,13,13,13,14,14,14,14,14,14,14,14,14
E01003424,EV motorcycles,Number,0,1,1,2,2,3,4,5,6,7,8,9,10,10,11,12,12,13,13,13,13,14,14,14,14,14,14,14,14,14
E01003425,EV motorcycles,Number,0,1,2,3,4,6,7,9,11,12,14,16,17,18,20,21,22,22,23,24,24,24,24,25,25,25,25,25,25,25
E01003426,EV motorcycles,Number,1,2,3,5,8,11,14,17,21,24,27,31,33,36,39,41,43,44,45,46,47,48,48,48,48,49,49,49,49,49
E01003427,EV motorcycles,Number,1,2,3,6,8,11,14,18,21,25,28,31,34,37,39,42,43,45,46,47,48,49,49,49,49,50,50,50,50,50
E01003428,EV motorcycles,Number,0,0,1,1,2,2,3,4,4,5,6,6,7,7,8,8,9,9,9,9,10,10,10,10,10,10,10,10,10,10
E01003429,EV motorcycles,Number,0,1,2,3,4,6,8,9,11,13,15,16,18,19,20,22,23,23,24,25,25,25,25,26,26,26,26,26,26,26
E01003430,EV motorcycles,Number,1,1,2,4,6,8,10,12,15,17,20,22,24,26,28,29,30,31,32,33,34,34,34,34,35,35,35,35,35,35
E01003431,EV motorcycles,Number,0,1,1,2,4,5,6,8,9,11,12,14,15,16,17,18,19,20,20,21,21,21,22,22,22,22,22,22,22,22
E01003432,EV motorcycles,Number,0,1,1,2,3,4,5,6,7,8,10,11,12,13,13,14,15,15,16,16,16,16,17,17,17,17,17,17,17,17
E01003433,EV motorcycles,Number,0,1,2,3,5,7,8,10,12,14,16,18,20,21,23,24,25,26,27,27,28,28,28,29,29,29,29,29,29,29
E01003434,EV motorcycles,Number,0,1,2,3,5,6,8,10,11,13,15,17,18,20,21,22,23,24,25,25,26,26,26,27,27,27,27,27,27,27
E01003435,EV motorcycles,Number,1,2,3,5,7,9,12,15,18,21,24,26,29,31,33,35,36,38,39,40,40,41,41,41,42,42,42,42,42,42
E01003436,EV motorcycles,Number,0,1,1,2,4,5,6,8,9,11,12,14,15,16,17,18,19,20,20,21,21,21,22,22,22,22,22,22,22,22
E01003437,EV motorcycles,Number,0,1,2,3,5,7,9,11,13,15,17,19,21,23,24,26,27,28,29,29,30,30,30,31,31,31,31,31,31,31
E01003438,EV motorcycles,Number,1,1,2,4,6,9,11,13,16,19,21,24,26,28,30,32,33,34,35,36,36,37,37,37,38,38,38,38,38,38
E01003439,EV motorcycles,Number,0,1,2,3,5,7,9,11,13,15,17,19,21,22,24,25,26,27,28,28,29,29,29,30,30,30,30,30,30,30
E01003440,EV motorcycles,Number,1,1,2,4,6,8,11,13,16,18,21,23,25,27,29,31,32,33,34,35,35,36,36,36,37,37,37,37,37,37
E01003441,EV motorcycles,Number,1,2,3,5,8,11,14,17,20,23,26,29,32,35,37,39,41,42,43,44,45,46,46,46,47,47,47,47,47,47
E01003442,EV motorcycles,Number,0,1,2,3,5,7,9,11,13,15,17,19,21,22,24,25,26,27,28,28,29,29,29,30,30,30,30,30,30,30
E01003443,EV motorcycles,Number,0,1,2,3,4,5,7,9,10,12,13,15,16,18,19,20,21,22,22,23,23,23,23,24,24,24,24,24,24,24
E01003444,EV motorcycles,Number,0,1,1,2,4,5,6,8,9,11,12,14,15,16,17,18,19,20,20,21,21,21,22,22,22,22,22,22,22,22
E01003445,EV motorcycles,Number,0,1,1,2,3,4,5,7,8,9,11,12,13,14,15,16,17,17,18,18,18,18,19,19,19,19,19,19,19,19
E01003446,EV motorcycles,Number,0,1,2,3,5,7,9,11,13,15,17,19,21,23,24,26,27,28,29,29,30,30,30,31,31,31,31,31,31,31
E01003447,EV motorcycles,Number,0,1,1,2,3,4,5,6,7,8,10,11,12,13,13,14,15,15,16,16,16,16,17,17,17,17,17,17,17,17
E01003448,EV motorcycles,Number,0,1,2,4,6,7,10,12,14,16,18,21,23,24,26,27,29,30,31,31,32,32,32,33,33,33,33,33,33,33
E01003449,EV motorcycles,Number,0,1,2,4,5,7,9,11,14,16,18,20,22,24,25,27,28,29,30,30,31,31,31,32,32,32,32,32,32,32
E01003450,EV motorcycles,Number,0,1,2,3,5,6,8,10,12,14,16,17,19,21,22,23,24,25,26,26,27,27,27,28,28,28,28,28,28,28
E01003451,EV motorcycles,Number,1,2,3,6,9,11,15,18,22,25,29,32,35,38,40,42,44,46,47,48,49,49,50,50,50,51,51,51,51,51
E01003452,EV motorcycles,Number,1,2,3,5,7,10,13,16,19,22,25,27,30,33,35,37,38,40,41,42,42,43,43,43,44,44,44,44,44,44
E01003453,EV motorcycles,Number,1,1,2,4,6,9,11,13,16,19,21,24,26,28,30,32,33,34,35,36,36,37,37,37,38,38,38,38,38,38
E01003454,EV motorcycles,Number,0,1,2,3,4,6,7,9,11,12,14,16,17,18,20,21,22,22,23,24,24,24,24,25,25,25,25,25,25,25
E01003455,EV motorcycles,Number,1,2,3,5,7,9,12,15,18,21,24,26,29,31,33,35,36,38,39,40,40,41,41,41,42,42,42,42,42,42
E01003456,EV motorcycles,Number,0,1,2,3,4,5,7,8,10,11,13,14,16,17,18,19,20,21,21,22,22,22,23,23,23,23,23,23,23,23
E01003457,EV motorcycles,Number,0,1,1,2,3,4,5,6,7,8,9,10,11,12,13,13,14,14,15,15,15,16,16,16,16,16,16,16,16,16
E01003458,EV motorcycles,Number,0,1,1,2,3,4,5,6,7,8,9,10,11,12,13,13,14,14,15,15,15,16,16,16,16,16,16,16,16,16
E01003459,EV motorcycles,Number,0,1,2,3,4,5,7,8,10,11,13,14,16,17,18,19,20,21,21,22,22,22,23,23,23,23,23,23,23,23
E01003460,EV motorcycles,Number,0,1,2,3,5,6,8,10,11,13,15,17,18,20,21,22,23,24,25,25,26,26,26,27,27,27,27,27,27,27
E01003461,EV motorcycles,Number,0,1,2,3,4,5,7,8,10,11,13,14,16,17,18,19,20,21,21,22,22,22,23,23,23,23,23,23,23,23
E01003462,EV motorcycles,Number,0,1,1,2,3,4,5,7,8,9,11,12,13,14,15,16,17,17,18,18,18,18,19,19,19,19,19,19,19,19
E01003463,EV motorcycles,Number,0,1,1,2,3,4,5,6,7,8,10,11,12,13,13,14,15,15,16,16,16,16,17,17,17,17,17,17,17,17
E01003464,EV motorcycles,Number,1,2,3,5,7,10,12,15,18,21,24,27,29,32,34,36,37,39,40,41,41,42,42,42,43,43,43,43,43,43
E01003465,EV motorcycles,Number,0,1,1,2,3,4,6,7,8,10,11,12,14,15,16,17,17,18,18,19,19,19,20,20,20,20,20,20,20,20
E01003466,EV motorcycles,Number,0,1,1,2,3,4,5,7,8,9,11,12,13,14,15,16,17,17,18,18,18,18,19,19,19,19,19,19,19,19
E01003467,EV motorcycles,Number,0,1,2,3,5,6,8,10,12,14,16,17,19,21,22,23,24,25,26,26,27,27,27,28,28,28,28,28,28,28
E01003468,EV motorcycles,Number,0,1,2,3,5,7,8,10,12,14,16,18,20,21,23,24,25,26,27,27,28,28,28,29,29,29,29,29,29,29
E01003469,EV motorcycles,Number,0,1,2,3,4,5,7,9,10,12,13,15,16,18,19,20,21,22,22,23,23,23,23,24,24,24,24,24,24,24
E01003470,EV motorcycles,Number,0,1,2,4,5,7,9,11,14,16,18,20,22,24,25,27,28,29,30,30,31,31,31,32,32,32,32,32,32,32
E01003471,EV motorcycles,Number,0,1,2,4,6,8,10,12,14,17,19,21,23,25,27,28,30,31,31,32,33,33,33,33,34,34,34,34,34,34
E01003472,EV motorcycles,Number,0,1,1,2,3,4,5,6,7,8,10,11,12,13,13,14,15,15,16,16,16,16,17,17,17,17,17,17,17,17
E01003473,EV motorcycles,Number,0,1,1,2,3,4,5,6,8,9,10,11,12,13,14,15,16,16,17,17,17,17,18,18,18,18,18,18,18,18
E01003474,EV motorcycles,Number,0,1,2,3,4,5,7,9,10,12,13,15,16,18,19,20,21,22,22,23,23,23,23,24,24,24,24,24,24,24
E01003475,EV motorcycles,Number,1,2,3,5,7,10,13,16,19,22,25,27,30,33,35,37,38,40,41,42,42,43,43,43,44,44,44,44,44,44
E01003476,EV motorcycles,Number,0,1,1,2,4,5,6,7,9,10,12,13,14,16,17,17,18,19,19,20,20,20,21,21,21,21,21,21,21,21
E01003477,EV motorcycles,Number,0,1,1,2,3,3,4,5,6,7,8,9,10,11,12,12,13,13,14,14,14,15,15,15,15,15,15,15,15,15
E01003478,EV motorcycles,Number,1,2,4,6,9,12,16,20,23,27,31,34,38,41,43,46,48,49,51,52,53,53,54,54,54,55,55,55,55,55
E01003479,EV motorcycles,Number,0,1,1,2,3,4,5,6,7,8,10,11,12,13,13,14,15,15,16,16,16,16,17,17,17,17,17,17,17,17
E01003480,EV motorcycles,Number,0,0,1,1,2,3,4,5,5,6,7,8,9,10,10,11,11,12,12,12,12,13,13,13,13,13,13,13,13,13
E01003481,EV motorcycles,Number,0,1,1,2,3,3,4,5,6,7,8,9,10,11,12,12,13,13,14,14,14,15,15,15,15,15,15,15,15,15
E01003482,EV motorcycles,Number,1,2,4,6,9,12,16,20,23,27,31,34,38,41,43,46,48,49,51,52,53,53,54,54,54,55,55,55,55,55
E01003483,EV motorcycles,Number,0,0,1,1,2,3,3,4,5,6,7,7,8,9,9,10,10,11,11,11,12,12,12,12,12,12,12,12,12,12
E01003484,EV motorcycles,Number,0,1,1,2,2,3,4,5,6,7,8,9,10,10,11,12,12,13,13,13,13,14,14,14,14,14,14,14,14,14
E01003485,EV motorcycles,Number,0,1,2,3,4,6,7,9,11,12,14,16,17,18,20,21,22,22,23,24,24,24,24,25,25,25,25,25,25,25
E01003486,EV motorcycles,Number,0,0,0,0,0,0,0,0,0,0,0,0,0,0,0,0,0,0,0,0,0,0,0,0,0,0,0,0,0,0
E01003487,EV motorcycles,Number,0,0,1,1,1,2,2,3,3,4,4,5,5,6,6,7,7,7,7,8,8,8,8,8,8,8,8,8,8,8
E01003488,EV motorcycles,Number,0,1,1,2,2,3,4,5,6,7,8,9,10,10,11,12,12,13,13,13,13,14,14,14,14,14,14,14,14,14
E01003489,EV motorcycles,Number,0,1,2,3,5,6,8,10,11,13,15,17,18,20,21,22,23,24,25,25,26,26,26,27,27,27,27,27,27,27
E01003490,EV motorcycles,Number,0,1,1,2,3,4,5,7,8,9,11,12,13,14,15,16,17,17,18,18,18,18,19,19,19,19,19,19,19,19
E01003491,EV motorcycles,Number,0,0,1,1,2,2,3,4,5,5,6,7,8,8,9,9,10,10,10,10,11,11,11,11,11,11,11,11,11,11
E01003492,EV motorcycles,Number,1,1,2,4,6,8,10,12,15,17,20,22,24,26,28,29,30,31,32,33,34,34,34,34,35,35,35,35,35,35
E01003493,EV motorcycles,Number,1,1,2,4,6,8,10,12,15,17,20,22,24,26,28,29,30,31,32,33,34,34,34,34,35,35,35,35,35,35
E01003494,EV motorcycles,Number,0,1,1,2,4,5,6,7,9,10,12,13,14,16,17,17,18,19,19,20,20,20,21,21,21,21,21,21,21,21
E01003495,EV motorcycles,Number,0,0,1,1,2,2,3,4,5,5,6,7,8,8,9,9,10,10,10,10,11,11,11,11,11,11,11,11,11,11
E01003496,EV motorcycles,Number,0,1,1,2,3,4,5,7,8,9,11,12,13,14,15,16,17,17,18,18,18,18,19,19,19,19,19,19,19,19
E01003497,EV motorcycles,Number,0,1,1,2,3,3,4,5,6,7,8,9,10,11,12,12,13,13,14,14,14,15,15,15,15,15,15,15,15,15
E01003498,EV motorcycles,Number,0,1,2,3,4,5,7,9,10,12,13,15,16,18,19,20,21,22,22,23,23,23,23,24,24,24,24,24,24,24
E01003499,EV motorcycles,Number,0,1,1,2,4,5,6,7,9,10,12,13,14,16,17,17,18,19,19,20,20,20,21,21,21,21,21,21,21,21
E01003500,EV motorcycles,Number,0,1,2,3,5,7,9,11,13,15,17,19,21,22,24,25,26,27,28,28,29,29,29,30,30,30,30,30,30,30
E01003501,EV motorcycles,Number,1,1,2,4,6,8,10,13,15,18,20,22,25,27,28,30,31,32,33,34,35,35,35,35,36,36,36,36,36,36
E01003502,EV motorcycles,Number,1,1,2,4,6,8,10,13,15,18,20,22,25,27,28,30,31,32,33,34,35,35,35,35,36,36,36,36,36,36
E01003503,EV motorcycles,Number,0,1,2,3,4,6,7,9,11,12,14,16,17,18,20,21,22,22,23,24,24,24,24,25,25,25,25,25,25,25
E01003506,EV motorcycles,Number,0,1,1,2,3,4,5,6,7,8,10,11,12,13,13,14,15,15,16,16,16,16,17,17,17,17,17,17,17,17
E01003507,EV motorcycles,Number,0,1,1,2,4,5,6,7,9,10,12,13,14,16,17,17,18,19,19,20,20,20,21,21,21,21,21,21,21,21
E01003508,EV motorcycles,Number,0,1,2,3,5,6,8,10,12,14,16,17,19,21,22,23,24,25,26,26,27,27,27,28,28,28,28,28,28,28
E01003509,EV motorcycles,Number,0,1,2,4,6,8,10,12,14,17,19,21,23,25,27,28,30,31,31,32,33,33,33,33,34,34,34,34,34,34
E01003511,EV motorcycles,Number,0,1,1,2,3,4,5,7,8,9,11,12,13,14,15,16,17,17,18,18,18,18,19,19,19,19,19,19,19,19
E01003512,EV motorcycles,Number,0,0,1,1,2,3,4,5,5,6,7,8,9,10,10,11,11,12,12,12,12,13,13,13,13,13,13,13,13,13
E01003513,EV motorcycles,Number,0,1,2,3,5,7,9,11,13,15,17,19,21,22,24,25,26,27,28,28,29,29,29,30,30,30,30,30,30,30
E01003514,EV motorcycles,Number,0,1,1,2,3,4,5,6,7,8,9,10,11,12,13,13,14,14,15,15,15,16,16,16,16,16,16,16,16,16
E01003515,EV motorcycles,Number,0,1,2,4,5,7,9,11,14,16,18,20,22,24,25,27,28,29,30,30,31,31,31,32,32,32,32,32,32,32
E01003516,EV motorcycles,Number,0,0,1,1,2,3,3,4,5,6,7,7,8,9,9,10,10,11,11,11,12,12,12,12,12,12,12,12,12,12
E01003517,EV motorcycles,Number,0,1,2,3,5,7,9,11,13,15,17,19,21,23,24,26,27,28,29,29,30,30,30,31,31,31,31,31,31,31
E01003518,EV motorcycles,Number,0,1,2,3,5,7,9,11,13,15,17,19,21,23,24,26,27,28,29,29,30,30,30,31,31,31,31,31,31,31
E01003519,EV motorcycles,Number,0,1,1,2,3,3,4,5,6,7,8,9,10,11,12,12,13,13,14,14,14,15,15,15,15,15,15,15,15,15
E01003520,EV motorcycles,Number,0,1,1,2,3,4,5,6,7,8,10,11,12,13,13,14,15,15,16,16,16,16,17,17,17,17,17,17,17,17
E01003521,EV motorcycles,Number,1,2,3,6,9,11,15,18,22,25,29,32,35,38,40,42,44,46,47,48,49,49,50,50,50,51,51,51,51,51
E01003522,EV motorcycles,Number,0,0,1,1,2,3,4,5,5,6,7,8,9,10,10,11,11,12,12,12,12,13,13,13,13,13,13,13,13,13
E01003523,EV motorcycles,Number,0,0,1,1,2,2,3,4,4,5,6,6,7,7,8,8,9,9,9,9,10,10,10,10,10,10,10,10,10,10
E01003524,EV motorcycles,Number,0,0,1,1,2,3,4,5,5,6,7,8,9,10,10,11,11,12,12,12,12,13,13,13,13,13,13,13,13,13
E01003525,EV motorcycles,Number,0,1,1,2,3,4,6,7,8,10,11,12,14,15,16,17,17,18,18,19,19,19,20,20,20,20,20,20,20,20
E01003526,EV motorcycles,Number,0,1,1,2,3,4,6,7,8,10,11,12,14,15,16,17,17,18,18,19,19,19,20,20,20,20,20,20,20,20
E01003527,EV motorcycles,Number,0,1,2,3,5,6,8,10,12,14,16,17,19,21,22,23,24,25,26,26,27,27,27,28,28,28,28,28,28,28
E01003528,EV motorcycles,Number,0,0,1,1,2,2,3,4,4,5,6,6,7,7,8,8,9,9,9,9,10,10,10,10,10,10,10,10,10,10
E01003529,EV motorcycles,Number,0,1,1,2,3,4,5,6,7,8,10,11,12,13,13,14,15,15,16,16,16,16,17,17,17,17,17,17,17,17
E01003530,EV motorcycles,Number,0,0,1,1,2,3,4,5,5,6,7,8,9,10,10,11,11,12,12,12,12,13,13,13,13,13,13,13,13,13
E01003531,EV motorcycles,Number,0,1,1,2,4,5,6,8,9,11,12,14,15,16,17,18,19,20,20,21,21,21,22,22,22,22,22,22,22,22
E01003532,EV motorcycles,Number,0,1,1,2,3,4,6,7,8,10,11,12,14,15,16,17,17,18,18,19,19,19,20,20,20,20,20,20,20,20
E01003533,EV motorcycles,Number,0,1,1,2,4,5,6,8,9,11,12,14,15,16,17,18,19,20,20,21,21,21,22,22,22,22,22,22,22,22
E01003534,EV motorcycles,Number,0,1,1,2,3,4,5,6,7,8,10,11,12,13,13,14,15,15,16,16,16,16,17,17,17,17,17,17,17,17
E01003535,EV motorcycles,Number,1,2,3,5,7,10,12,15,18,21,24,27,29,32,34,36,37,39,40,41,41,42,42,42,43,43,43,43,43,43
E01003536,EV motorcycles,Number,0,1,1,2,3,4,5,6,7,8,10,11,12,13,13,14,15,15,16,16,16,16,17,17,17,17,17,17,17,17
E01003537,EV motorcycles,Number,0,1,2,3,5,6,8,10,11,13,15,17,18,20,21,22,23,24,25,25,26,26,26,27,27,27,27,27,27,27
E01003538,EV motorcycles,Number,0,1,1,2,3,4,5,6,7,8,10,11,12,13,13,14,15,15,16,16,16,16,17,17,17,17,17,17,17,17
E01003539,EV motorcycles,Number,0,0,1,1,2,3,4,5,5,6,7,8,9,10,10,11,11,12,12,12,12,13,13,13,13,13,13,13,13,13
E01003540,EV motorcycles,Number,0,0,1,1,2,3,4,5,5,6,7,8,9,10,10,11,11,12,12,12,12,13,13,13,13,13,13,13,13,13
E01003541,EV motorcycles,Number,0,1,1,2,3,4,6,7,8,10,11,12,14,15,16,17,17,18,18,19,19,19,20,20,20,20,20,20,20,20
E01003542,EV motorcycles,Number,0,0,1,1,2,3,4,5,5,6,7,8,9,10,10,11,11,12,12,12,12,13,13,13,13,13,13,13,13,13
E01003543,EV motorcycles,Number,0,1,2,3,4,6,7,9,11,12,14,16,17,18,20,21,22,22,23,24,24,24,24,25,25,25,25,25,25,25
E01003544,EV motorcycles,Number,0,1,1,2,3,3,4,5,6,7,8,9,10,11,12,12,13,13,14,14,14,15,15,15,15,15,15,15,15,15
E01003545,EV motorcycles,Number,0,0,1,1,2,3,4,5,5,6,7,8,9,10,10,11,11,12,12,12,12,13,13,13,13,13,13,13,13,13
E01003546,EV motorcycles,Number,1,1,2,4,6,8,11,13,16,18,21,23,25,27,29,31,32,33,34,35,35,36,36,36,37,37,37,37,37,37
E01003547,EV motorcycles,Number,0,1,1,2,4,5,6,8,9,11,12,14,15,16,17,18,19,20,20,21,21,21,22,22,22,22,22,22,22,22
E01003548,EV motorcycles,Number,0,1,2,3,5,7,9,11,13,15,17,19,21,23,24,26,27,28,29,29,30,30,30,31,31,31,31,31,31,31
E01003549,EV motorcycles,Number,0,1,1,2,3,4,5,7,8,9,11,12,13,14,15,16,17,17,18,18,18,18,19,19,19,19,19,19,19,19
E01003550,EV motorcycles,Number,0,0,1,1,2,3,3,4,5,6,7,7,8,9,9,10,10,11,11,11,12,12,12,12,12,12,12,12,12,12
E01003551,EV motorcycles,Number,0,0,1,1,2,2,3,3,4,4,5,6,6,7,7,7,8,8,8,8,9,9,9,9,9,9,9,9,9,9
E01003552,EV motorcycles,Number,1,1,2,4,6,8,10,13,15,18,20,22,25,27,28,30,31,32,33,34,35,35,35,35,36,36,36,36,36,36
E01003553,EV motorcycles,Number,0,1,1,2,3,4,5,7,8,9,11,12,13,14,15,16,17,17,18,18,18,18,19,19,19,19,19,19,19,19
E01003554,EV motorcycles,Number,0,1,1,2,3,4,5,6,7,8,9,10,11,12,13,13,14,14,15,15,15,16,16,16,16,16,16,16,16,16
E01003555,EV motorcycles,Number,0,1,1,2,3,4,5,6,8,9,10,11,12,13,14,15,16,16,17,17,17,17,18,18,18,18,18,18,18,18
E01003556,EV motorcycles,Number,1,2,3,5,8,11,14,17,20,23,26,29,32,35,37,39,41,42,43,44,45,46,46,46,47,47,47,47,47,47
E01003557,EV motorcycles,Number,0,1,2,3,5,6,8,10,11,13,15,17,18,20,21,22,23,24,25,25,26,26,26,27,27,27,27,27,27,27
E01003558,EV motorcycles,Number,0,1,2,3,4,5,7,9,10,12,13,15,16,18,19,20,21,22,22,23,23,23,23,24,24,24,24,24,24,24
E01003559,EV motorcycles,Number,0,1,1,2,3,4,6,7,8,10,11,12,14,15,16,17,17,18,18,19,19,19,20,20,20,20,20,20,20,20
E01003560,EV motorcycles,Number,0,1,1,2,3,4,6,7,8,10,11,12,14,15,16,17,17,18,18,19,19,19,20,20,20,20,20,20,20,20
E01003561,EV motorcycles,Number,0,1,1,2,4,5,6,7,9,10,12,13,14,16,17,17,18,19,19,20,20,20,21,21,21,21,21,21,21,21
E01003562,EV motorcycles,Number,0,1,2,3,4,6,7,9,11,12,14,16,17,18,20,21,22,22,23,24,24,24,24,25,25,25,25,25,25,25
E01003563,EV motorcycles,Number,0,1,1,2,3,4,5,7,8,9,11,12,13,14,15,16,17,17,18,18,18,18,19,19,19,19,19,19,19,19
E01003564,EV motorcycles,Number,0,1,2,3,5,7,9,11,13,15,17,19,21,23,24,26,27,28,29,29,30,30,30,31,31,31,31,31,31,31
E01003565,EV motorcycles,Number,0,1,1,2,4,5,6,8,9,11,12,14,15,16,17,18,19,20,20,21,21,21,22,22,22,22,22,22,22,22
E01003566,EV motorcycles,Number,0,1,1,2,3,4,6,7,8,10,11,12,14,15,16,17,17,18,18,19,19,19,20,20,20,20,20,20,20,20
E01003567,EV motorcycles,Number,0,1,2,3,5,6,8,10,12,14,16,17,19,21,22,23,24,25,26,26,27,27,27,28,28,28,28,28,28,28
E01003568,EV motorcycles,Number,0,1,2,3,4,6,8,9,11,13,15,16,18,19,20,22,23,23,24,25,25,25,25,26,26,26,26,26,26,26
E01003569,EV motorcycles,Number,1,2,3,5,8,11,14,17,21,24,27,31,33,36,39,41,43,44,45,46,47,48,48,48,48,49,49,49,49,49
E01003570,EV motorcycles,Number,0,1,2,4,6,7,10,12,14,16,18,21,23,24,26,27,29,30,31,31,32,32,32,33,33,33,33,33,33,33
E01003571,EV motorcycles,Number,0,1,2,3,4,6,8,9,11,13,15,16,18,19,20,22,23,23,24,25,25,25,25,26,26,26,26,26,26,26
E01003572,EV motorcycles,Number,0,1,1,2,4,5,6,8,9,11,12,14,15,16,17,18,19,20,20,21,21,21,22,22,22,22,22,22,22,22
E01003573,EV motorcycles,Number,0,1,2,3,4,5,7,9,10,12,13,15,16,18,19,20,21,22,22,23,23,23,23,24,24,24,24,24,24,24
E01003574,EV motorcycles,Number,0,1,2,4,6,8,10,12,14,17,19,21,23,25,27,28,30,31,31,32,33,33,33,33,34,34,34,34,34,34
E01003575,EV motorcycles,Number,0,0,0,1,1,1,2,2,3,3,3,4,4,4,5,5,5,5,6,6,6,6,6,6,6,6,6,6,6,6
E01003576,EV motorcycles,Number,0,1,1,2,3,4,5,6,7,8,10,11,12,13,13,14,15,15,16,16,16,16,17,17,17,17,17,17,17,17
E01003577,EV motorcycles,Number,0,0,1,1,2,2,3,4,4,5,6,6,7,7,8,8,9,9,9,9,10,10,10,10,10,10,10,10,10,10
E01003578,EV motorcycles,Number,0,1,1,2,4,5,6,7,9,10,12,13,14,16,17,17,18,19,19,20,20,20,21,21,21,21,21,21,21,21
E01003579,EV motorcycles,Number,0,0,1,1,2,2,3,4,5,5,6,7,8,8,9,9,10,10,10,10,11,11,11,11,11,11,11,11,11,11
E01003580,EV motorcycles,Number,0,0,1,1,2,3,4,5,5,6,7,8,9,10,10,11,11,12,12,12,12,13,13,13,13,13,13,13,13,13
E01003581,EV motorcycles,Number,0,0,1,1,2,3,4,5,5,6,7,8,9,10,10,11,11,12,12,12,12,13,13,13,13,13,13,13,13,13
E01003582,EV motorcycles,Number,0,1,1,2,4,5,6,7,9,10,12,13,14,16,17,17,18,19,19,20,20,20,21,21,21,21,21,21,21,21
E01003583,EV motorcycles,Number,0,0,1,1,1,2,2,3,3,4,4,5,5,6,6,7,7,7,7,8,8,8,8,8,8,8,8,8,8,8
E01003584,EV motorcycles,Number,0,1,2,3,4,5,7,8,10,11,13,14,16,17,18,19,20,21,21,22,22,22,23,23,23,23,23,23,23,23
E01003585,EV motorcycles,Number,0,1,1,2,3,4,5,6,7,8,10,11,12,13,13,14,15,15,16,16,16,16,17,17,17,17,17,17,17,17
E01003586,EV motorcycles,Number,0,1,2,3,4,6,8,9,11,13,15,16,18,19,20,22,23,23,24,25,25,25,25,26,26,26,26,26,26,26
E01003587,EV motorcycles,Number,0,1,1,2,3,4,5,6,8,9,10,11,12,13,14,15,16,16,17,17,17,17,18,18,18,18,18,18,18,18
E01003588,EV motorcycles,Number,0,1,1,2,3,4,6,7,8,10,11,12,14,15,16,17,17,18,18,19,19,19,20,20,20,20,20,20,20,20
E01003589,EV motorcycles,Number,0,1,2,3,4,5,7,9,10,12,13,15,16,18,19,20,21,22,22,23,23,23,23,24,24,24,24,24,24,24
E01003590,EV motorcycles,Number,0,1,1,2,3,4,5,6,7,8,10,11,12,13,13,14,15,15,16,16,16,16,17,17,17,17,17,17,17,17
E01003591,EV motorcycles,Number,0,1,2,3,4,5,7,8,10,11,13,14,16,17,18,19,20,21,21,22,22,22,23,23,23,23,23,23,23,23
E01003592,EV motorcycles,Number,0,1,1,2,3,4,5,7,8,9,11,12,13,14,15,16,17,17,18,18,18,18,19,19,19,19,19,19,19,19
E01003593,EV motorcycles,Number,0,0,1,1,2,2,3,4,4,5,6,6,7,7,8,8,9,9,9,9,10,10,10,10,10,10,10,10,10,10
E01003594,EV motorcycles,Number,0,1,1,2,3,4,5,6,7,8,9,10,11,12,13,13,14,14,15,15,15,16,16,16,16,16,16,16,16,16
E01003595,EV motorcycles,Number,0,1,1,2,2,3,4,5,6,7,8,9,10,10,11,12,12,13,13,13,13,14,14,14,14,14,14,14,14,14
E01003596,EV motorcycles,Number,0,0,1,1,2,3,4,5,5,6,7,8,9,10,10,11,11,12,12,12,12,13,13,13,13,13,13,13,13,13
E01003597,EV motorcycles,Number,0,1,1,2,2,3,4,5,6,7,8,9,10,10,11,12,12,13,13,13,13,14,14,14,14,14,14,14,14,14
E01003598,EV motorcycles,Number,0,1,1,2,3,4,5,6,7,8,9,10,11,12,13,13,14,14,15,15,15,16,16,16,16,16,16,16,16,16
E01003599,EV motorcycles,Number,0,0,1,1,2,2,3,4,4,5,6,6,7,7,8,8,9,9,9,9,10,10,10,10,10,10,10,10,10,10
E01003600,EV motorcycles,Number,0,0,1,1,2,3,3,4,5,6,7,7,8,9,9,10,10,11,11,11,12,12,12,12,12,12,12,12,12,12
E01003601,EV motorcycles,Number,0,1,2,3,5,7,9,11,13,15,17,19,21,23,24,26,27,28,29,29,30,30,30,31,31,31,31,31,31,31
E01003602,EV motorcycles,Number,0,0,1,1,2,3,4,5,5,6,7,8,9,10,10,11,11,12,12,12,12,13,13,13,13,13,13,13,13,13
E01003603,EV motorcycles,Number,0,1,1,2,3,4,5,7,8,9,11,12,13,14,15,16,17,17,18,18,18,18,19,19,19,19,19,19,19,19
E01003604,EV motorcycles,Number,0,0,1,1,2,3,4,5,5,6,7,8,9,10,10,11,11,12,12,12,12,13,13,13,13,13,13,13,13,13
E01003605,EV motorcycles,Number,0,1,1,2,3,4,5,6,7,8,9,10,11,12,13,13,14,14,15,15,15,16,16,16,16,16,16,16,16,16
E01003606,EV motorcycles,Number,0,1,2,3,5,7,9,11,13,15,17,19,21,23,24,26,27,28,29,29,30,30,30,31,31,31,31,31,31,31
E01003607,EV motorcycles,Number,0,1,1,2,3,4,6,7,8,10,11,12,14,15,16,17,17,18,18,19,19,19,20,20,20,20,20,20,20,20
E01003608,EV motorcycles,Number,0,1,2,3,5,7,9,11,13,15,17,19,21,22,24,25,26,27,28,28,29,29,29,30,30,30,30,30,30,30
E01003609,EV motorcycles,Number,1,2,4,6,10,13,17,21,25,29,32,36,40,43,46,48,50,52,54,55,56,56,57,57,57,58,58,58,58,58
E01003611,EV motorcycles,Number,0,0,1,1,2,3,3,4,5,6,7,7,8,9,9,10,10,11,11,11,12,12,12,12,12,12,12,12,12,12
E01003615,EV motorcycles,Number,0,1,1,2,3,4,5,7,8,9,11,12,13,14,15,16,17,17,18,18,18,18,19,19,19,19,19,19,19,19
E01003616,EV motorcycles,Number,0,0,1,1,2,2,3,3,4,4,5,6,6,7,7,7,8,8,8,8,9,9,9,9,9,9,9,9,9,9
E01003617,EV motorcycles,Number,0,1,1,2,4,5,6,8,9,11,12,14,15,16,17,18,19,20,20,21,21,21,22,22,22,22,22,22,22,22
E01003618,EV motorcycles,Number,0,1,1,2,4,5,6,8,9,11,12,14,15,16,17,18,19,20,20,21,21,21,22,22,22,22,22,22,22,22
E01003619,EV motorcycles,Number,0,0,1,1,2,3,4,5,5,6,7,8,9,10,10,11,11,12,12,12,12,13,13,13,13,13,13,13,13,13
E01003621,EV motorcycles,Number,0,0,0,1,1,1,2,2,3,3,3,4,4,4,5,5,5,5,6,6,6,6,6,6,6,6,6,6,6,6
E01003622,EV motorcycles,Number,0,1,1,2,3,4,5,6,8,9,10,11,12,13,14,15,16,16,17,17,17,17,18,18,18,18,18,18,18,18
E01003623,EV motorcycles,Number,0,0,1,1,2,3,4,5,5,6,7,8,9,10,10,11,11,12,12,12,12,13,13,13,13,13,13,13,13,13
E01003624,EV motorcycles,Number,0,0,0,1,1,1,2,2,3,3,3,4,4,4,5,5,5,5,6,6,6,6,6,6,6,6,6,6,6,6
E01003625,EV motorcycles,Number,0,0,1,1,2,2,3,4,4,5,6,6,7,7,8,8,9,9,9,9,10,10,10,10,10,10,10,10,10,10
E01003626,EV motorcycles,Number,0,0,0,1,1,1,1,2,2,2,3,3,3,4,4,4,4,4,5,5,5,5,5,5,5,5,5,5,5,5
E01003627,EV motorcycles,Number,0,1,1,2,3,4,5,6,7,8,9,10,11,12,13,13,14,14,15,15,15,16,16,16,16,16,16,16,16,16
E01003628,EV motorcycles,Number,0,0,1,1,2,2,3,4,5,5,6,7,8,8,9,9,10,10,10,10,11,11,11,11,11,11,11,11,11,11
E01003629,EV motorcycles,Number,0,1,1,2,3,4,5,6,7,8,10,11,12,13,13,14,15,15,16,16,16,16,17,17,17,17,17,17,17,17
E01003630,EV motorcycles,Number,0,1,1,2,3,4,6,7,8,10,11,12,14,15,16,17,17,18,18,19,19,19,20,20,20,20,20,20,20,20
E01003631,EV motorcycles,Number,0,0,1,1,2,2,3,4,4,5,6,6,7,7,8,8,9,9,9,9,10,10,10,10,10,10,10,10,10,10
E01003632,EV motorcycles,Number,0,1,1,2,4,5,6,8,9,11,12,14,15,16,17,18,19,20,20,21,21,21,22,22,22,22,22,22,22,22
E01003633,EV motorcycles,Number,0,1,1,2,3,4,5,6,7,8,9,10,11,12,13,13,14,14,15,15,15,16,16,16,16,16,16,16,16,16
E01003634,EV motorcycles,Number,0,0,1,1,2,2,3,4,5,5,6,7,8,8,9,9,10,10,10,10,11,11,11,11,11,11,11,11,11,11
E01003635,EV motorcycles,Number,0,1,2,3,4,5,7,8,10,11,13,14,16,17,18,19,20,21,21,22,22,22,23,23,23,23,23,23,23,23
E01003636,EV motorcycles,Number,0,0,1,1,2,2,3,4,5,5,6,7,8,8,9,9,10,10,10,10,11,11,11,11,11,11,11,11,11,11
E01003637,EV motorcycles,Number,0,1,1,2,3,4,5,6,7,8,10,11,12,13,13,14,15,15,16,16,16,16,17,17,17,17,17,17,17,17
E01003638,EV motorcycles,Number,0,1,1,2,2,3,4,5,6,7,8,9,10,10,11,12,12,13,13,13,13,14,14,14,14,14,14,14,14,14
E01003639,EV motorcycles,Number,0,1,2,3,5,7,8,10,12,14,16,18,20,21,23,24,25,26,27,27,28,28,28,29,29,29,29,29,29,29
E01003640,EV motorcycles,Number,0,0,1,1,2,2,3,3,4,4,5,6,6,7,7,7,8,8,8,8,9,9,9,9,9,9,9,9,9,9
E01003641,EV motorcycles,Number,0,1,2,3,5,7,8,10,12,14,16,18,20,21,23,24,25,26,27,27,28,28,28,29,29,29,29,29,29,29
E01003642,EV motorcycles,Number,0,1,1,2,3,4,5,7,8,9,11,12,13,14,15,16,17,17,18,18,18,18,19,19,19,19,19,19,19,19
E01003643,EV motorcycles,Number,0,1,1,2,3,4,5,6,7,8,9,10,11,12,13,13,14,14,15,15,15,16,16,16,16,16,16,16,16,16
E01003644,EV motorcycles,Number,0,0,0,1,1,1,1,2,2,2,3,3,3,4,4,4,4,4,5,5,5,5,5,5,5,5,5,5,5,5
E01003645,EV motorcycles,Number,0,1,2,4,5,7,9,11,14,16,18,20,22,24,25,27,28,29,30,30,31,31,31,32,32,32,32,32,32,32
E01003646,EV motorcycles,Number,0,0,1,1,2,2,3,4,5,5,6,7,8,8,9,9,10,10,10,10,11,11,11,11,11,11,11,11,11,11
E01003647,EV motorcycles,Number,0,0,0,0,0,0,0,0,0,0,0,0,0,0,0,0,0,0,0,0,0,0,0,0,0,0,0,0,0,0
E01003648,EV motorcycles,Number,0,0,1,1,2,2,3,3,4,4,5,6,6,7,7,7,8,8,8,8,9,9,9,9,9,9,9,9,9,9
E01003649,EV motorcycles,Number,0,1,1,2,2,3,4,5,6,7,8,9,10,10,11,12,12,13,13,13,13,14,14,14,14,14,14,14,14,14
E01003650,EV motorcycles,Number,0,0,1,1,1,2,2,3,3,4,4,5,5,6,6,7,7,7,7,8,8,8,8,8,8,8,8,8,8,8
E01003651,EV motorcycles,Number,0,0,1,1,2,2,3,4,5,5,6,7,8,8,9,9,10,10,10,10,11,11,11,11,11,11,11,11,11,11
E01003652,EV motorcycles,Number,0,0,1,1,2,2,3,4,4,5,6,6,7,7,8,8,9,9,9,9,10,10,10,10,10,10,10,10,10,10
E01003653,EV motorcycles,Number,0,1,1,2,4,5,6,7,9,10,12,13,14,16,17,17,18,19,19,20,20,20,21,21,21,21,21,21,21,21
E01003654,EV motorcycles,Number,1,1,2,4,6,8,10,12,15,17,20,22,24,26,28,29,30,31,32,33,34,34,34,34,35,35,35,35,35,35
E01003655,EV motorcycles,Number,0,1,1,2,3,4,5,6,8,9,10,11,12,13,14,15,16,16,17,17,17,17,18,18,18,18,18,18,18,18
E01003656,EV motorcycles,Number,0,1,2,3,4,5,7,8,10,11,13,14,16,17,18,19,20,21,21,22,22,22,23,23,23,23,23,23,23,23
E01003657,EV motorcycles,Number,0,1,2,3,5,7,9,11,13,15,17,19,21,23,24,26,27,28,29,29,30,30,30,31,31,31,31,31,31,31
E01003658,EV motorcycles,Number,0,1,2,3,4,5,7,8,10,11,13,14,16,17,18,19,20,21,21,22,22,22,23,23,23,23,23,23,23,23
E01003659,EV motorcycles,Number,0,1,1,2,4,5,6,8,9,11,12,14,15,16,17,18,19,20,20,21,21,21,22,22,22,22,22,22,22,22
E01003660,EV motorcycles,Number,0,1,2,3,4,5,7,8,10,11,13,14,16,17,18,19,20,21,21,22,22,22,23,23,23,23,23,23,23,23
E01003661,EV motorcycles,Number,0,0,1,1,2,3,3,4,5,6,7,7,8,9,9,10,10,11,11,11,12,12,12,12,12,12,12,12,12,12
E01003662,EV motorcycles,Number,0,1,1,2,3,4,5,6,8,9,10,11,12,13,14,15,16,16,17,17,17,17,18,18,18,18,18,18,18,18
E01003663,EV motorcycles,Number,0,1,2,3,4,5,7,8,10,11,13,14,16,17,18,19,20,21,21,22,22,22,23,23,23,23,23,23,23,23
E01003664,EV motorcycles,Number,0,1,1,2,4,5,6,8,9,11,12,14,15,16,17,18,19,20,20,21,21,21,22,22,22,22,22,22,22,22
E01003665,EV motorcycles,Number,0,0,1,1,2,2,3,4,5,5,6,7,8,8,9,9,10,10,10,10,11,11,11,11,11,11,11,11,11,11
E01003666,EV motorcycles,Number,0,1,2,3,4,6,7,9,11,12,14,16,17,18,20,21,22,22,23,24,24,24,24,25,25,25,25,25,25,25
E01003668,EV motorcycles,Number,0,1,2,4,6,7,10,12,14,16,18,21,23,24,26,27,29,30,31,31,32,32,32,33,33,33,33,33,33,33
E01003669,EV motorcycles,Number,1,1,3,4,7,9,12,14,17,20,22,25,27,30,32,33,35,36,37,38,38,39,39,39,40,40,40,40,40,40
E01003670,EV motorcycles,Number,1,1,2,4,6,8,10,12,15,17,20,22,24,26,28,29,30,31,32,33,34,34,34,34,35,35,35,35,35,35
E01003671,EV motorcycles,Number,0,1,1,2,3,4,5,7,8,9,11,12,13,14,15,16,17,17,18,18,18,18,19,19,19,19,19,19,19,19
E01003672,EV motorcycles,Number,0,1,1,2,3,4,6,7,8,10,11,12,14,15,16,17,17,18,18,19,19,19,20,20,20,20,20,20,20,20
E01003673,EV motorcycles,Number,0,0,1,1,1,2,2,3,3,4,4,5,5,6,6,7,7,7,7,8,8,8,8,8,8,8,8,8,8,8
E01003674,EV motorcycles,Number,0,1,1,2,4,5,6,8,9,11,12,14,15,16,17,18,19,20,20,21,21,21,22,22,22,22,22,22,22,22
E01003675,EV motorcycles,Number,0,0,0,1,1,1,2,2,3,3,3,4,4,4,5,5,5,5,6,6,6,6,6,6,6,6,6,6,6,6
E01003676,EV motorcycles,Number,0,1,1,2,2,3,4,5,6,7,8,9,10,10,11,12,12,13,13,13,13,14,14,14,14,14,14,14,14,14
E01003677,EV motorcycles,Number,0,1,1,2,3,4,5,6,7,8,10,11,12,13,13,14,15,15,16,16,16,16,17,17,17,17,17,17,17,17
E01003678,EV motorcycles,Number,0,0,1,1,2,3,3,4,5,6,7,7,8,9,9,10,10,11,11,11,12,12,12,12,12,12,12,12,12,12
E01003679,EV motorcycles,Number,0,1,1,2,3,4,5,6,7,8,9,10,11,12,13,13,14,14,15,15,15,16,16,16,16,16,16,16,16,16
E01003680,EV motorcycles,Number,0,0,0,0,0,0,0,0,0,0,0,0,0,0,0,0,0,0,0,0,0,0,0,0,0,0,0,0,0,0
E01003681,EV motorcycles,Number,0,0,0,1,1,2,2,2,3,3,4,4,5,5,6,6,6,6,6,7,7,7,7,7,7,7,7,7,7,7
E01003682,EV motorcycles,Number,0,0,1,1,2,2,3,3,4,4,5,6,6,7,7,7,8,8,8,8,9,9,9,9,9,9,9,9,9,9
E01003683,EV motorcycles,Number,0,1,1,2,3,4,5,6,7,8,10,11,12,13,13,14,15,15,16,16,16,16,17,17,17,17,17,17,17,17
E01003684,EV motorcycles,Number,0,1,1,2,3,4,5,6,8,9,10,11,12,13,14,15,16,16,17,17,17,17,18,18,18,18,18,18,18,18
E01003685,EV motorcycles,Number,0,0,1,1,2,3,3,4,5,6,7,7,8,9,9,10,10,11,11,11,12,12,12,12,12,12,12,12,12,12
E01003686,EV motorcycles,Number,0,0,1,1,2,3,4,5,5,6,7,8,9,10,10,11,11,12,12,12,12,13,13,13,13,13,13,13,13,13
E01003688,EV motorcycles,Number,0,0,1,1,2,3,3,4,5,6,7,7,8,9,9,10,10,11,11,11,12,12,12,12,12,12,12,12,12,12
E01003689,EV motorcycles,Number,0,0,0,1,1,2,2,2,3,3,4,4,5,5,6,6,6,6,6,7,7,7,7,7,7,7,7,7,7,7
E01003690,EV motorcycles,Number,0,0,1,1,2,3,3,4,5,6,7,7,8,9,9,10,10,11,11,11,12,12,12,12,12,12,12,12,12,12
E01003691,EV motorcycles,Number,0,0,1,1,2,3,4,5,5,6,7,8,9,10,10,11,11,12,12,12,12,13,13,13,13,13,13,13,13,13
E01003692,EV motorcycles,Number,0,0,0,1,1,1,1,2,2,2,3,3,3,4,4,4,4,4,5,5,5,5,5,5,5,5,5,5,5,5
E01003693,EV motorcycles,Number,0,0,1,1,2,3,4,5,5,6,7,8,9,10,10,11,11,12,12,12,12,13,13,13,13,13,13,13,13,13
E01003694,EV motorcycles,Number,0,0,1,1,2,2,3,4,5,5,6,7,8,8,9,9,10,10,10,10,11,11,11,11,11,11,11,11,11,11
E01003695,EV motorcycles,Number,0,0,1,1,1,2,2,3,3,4,4,5,5,6,6,7,7,7,7,8,8,8,8,8,8,8,8,8,8,8
E01003696,EV motorcycles,Number,0,0,1,1,2,2,3,4,4,5,6,6,7,7,8,8,9,9,9,9,10,10,10,10,10,10,10,10,10,10
E01003697,EV motorcycles,Number,0,0,1,1,1,2,2,3,3,4,4,5,5,6,6,7,7,7,7,8,8,8,8,8,8,8,8,8,8,8
E01003698,EV motorcycles,Number,0,1,1,2,3,4,5,6,7,8,10,11,12,13,13,14,15,15,16,16,16,16,17,17,17,17,17,17,17,17
E01003699,EV motorcycles,Number,0,1,2,4,6,8,10,12,14,17,19,21,23,25,27,28,30,31,31,32,33,33,33,33,34,34,34,34,34,34
E01003700,EV motorcycles,Number,0,1,1,2,3,4,5,6,8,9,10,11,12,13,14,15,16,16,17,17,17,17,18,18,18,18,18,18,18,18
E01003701,EV motorcycles,Number,0,0,1,1,2,2,3,3,4,4,5,6,6,7,7,7,8,8,8,8,9,9,9,9,9,9,9,9,9,9
E01003702,EV motorcycles,Number,0,1,1,2,3,4,5,7,8,9,11,12,13,14,15,16,17,17,18,18,18,18,19,19,19,19,19,19,19,19
E01003703,EV motorcycles,Number,0,1,1,2,3,4,6,7,8,10,11,12,14,15,16,17,17,18,18,19,19,19,20,20,20,20,20,20,20,20
E01003704,EV motorcycles,Number,0,1,1,2,4,5,6,8,9,11,12,14,15,16,17,18,19,20,20,21,21,21,22,22,22,22,22,22,22,22
E01003705,EV motorcycles,Number,0,1,2,3,4,5,7,8,10,11,13,14,16,17,18,19,20,21,21,22,22,22,23,23,23,23,23,23,23,23
E01003706,EV motorcycles,Number,0,0,0,1,1,2,2,2,3,3,4,4,5,5,6,6,6,6,6,7,7,7,7,7,7,7,7,7,7,7
E01003707,EV motorcycles,Number,0,1,1,2,3,4,5,6,7,8,9,10,11,12,13,13,14,14,15,15,15,16,16,16,16,16,16,16,16,16
E01003708,EV motorcycles,Number,0,1,1,2,4,5,6,8,9,11,12,14,15,16,17,18,19,20,20,21,21,21,22,22,22,22,22,22,22,22
E01003709,EV motorcycles,Number,0,0,1,1,2,3,4,5,5,6,7,8,9,10,10,11,11,12,12,12,12,13,13,13,13,13,13,13,13,13
E01003710,EV motorcycles,Number,0,0,1,1,2,2,3,3,4,4,5,6,6,7,7,7,8,8,8,8,9,9,9,9,9,9,9,9,9,9
E01003711,EV motorcycles,Number,0,1,1,2,3,4,5,6,7,8,10,11,12,13,13,14,15,15,16,16,16,16,17,17,17,17,17,17,17,17
E01003712,EV motorcycles,Number,0,0,1,1,2,2,3,4,4,5,6,6,7,7,8,8,9,9,9,9,10,10,10,10,10,10,10,10,10,10
E01003713,EV motorcycles,Number,0,0,0,0,0,0,0,0,0,0,0,0,0,0,0,0,0,0,0,0,0,0,0,0,0,0,0,0,0,0
E01003714,EV motorcycles,Number,0,1,1,2,3,4,6,7,8,10,11,12,14,15,16,17,17,18,18,19,19,19,20,20,20,20,20,20,20,20
E01003715,EV motorcycles,Number,0,1,1,2,2,3,4,5,6,7,8,9,10,10,11,12,12,13,13,13,13,14,14,14,14,14,14,14,14,14
E01003716,EV motorcycles,Number,0,0,1,1,2,3,3,4,5,6,7,7,8,9,9,10,10,11,11,11,12,12,12,12,12,12,12,12,12,12
E01003718,EV motorcycles,Number,0,0,1,1,2,2,3,3,4,4,5,6,6,7,7,7,8,8,8,8,9,9,9,9,9,9,9,9,9,9
E01003719,EV motorcycles,Number,0,1,1,2,3,4,5,6,8,9,10,11,12,13,14,15,16,16,17,17,17,17,18,18,18,18,18,18,18,18
E01003720,EV motorcycles,Number,0,1,1,2,3,3,4,5,6,7,8,9,10,11,12,12,13,13,14,14,14,15,15,15,15,15,15,15,15,15
E01003721,EV motorcycles,Number,0,1,1,2,3,4,5,6,7,8,10,11,12,13,13,14,15,15,16,16,16,16,17,17,17,17,17,17,17,17
E01003722,EV motorcycles,Number,0,1,2,3,5,7,8,10,12,14,16,18,20,21,23,24,25,26,27,27,28,28,28,29,29,29,29,29,29,29
E01003723,EV motorcycles,Number,0,1,2,3,5,7,9,11,13,15,17,19,21,23,24,26,27,28,29,29,30,30,30,31,31,31,31,31,31,31
E01003724,EV motorcycles,Number,0,1,2,3,5,6,8,10,12,14,16,17,19,21,22,23,24,25,26,26,27,27,27,28,28,28,28,28,28,28
E01003725,EV motorcycles,Number,0,1,1,2,3,4,5,6,7,8,9,10,11,12,13,13,14,14,15,15,15,16,16,16,16,16,16,16,16,16
E01003726,EV motorcycles,Number,1,1,3,4,7,9,11,14,16,19,22,24,27,29,31,32,34,35,36,37,37,38,38,38,39,39,39,39,39,39
E01003727,EV motorcycles,Number,0,1,1,2,4,5,6,8,9,11,12,14,15,16,17,18,19,20,20,21,21,21,22,22,22,22,22,22,22,22
E01003728,EV motorcycles,Number,0,1,2,3,5,7,9,11,13,15,17,19,21,22,24,25,26,27,28,28,29,29,29,30,30,30,30,30,30,30
E01003729,EV motorcycles,Number,0,0,1,1,2,3,3,4,5,6,7,7,8,9,9,10,10,11,11,11,12,12,12,12,12,12,12,12,12,12
E01003730,EV motorcycles,Number,0,0,1,1,2,2,3,3,4,4,5,6,6,7,7,7,8,8,8,8,9,9,9,9,9,9,9,9,9,9
E01003731,EV motorcycles,Number,0,0,1,1,2,2,3,3,4,4,5,6,6,7,7,7,8,8,8,8,9,9,9,9,9,9,9,9,9,9
E01003732,EV motorcycles,Number,0,1,1,2,3,3,4,5,6,7,8,9,10,11,12,12,13,13,14,14,14,15,15,15,15,15,15,15,15,15
E01003733,EV motorcycles,Number,0,0,1,1,2,2,3,4,4,5,6,6,7,7,8,8,9,9,9,9,10,10,10,10,10,10,10,10,10,10
E01003734,EV motorcycles,Number,0,0,0,1,1,2,2,2,3,3,4,4,5,5,6,6,6,6,6,7,7,7,7,7,7,7,7,7,7,7
E01003735,EV motorcycles,Number,0,0,0,1,1,1,2,2,3,3,3,4,4,4,5,5,5,5,6,6,6,6,6,6,6,6,6,6,6,6
E01003736,EV motorcycles,Number,0,0,1,1,1,2,2,3,3,4,4,5,5,6,6,7,7,7,7,8,8,8,8,8,8,8,8,8,8,8
E01003737,EV motorcycles,Number,0,1,2,3,4,6,8,9,11,13,15,16,18,19,20,22,23,23,24,25,25,25,25,26,26,26,26,26,26,26
E01003738,EV motorcycles,Number,0,0,1,1,2,3,3,4,5,6,7,7,8,9,9,10,10,11,11,11,12,12,12,12,12,12,12,12,12,12
E01003739,EV motorcycles,Number,0,1,1,2,4,5,6,7,9,10,12,13,14,16,17,17,18,19,19,20,20,20,21,21,21,21,21,21,21,21
E01003740,EV motorcycles,Number,0,0,1,1,2,3,3,4,5,6,7,7,8,9,9,10,10,11,11,11,12,12,12,12,12,12,12,12,12,12
E01003741,EV motorcycles,Number,0,0,0,1,1,1,2,2,3,3,3,4,4,4,5,5,5,5,6,6,6,6,6,6,6,6,6,6,6,6
E01003742,EV motorcycles,Number,0,1,1,2,2,3,4,5,6,7,8,9,10,10,11,12,12,13,13,13,13,14,14,14,14,14,14,14,14,14
E01003743,EV motorcycles,Number,0,0,1,1,1,2,2,3,3,4,4,5,5,6,6,7,7,7,7,8,8,8,8,8,8,8,8,8,8,8
E01003744,EV motorcycles,Number,0,1,1,2,2,3,4,5,6,7,8,9,10,10,11,12,12,13,13,13,13,14,14,14,14,14,14,14,14,14
E01003745,EV motorcycles,Number,0,0,0,1,1,2,2,2,3,3,4,4,5,5,6,6,6,6,6,7,7,7,7,7,7,7,7,7,7,7
E01003746,EV motorcycles,Number,0,1,2,4,5,7,9,11,14,16,18,20,22,24,25,27,28,29,30,30,31,31,31,32,32,32,32,32,32,32
E01003747,EV motorcycles,Number,0,0,1,1,2,2,3,3,4,4,5,6,6,7,7,7,8,8,8,8,9,9,9,9,9,9,9,9,9,9
E01003748,EV motorcycles,Number,0,1,2,3,5,7,8,10,12,14,16,18,20,21,23,24,25,26,27,27,28,28,28,29,29,29,29,29,29,29
E01003749,EV motorcycles,Number,0,1,1,2,3,4,5,6,7,8,10,11,12,13,13,14,15,15,16,16,16,16,17,17,17,17,17,17,17,17
E01003750,EV motorcycles,Number,0,1,2,3,4,6,8,9,11,13,15,16,18,19,20,22,23,23,24,25,25,25,25,26,26,26,26,26,26,26
E01003751,EV motorcycles,Number,0,1,1,2,3,3,4,5,6,7,8,9,10,11,12,12,13,13,14,14,14,15,15,15,15,15,15,15,15,15
E01003752,EV motorcycles,Number,0,0,1,1,2,2,3,3,4,4,5,6,6,7,7,7,8,8,8,8,9,9,9,9,9,9,9,9,9,9
E01003753,EV motorcycles,Number,0,1,1,2,3,3,4,5,6,7,8,9,10,11,12,12,13,13,14,14,14,15,15,15,15,15,15,15,15,15
E01003754,EV motorcycles,Number,0,1,1,2,2,3,4,5,6,7,8,9,10,10,11,12,12,13,13,13,13,14,14,14,14,14,14,14,14,14
E01003755,EV motorcycles,Number,0,0,1,1,2,2,3,3,4,4,5,6,6,7,7,7,8,8,8,8,9,9,9,9,9,9,9,9,9,9
E01003756,EV motorcycles,Number,0,0,1,1,2,3,4,5,5,6,7,8,9,10,10,11,11,12,12,12,12,13,13,13,13,13,13,13,13,13
E01003757,EV motorcycles,Number,0,0,1,1,1,2,2,3,3,4,4,5,5,6,6,7,7,7,7,8,8,8,8,8,8,8,8,8,8,8
E01003758,EV motorcycles,Number,0,1,1,2,2,3,4,5,6,7,8,9,10,10,11,12,12,13,13,13,13,14,14,14,14,14,14,14,14,14
E01003759,EV motorcycles,Number,0,1,1,2,3,4,5,6,8,9,10,11,12,13,14,15,16,16,17,17,17,17,18,18,18,18,18,18,18,18
E01003760,EV motorcycles,Number,0,1,1,2,3,4,6,7,8,10,11,12,14,15,16,17,17,18,18,19,19,19,20,20,20,20,20,20,20,20
E01003761,EV motorcycles,Number,0,1,1,2,3,4,5,6,7,8,9,10,11,12,13,13,14,14,15,15,15,16,16,16,16,16,16,16,16,16
E01003762,EV motorcycles,Number,0,1,1,2,3,4,6,7,8,10,11,12,14,15,16,17,17,18,18,19,19,19,20,20,20,20,20,20,20,20
E01003763,EV motorcycles,Number,0,1,2,4,5,7,9,11,14,16,18,20,22,24,25,27,28,29,30,30,31,31,31,32,32,32,32,32,32,32
E01003764,EV motorcycles,Number,0,1,2,3,5,6,8,10,12,14,16,17,19,21,22,23,24,25,26,26,27,27,27,28,28,28,28,28,28,28
E01003765,EV motorcycles,Number,0,1,1,2,3,4,6,7,8,10,11,12,14,15,16,17,17,18,18,19,19,19,20,20,20,20,20,20,20,20
E01003766,EV motorcycles,Number,0,0,1,1,2,3,3,4,5,6,7,7,8,9,9,10,10,11,11,11,12,12,12,12,12,12,12,12,12,12
E01003767,EV motorcycles,Number,0,0,1,1,2,3,4,5,5,6,7,8,9,10,10,11,11,12,12,12,12,13,13,13,13,13,13,13,13,13
E01003768,EV motorcycles,Number,0,1,1,2,2,3,4,5,6,7,8,9,10,10,11,12,12,13,13,13,13,14,14,14,14,14,14,14,14,14
E01003769,EV motorcycles,Number,0,1,1,2,3,4,5,6,7,8,9,10,11,12,13,13,14,14,15,15,15,16,16,16,16,16,16,16,16,16
E01003770,EV motorcycles,Number,0,1,1,2,3,4,6,7,8,10,11,12,14,15,16,17,17,18,18,19,19,19,20,20,20,20,20,20,20,20
E01003771,EV motorcycles,Number,1,3,6,10,15,20,26,32,38,44,50,55,61,66,70,74,77,80,82,84,85,86,87,88,88,88,89,89,89,89
E01003772,EV motorcycles,Number,0,0,1,1,2,2,3,3,4,4,5,6,6,7,7,7,8,8,8,8,9,9,9,9,9,9,9,9,9,9
E01003773,EV motorcycles,Number,0,1,1,2,2,3,4,5,6,7,8,9,10,10,11,12,12,13,13,13,13,14,14,14,14,14,14,14,14,14
E01003774,EV motorcycles,Number,0,0,1,1,2,2,3,4,5,5,6,7,8,8,9,9,10,10,10,10,11,11,11,11,11,11,11,11,11,11
E01003775,EV motorcycles,Number,0,1,1,2,3,4,6,7,8,10,11,12,14,15,16,17,17,18,18,19,19,19,20,20,20,20,20,20,20,20
E01003776,EV motorcycles,Number,0,1,1,2,3,4,5,6,7,8,9,10,11,12,13,13,14,14,15,15,15,16,16,16,16,16,16,16,16,16
E01003777,EV motorcycles,Number,0,1,1,2,2,3,4,5,6,7,8,9,10,10,11,12,12,13,13,13,13,14,14,14,14,14,14,14,14,14
E01003778,EV motorcycles,Number,0,1,1,2,2,3,4,5,6,7,8,9,10,10,11,12,12,13,13,13,13,14,14,14,14,14,14,14,14,14
E01003779,EV motorcycles,Number,0,0,1,1,1,2,2,3,3,4,4,5,5,6,6,7,7,7,7,8,8,8,8,8,8,8,8,8,8,8
E01003780,EV motorcycles,Number,0,1,1,2,3,4,5,6,8,9,10,11,12,13,14,15,16,16,17,17,17,17,18,18,18,18,18,18,18,18
E01003781,EV motorcycles,Number,0,0,1,1,2,3,3,4,5,6,7,7,8,9,9,10,10,11,11,11,12,12,12,12,12,12,12,12,12,12
E01003782,EV motorcycles,Number,0,0,1,1,2,3,3,4,5,6,7,7,8,9,9,10,10,11,11,11,12,12,12,12,12,12,12,12,12,12
E01003783,EV motorcycles,Number,0,1,1,2,2,3,4,5,6,7,8,9,10,10,11,12,12,13,13,13,13,14,14,14,14,14,14,14,14,14
E01003784,EV motorcycles,Number,0,1,1,2,4,5,6,7,9,10,12,13,14,16,17,17,18,19,19,20,20,20,21,21,21,21,21,21,21,21
E01003785,EV motorcycles,Number,0,0,1,1,2,2,3,3,4,4,5,6,6,7,7,7,8,8,8,8,9,9,9,9,9,9,9,9,9,9
E01003786,EV motorcycles,Number,0,0,1,1,1,2,2,3,3,4,4,5,5,6,6,7,7,7,7,8,8,8,8,8,8,8,8,8,8,8
E01003787,EV motorcycles,Number,0,0,0,1,1,1,1,2,2,2,3,3,3,4,4,4,4,4,5,5,5,5,5,5,5,5,5,5,5,5
E01003788,EV motorcycles,Number,0,1,1,2,2,3,4,5,6,7,8,9,10,10,11,12,12,13,13,13,13,14,14,14,14,14,14,14,14,14
E01003789,EV motorcycles,Number,0,1,1,2,3,4,5,7,8,9,11,12,13,14,15,16,17,17,18,18,18,18,19,19,19,19,19,19,19,19
E01003790,EV motorcycles,Number,0,1,2,3,5,6,8,10,12,14,16,17,19,21,22,23,24,25,26,26,27,27,27,28,28,28,28,28,28,28
E01003791,EV motorcycles,Number,0,1,2,3,5,6,8,10,11,13,15,17,18,20,21,22,23,24,25,25,26,26,26,27,27,27,27,27,27,27
E01003792,EV motorcycles,Number,0,1,1,2,3,4,5,7,8,9,11,12,13,14,15,16,17,17,18,18,18,18,19,19,19,19,19,19,19,19
E01003793,EV motorcycles,Number,0,1,1,2,3,4,5,6,7,8,10,11,12,13,13,14,15,15,16,16,16,16,17,17,17,17,17,17,17,17
E01003794,EV motorcycles,Number,0,1,2,3,4,5,7,8,10,11,13,14,16,17,18,19,20,21,21,22,22,22,23,23,23,23,23,23,23,23
E01003795,EV motorcycles,Number,0,0,0,1,1,2,2,2,3,3,4,4,5,5,6,6,6,6,6,7,7,7,7,7,7,7,7,7,7,7
E01003796,EV motorcycles,Number,0,0,1,1,1,2,2,3,3,4,4,5,5,6,6,7,7,7,7,8,8,8,8,8,8,8,8,8,8,8
E01003797,EV motorcycles,Number,0,1,2,3,4,5,7,8,10,11,13,14,16,17,18,19,20,21,21,22,22,22,23,23,23,23,23,23,23,23
E01003798,EV motorcycles,Number,0,1,2,4,6,8,10,12,14,17,19,21,23,25,27,28,30,31,31,32,33,33,33,33,34,34,34,34,34,34
E01003799,EV motorcycles,Number,0,1,1,2,4,5,6,8,9,11,12,14,15,16,17,18,19,20,20,21,21,21,22,22,22,22,22,22,22,22
E01003800,EV motorcycles,Number,1,2,3,5,8,11,14,17,20,23,26,29,32,35,37,39,41,42,43,44,45,46,46,46,47,47,47,47,47,47
E01003801,EV motorcycles,Number,0,1,2,3,4,6,7,9,11,12,14,16,17,18,20,21,22,22,23,24,24,24,24,25,25,25,25,25,25,25
E01003802,EV motorcycles,Number,0,1,2,3,5,7,8,10,12,14,16,18,20,21,23,24,25,26,27,27,28,28,28,29,29,29,29,29,29,29
E01003803,EV motorcycles,Number,0,1,2,4,5,7,9,11,14,16,18,20,22,24,25,27,28,29,30,30,31,31,31,32,32,32,32,32,32,32
E01003804,EV motorcycles,Number,1,2,3,5,7,10,13,16,19,22,25,27,30,33,35,37,38,40,41,42,42,43,43,43,44,44,44,44,44,44
E01003805,EV motorcycles,Number,1,1,3,4,7,9,11,14,16,19,22,24,27,29,31,32,34,35,36,37,37,38,38,38,39,39,39,39,39,39
E01003806,EV motorcycles,Number,1,2,4,6,10,13,16,20,24,28,32,35,39,42,45,47,50,51,53,54,55,55,56,56,56,57,57,57,57,57
E01003807,EV motorcycles,Number,1,1,2,4,6,9,11,13,16,19,21,24,26,28,30,32,33,34,35,36,36,37,37,37,38,38,38,38,38,38
E01003808,EV motorcycles,Number,0,1,2,3,5,7,9,11,13,15,17,19,21,23,24,26,27,28,29,29,30,30,30,31,31,31,31,31,31,31
E01003809,EV motorcycles,Number,0,1,2,3,5,7,8,10,12,14,16,18,20,21,23,24,25,26,27,27,28,28,28,29,29,29,29,29,29,29
E01003810,EV motorcycles,Number,0,1,2,3,5,7,9,11,13,15,17,19,21,23,24,26,27,28,29,29,30,30,30,31,31,31,31,31,31,31
E01003811,EV motorcycles,Number,0,1,1,2,4,5,6,8,9,11,12,14,15,16,17,18,19,20,20,21,21,21,22,22,22,22,22,22,22,22
E01003812,EV motorcycles,Number,0,1,2,3,5,7,8,10,12,14,16,18,20,21,23,24,25,26,27,27,28,28,28,29,29,29,29,29,29,29
E01003813,EV motorcycles,Number,1,2,4,6,10,13,16,20,24,28,32,35,39,42,45,47,50,51,53,54,55,55,56,56,56,57,57,57,57,57
E01003814,EV motorcycles,Number,0,1,2,3,5,7,9,11,13,15,17,19,21,23,24,26,27,28,29,29,30,30,30,31,31,31,31,31,31,31
E01003815,EV motorcycles,Number,1,1,3,4,7,9,11,14,16,19,22,24,27,29,31,32,34,35,36,37,37,38,38,38,39,39,39,39,39,39
E01003816,EV motorcycles,Number,1,1,3,4,7,9,12,14,17,20,22,25,27,30,32,33,35,36,37,38,38,39,39,39,40,40,40,40,40,40
E01003817,EV motorcycles,Number,1,3,5,8,12,16,20,25,30,34,39,44,48,52,55,58,61,63,65,66,67,68,69,69,69,70,70,70,70,70
E01003818,EV motorcycles,Number,1,2,3,5,8,10,13,16,19,22,25,28,31,33,35,37,39,40,42,42,43,44,44,44,45,45,45,45,45,45
E01003819,EV motorcycles,Number,1,2,3,5,7,10,12,15,18,21,24,27,29,32,34,36,37,39,40,41,41,42,42,42,43,43,43,43,43,43
E01003820,EV motorcycles,Number,1,2,4,7,10,13,17,21,25,29,33,37,40,44,47,49,51,53,55,56,57,57,58,58,58,59,59,59,59,59
E01003821,EV motorcycles,Number,0,0,1,1,1,2,2,3,3,4,4,5,5,6,6,7,7,7,7,8,8,8,8,8,8,8,8,8,8,8
E01003822,EV motorcycles,Number,0,1,1,2,3,4,6,7,8,10,11,12,14,15,16,17,17,18,18,19,19,19,20,20,20,20,20,20,20,20
E01003823,EV motorcycles,Number,1,2,4,6,10,13,17,21,25,29,32,36,40,43,46,48,50,52,54,55,56,56,57,57,57,58,58,58,58,58
E01003824,EV motorcycles,Number,0,1,2,3,4,5,7,9,10,12,13,15,16,18,19,20,21,22,22,23,23,23,23,24,24,24,24,24,24,24
E01003825,EV motorcycles,Number,0,1,1,2,3,3,4,5,6,7,9,9,10,11,12,13,13,14,14,14,15,15,15,15,15,15,15,15,15,15
E01003826,EV motorcycles,Number,0,1,2,4,6,7,10,12,14,16,18,21,23,24,26,27,29,30,31,31,32,32,32,33,33,33,33,33,33,33
E01003827,EV motorcycles,Number,1,1,2,4,6,8,10,13,15,18,20,22,25,27,28,30,31,32,33,34,35,35,35,35,36,36,36,36,36,36
E01003828,EV motorcycles,Number,1,1,3,5,7,9,12,15,17,20,23,26,28,30,32,34,36,37,38,39,39,40,40,40,41,41,41,41,41,41
E01003829,EV motorcycles,Number,0,1,2,3,5,7,9,11,13,15,17,19,21,22,24,25,26,27,28,28,29,29,29,30,30,30,30,30,30,30
E01003830,EV motorcycles,Number,1,2,3,5,7,9,12,15,18,21,24,26,29,31,33,35,36,38,39,40,40,41,41,41,42,42,42,42,42,42
E01003831,EV motorcycles,Number,0,1,1,2,2,3,4,5,6,7,8,9,10,11,11,12,13,13,13,14,14,14,14,14,14,14,15,15,15,15
E01003832,EV motorcycles,Number,0,1,2,3,5,7,9,11,13,15,17,19,21,22,24,25,26,27,28,28,29,29,29,30,30,30,30,30,30,30
E01003833,EV motorcycles,Number,0,1,2,4,6,8,10,12,14,17,19,21,23,25,27,28,30,31,31,32,33,33,33,33,34,34,34,34,34,34
E01003834,EV motorcycles,Number,0,1,2,3,5,6,8,10,11,13,15,17,18,20,21,22,23,24,25,25,26,26,26,27,27,27,27,27,27,27
E01003835,EV motorcycles,Number,0,1,2,3,4,5,7,9,10,12,13,15,16,18,19,20,21,22,22,23,23,23,23,24,24,24,24,24,24,24
E01003836,EV motorcycles,Number,0,1,2,3,4,6,7,9,11,12,14,16,17,18,20,21,22,22,23,24,24,24,24,25,25,25,25,25,25,25
E01003837,EV motorcycles,Number,1,2,4,6,9,12,16,20,23,27,31,34,38,41,43,46,48,49,51,52,53,53,54,54,54,55,55,55,55,55
E01003838,EV motorcycles,Number,0,1,2,3,5,7,9,11,13,15,17,19,21,22,24,25,26,27,28,28,29,29,29,30,30,30,30,30,30,30
E01003839,EV motorcycles,Number,0,1,2,4,5,7,9,11,14,16,18,20,22,24,25,27,28,29,30,30,31,31,31,32,32,32,32,32,32,32
E01003840,EV motorcycles,Number,0,0,1,1,2,3,4,5,5,6,7,8,9,10,10,11,11,12,12,12,12,13,13,13,13,13,13,13,13,13
E01003841,EV motorcycles,Number,0,1,1,2,3,4,6,7,8,10,11,12,14,15,16,17,17,18,18,19,19,19,20,20,20,20,20,20,20,20
E01003842,EV motorcycles,Number,0,1,2,3,5,6,8,10,11,13,15,17,18,20,21,22,23,24,25,25,26,26,26,27,27,27,27,27,27,27
E01003843,EV motorcycles,Number,1,2,3,5,7,10,13,15,18,21,24,27,30,32,34,36,38,39,40,41,41,42,42,43,43,43,43,43,43,43
E01003844,EV motorcycles,Number,0,1,1,2,4,5,6,8,9,11,12,14,15,16,17,18,19,20,20,21,21,21,22,22,22,22,22,22,22,22
E01003845,EV motorcycles,Number,0,1,2,3,5,7,9,11,13,15,17,19,21,22,24,25,26,27,28,28,29,29,29,30,30,30,30,30,30,30
E01003846,EV motorcycles,Number,0,1,2,4,6,7,10,12,14,16,18,21,23,24,26,27,29,30,31,31,32,32,32,33,33,33,33,33,33,33
E01003847,EV motorcycles,Number,1,1,2,4,6,8,10,13,15,18,20,22,25,27,28,30,31,32,33,34,35,35,35,35,36,36,36,36,36,36
E01003848,EV motorcycles,Number,2,6,11,19,29,38,49,61,72,84,96,106,117,126,135,142,149,154,158,161,164,166,167,168,169,170,171,171,171,171
E01003849,EV motorcycles,Number,0,1,2,3,5,7,9,11,13,15,17,19,21,23,24,26,27,28,29,29,30,30,30,31,31,31,31,31,31,31
E01003851,EV motorcycles,Number,0,1,2,3,4,6,7,9,11,13,14,16,18,19,20,21,22,23,24,24,25,25,25,25,26,26,26,26,26,26
E01003852,EV motorcycles,Number,0,1,2,3,5,7,9,11,13,15,17,19,21,22,24,25,26,27,28,28,29,29,29,30,30,30,30,30,30,30
E01003853,EV motorcycles,Number,0,1,2,3,4,6,8,9,11,13,15,16,18,19,20,22,23,23,24,25,25,25,25,26,26,26,26,26,26,26
E01003854,EV motorcycles,Number,0,1,1,2,4,5,6,7,9,10,12,13,14,16,17,17,18,19,19,20,20,20,21,21,21,21,21,21,21,21
E01003855,EV motorcycles,Number,1,1,2,4,6,8,11,13,16,19,21,23,26,28,30,31,33,34,35,36,36,37,37,37,37,37,38,38,38,38
E01003856,EV motorcycles,Number,0,1,2,3,5,7,8,10,12,14,16,18,20,21,23,24,25,26,27,27,28,28,28,29,29,29,29,29,29,29
E01003857,EV motorcycles,Number,0,1,1,2,3,4,5,7,8,9,11,12,13,14,15,16,17,17,18,18,18,18,19,19,19,19,19,19,19,19
E01003858,EV motorcycles,Number,0,1,1,2,3,4,6,7,8,10,11,12,14,15,16,17,17,18,18,19,19,19,20,20,20,20,20,20,20,20
E01003859,EV motorcycles,Number,1,2,3,5,7,10,13,16,19,22,25,27,30,33,35,37,38,40,41,42,42,43,43,43,44,44,44,44,44,44
E01003860,EV motorcycles,Number,0,0,0,1,1,1,2,2,2,3,3,4,4,4,4,5,5,5,5,5,5,6,6,6,6,6,6,6,6,6
E01003861,EV motorcycles,Number,0,1,2,3,5,7,9,11,13,15,17,19,21,22,24,25,26,27,28,28,29,29,29,30,30,30,30,30,30,30
E01003862,EV motorcycles,Number,0,1,2,3,4,6,7,9,11,12,14,16,17,18,20,21,22,22,23,24,24,24,24,25,25,25,25,25,25,25
E01003863,EV motorcycles,Number,0,1,1,2,3,4,5,6,7,8,9,10,11,12,13,13,14,14,15,15,15,16,16,16,16,16,16,16,16,16
E01003864,EV motorcycles,Number,0,1,1,2,3,4,5,6,8,9,10,11,12,13,14,15,16,16,17,17,17,17,18,18,18,18,18,18,18,18
E01003865,EV motorcycles,Number,0,1,2,3,4,5,7,8,10,11,13,14,16,17,18,19,20,21,21,22,22,22,23,23,23,23,23,23,23,23
E01003866,EV motorcycles,Number,0,0,1,1,2,3,3,4,5,6,6,7,8,8,9,10,10,10,11,11,11,11,11,11,11,11,11,11,11,11
E01003867,EV motorcycles,Number,0,1,2,3,5,6,8,10,12,14,16,17,19,21,22,23,24,25,26,26,27,27,27,28,28,28,28,28,28,28
E01003868,EV motorcycles,Number,0,1,1,2,3,4,5,7,8,9,11,12,13,14,15,16,17,17,18,18,18,18,19,19,19,19,19,19,19,19
E01003869,EV motorcycles,Number,1,2,3,5,7,10,12,15,18,21,24,27,29,32,34,36,37,39,40,41,41,42,42,42,43,43,43,43,43,43
E01003870,EV motorcycles,Number,1,1,2,4,6,8,10,13,15,18,20,22,25,27,28,30,31,32,33,34,35,35,35,35,36,36,36,36,36,36
E01003871,EV motorcycles,Number,0,0,0,0,0,0,0,0,0,0,0,0,0,0,0,0,0,0,0,0,0,0,0,0,0,0,0,0,0,0
E01003872,EV motorcycles,Number,0,1,2,3,5,7,9,11,13,15,17,19,21,23,24,26,27,28,28,29,30,30,30,30,30,31,31,31,31,31
E01003873,EV motorcycles,Number,0,1,2,3,5,6,8,10,11,13,15,17,18,20,21,22,23,24,25,25,26,26,26,27,27,27,27,27,27,27
E01003874,EV motorcycles,Number,0,1,1,2,3,4,5,6,7,8,10,11,12,13,13,14,15,15,16,16,16,16,17,17,17,17,17,17,17,17
E01003875,EV motorcycles,Number,1,2,3,5,7,10,12,15,18,21,24,27,29,32,34,36,37,39,40,41,41,42,42,42,43,43,43,43,43,43
E01003876,EV motorcycles,Number,0,1,2,3,5,6,8,10,12,14,16,17,19,21,22,23,24,25,26,26,27,27,27,28,28,28,28,28,28,28
E01003877,EV motorcycles,Number,0,1,1,2,4,5,6,7,9,10,12,13,14,16,17,17,18,19,19,20,20,20,21,21,21,21,21,21,21,21
E01003878,EV motorcycles,Number,0,1,1,2,4,5,6,8,9,11,12,14,15,16,17,18,19,20,20,21,21,21,22,22,22,22,22,22,22,22
E01003879,EV motorcycles,Number,0,1,1,2,3,4,5,6,8,9,10,11,12,13,14,15,16,16,17,17,17,17,18,18,18,18,18,18,18,18
E01003880,EV motorcycles,Number,0,1,2,3,5,7,9,11,13,15,17,19,21,23,24,26,27,28,29,29,30,30,30,31,31,31,31,31,31,31
E01003881,EV motorcycles,Number,0,1,2,3,5,7,9,11,13,15,17,19,21,23,24,26,27,28,29,29,30,30,30,31,31,31,31,31,31,31
E01003882,EV motorcycles,Number,1,1,3,4,7,9,11,14,16,19,22,24,27,29,31,32,34,35,36,37,37,38,38,38,39,39,39,39,39,39
E01003883,EV motorcycles,Number,0,1,2,3,5,6,8,10,11,13,15,17,18,20,21,22,23,24,25,25,26,26,26,27,27,27,27,27,27,27
E01003884,EV motorcycles,Number,0,1,2,3,4,6,8,9,11,13,15,16,18,19,20,22,23,23,24,25,25,25,25,26,26,26,26,26,26,26
E01003885,EV motorcycles,Number,0,1,2,3,4,5,7,9,10,12,13,15,16,18,19,20,21,22,22,23,23,23,23,24,24,24,24,24,24,24
E01003886,EV motorcycles,Number,0,1,1,2,3,3,4,5,6,7,8,9,10,11,12,12,13,13,14,14,14,15,15,15,15,15,15,15,15,15
E01003887,EV motorcycles,Number,0,0,1,1,2,3,4,5,5,6,7,8,9,10,10,11,11,12,12,12,12,13,13,13,13,13,13,13,13,13
E01003888,EV motorcycles,Number,0,1,2,3,5,7,9,11,13,15,17,19,21,22,24,25,26,27,28,28,29,29,29,30,30,30,30,30,30,30
E01003889,EV motorcycles,Number,0,1,2,3,5,6,8,10,12,14,16,17,19,21,22,23,24,25,26,26,27,27,27,28,28,28,28,28,28,28
E01003890,EV motorcycles,Number,0,1,2,3,4,5,7,8,10,11,13,14,16,17,18,19,20,21,21,22,22,22,23,23,23,23,23,23,23,23
E01003891,EV motorcycles,Number,0,1,2,4,6,7,10,12,14,16,18,21,23,24,26,27,29,30,31,31,32,32,32,33,33,33,33,33,33,33
E01003892,EV motorcycles,Number,1,1,2,4,6,9,11,13,16,19,21,24,26,28,30,32,33,34,35,36,36,37,37,37,38,38,38,38,38,38
E01003893,EV motorcycles,Number,0,1,2,4,6,7,10,12,14,16,18,21,23,24,26,27,29,30,31,31,32,32,32,33,33,33,33,33,33,33
E01003894,EV motorcycles,Number,0,1,2,3,4,5,7,9,10,12,13,15,16,18,19,20,21,22,22,23,23,23,23,24,24,24,24,24,24,24
E01003895,EV motorcycles,Number,1,2,3,5,7,10,12,15,18,21,24,27,29,32,34,36,37,39,40,41,41,42,42,42,43,43,43,43,43,43
E01003896,EV motorcycles,Number,1,1,3,4,7,9,12,14,17,20,22,25,27,30,32,33,35,36,37,38,38,39,39,39,40,40,40,40,40,40
E01003897,EV motorcycles,Number,0,1,1,2,4,5,6,8,9,11,12,14,15,16,17,18,19,20,20,21,21,21,22,22,22,22,22,22,22,22
E01003898,EV motorcycles,Number,0,1,2,4,5,7,9,11,14,16,18,20,22,24,25,27,28,29,30,30,31,31,31,32,32,32,32,32,32,32
E01003899,EV motorcycles,Number,1,3,5,9,14,19,24,30,36,41,47,52,57,62,66,70,73,76,78,79,81,82,82,83,83,83,84,84,84,84
E01003900,EV motorcycles,Number,1,2,3,5,8,10,13,16,19,23,26,29,31,34,36,38,40,41,43,43,44,45,45,45,46,46,46,46,46,46
E01003901,EV motorcycles,Number,1,1,3,4,7,9,12,14,17,20,22,25,27,30,32,33,35,36,37,38,38,39,39,39,40,40,40,40,40,40
E01003902,EV motorcycles,Number,0,1,1,2,4,5,6,7,9,10,12,13,14,16,17,17,18,19,19,20,20,20,21,21,21,21,21,21,21,21
E01003903,EV motorcycles,Number,1,2,3,5,7,9,12,15,18,21,24,26,29,31,33,35,37,38,39,40,40,41,41,41,42,42,42,42,42,42
E01003904,EV motorcycles,Number,0,1,2,3,5,6,8,10,11,13,15,17,18,20,21,22,23,24,25,25,26,26,26,27,27,27,27,27,27,27
E01003905,EV motorcycles,Number,1,2,3,6,9,11,15,18,22,25,29,32,35,38,40,42,44,46,47,48,49,49,50,50,50,51,51,51,51,51
E01003906,EV motorcycles,Number,0,0,1,1,2,3,3,4,5,6,7,7,8,9,9,10,10,11,11,11,11,12,12,12,12,12,12,12,12,12
E01003907,EV motorcycles,Number,1,2,3,5,7,10,13,16,19,22,25,27,30,33,35,37,38,40,41,42,42,43,43,43,44,44,44,44,44,44
E01003908,EV motorcycles,Number,0,1,2,3,5,7,9,11,13,15,17,19,21,23,24,26,27,28,29,29,30,30,30,31,31,31,31,31,31,31
E01003909,EV motorcycles,Number,1,1,2,4,6,8,10,13,15,18,20,22,25,27,28,30,31,32,33,34,35,35,35,35,36,36,36,36,36,36
E01003910,EV motorcycles,Number,1,2,3,5,8,10,13,16,19,22,25,28,31,33,35,37,39,40,42,42,43,44,44,44,45,45,45,45,45,45
E01003911,EV motorcycles,Number,0,1,1,2,4,5,6,8,9,11,12,14,15,16,17,18,19,20,20,21,21,21,22,22,22,22,22,22,22,22
E01003912,EV motorcycles,Number,0,0,1,1,2,2,3,4,4,5,6,6,7,7,8,8,9,9,9,9,10,10,10,10,10,10,10,10,10,10
E01003913,EV motorcycles,Number,0,1,1,2,3,4,5,7,8,9,11,12,13,14,15,16,17,17,18,18,18,18,19,19,19,19,19,19,19,19
E01003914,EV motorcycles,Number,0,1,2,3,4,5,7,8,10,11,13,14,16,17,18,19,20,21,21,22,22,22,23,23,23,23,23,23,23,23
E01003915,EV motorcycles,Number,0,1,1,2,3,4,6,7,8,10,11,12,14,15,16,17,17,18,18,19,19,19,20,20,20,20,20,20,20,20
E01003916,EV motorcycles,Number,1,2,3,5,7,9,12,15,18,21,24,26,29,31,33,35,36,38,39,40,40,41,41,41,42,42,42,42,42,42
E01003917,EV motorcycles,Number,0,1,2,3,5,7,9,11,13,15,17,19,21,22,24,25,26,27,28,28,29,29,29,30,30,30,30,30,30,30
E01003918,EV motorcycles,Number,0,1,1,2,3,4,5,6,7,8,9,10,11,12,13,13,14,14,15,15,15,16,16,16,16,16,16,16,16,16
E01003919,EV motorcycles,Number,1,2,4,7,11,14,19,23,27,31,36,40,44,47,50,53,56,58,59,60,61,62,63,63,63,64,64,64,64,64
E01003920,EV motorcycles,Number,0,0,1,1,2,3,4,5,5,6,7,8,9,10,10,11,11,12,12,12,12,13,13,13,13,13,13,13,13,13
E01003921,EV motorcycles,Number,0,1,1,2,3,4,5,6,7,8,10,11,12,13,13,14,15,15,16,16,16,16,17,17,17,17,17,17,17,17
E01003922,EV motorcycles,Number,0,1,1,2,3,4,5,6,7,8,9,10,11,12,13,13,14,14,15,15,15,16,16,16,16,16,16,16,16,16
E01003923,EV motorcycles,Number,0,1,2,3,5,7,8,10,12,14,16,18,20,21,23,24,25,26,27,27,28,28,28,29,29,29,29,29,29,29
E01003924,EV motorcycles,Number,0,1,1,2,3,3,4,5,6,7,8,9,10,11,12,12,13,13,14,14,14,15,15,15,15,15,15,15,15,15
E01003925,EV motorcycles,Number,0,1,1,2,3,4,5,6,7,8,9,10,11,12,13,13,14,14,15,15,15,16,16,16,16,16,16,16,16,16
E01003926,EV motorcycles,Number,0,1,1,2,3,4,6,7,8,10,11,12,14,15,16,17,17,18,18,19,19,19,20,20,20,20,20,20,20,20
E01003927,EV motorcycles,Number,6,15,27,45,68,92,119,146,173,202,229,255,280,303,323,341,356,369,379,387,393,398,401,404,406,407,410,410,410,410
E01003929,EV motorcycles,Number,0,1,2,3,5,7,9,11,13,15,17,19,21,22,24,25,26,27,28,28,29,29,29,30,30,30,30,30,30,30
E01003930,EV motorcycles,Number,0,0,1,1,2,3,3,4,5,6,7,7,8,9,9,10,10,11,11,11,12,12,12,12,12,12,12,12,12,12
E01003932,EV motorcycles,Number,0,1,2,3,5,7,9,11,13,15,17,19,21,22,24,25,26,27,28,28,29,29,29,30,30,30,30,30,30,30
E01003933,EV motorcycles,Number,0,1,1,2,3,4,5,6,8,9,10,11,12,13,14,15,16,16,17,17,17,17,18,18,18,18,18,18,18,18
E01003934,EV motorcycles,Number,2,6,10,17,25,34,44,54,64,75,85,95,104,112,120,126,132,137,140,143,146,147,149,150,150,151,152,152,152,152
E01003935,EV motorcycles,Number,0,0,1,1,2,2,3,4,5,5,6,7,8,8,9,9,10,10,10,10,11,11,11,11,11,11,11,11,11,11
E01003936,EV motorcycles,Number,0,0,1,1,2,2,3,4,4,5,6,6,7,7,8,8,9,9,9,9,10,10,10,10,10,10,10,10,10,10
E01003937,EV motorcycles,Number,0,1,1,2,3,3,4,5,6,7,8,9,10,11,12,12,13,13,14,14,14,15,15,15,15,15,15,15,15,15
E01003938,EV motorcycles,Number,0,0,1,1,2,2,3,3,4,4,5,6,6,7,7,7,8,8,8,8,9,9,9,9,9,9,9,9,9,9
E01003939,EV motorcycles,Number,0,0,1,1,2,3,3,4,5,6,7,7,8,9,9,10,10,11,11,11,12,12,12,12,12,12,12,12,12,12
E01003940,EV motorcycles,Number,0,1,1,2,2,3,4,5,6,7,8,9,10,10,11,12,12,13,13,13,13,14,14,14,14,14,14,14,14,14
E01003941,EV motorcycles,Number,0,1,2,3,5,6,8,10,12,14,16,17,19,21,22,23,24,25,26,26,27,27,27,28,28,28,28,28,28,28
E01003942,EV motorcycles,Number,0,1,1,2,3,4,5,6,7,8,10,11,12,13,13,14,15,15,16,16,16,16,17,17,17,17,17,17,17,17
E01003943,EV motorcycles,Number,0,1,2,4,6,7,10,12,14,16,18,21,23,24,26,27,29,30,31,31,32,32,32,33,33,33,33,33,33,33
E01003945,EV motorcycles,Number,1,1,2,4,6,8,10,13,15,18,20,22,25,27,28,30,31,32,33,34,35,35,35,35,36,36,36,36,36,36
E01003946,EV motorcycles,Number,0,1,2,3,5,6,8,10,12,14,16,17,19,21,22,23,24,25,26,26,27,27,27,28,28,28,28,28,28,28
E01003947,EV motorcycles,Number,0,1,2,3,4,5,7,8,10,11,13,14,16,17,18,19,20,21,21,22,22,22,23,23,23,23,23,23,23,23
E01003948,EV motorcycles,Number,0,1,2,3,5,7,9,11,13,15,17,19,21,22,24,25,26,27,28,28,29,29,29,30,30,30,30,30,30,30
E01003949,EV motorcycles,Number,1,1,2,4,6,8,10,13,15,18,20,22,25,27,28,30,31,32,33,34,35,35,35,35,36,36,36,36,36,36
E01003950,EV motorcycles,Number,0,1,2,3,5,6,8,10,11,13,15,17,18,20,21,22,23,24,25,25,26,26,26,27,27,27,27,27,27,27
E01003951,EV motorcycles,Number,0,1,2,4,6,7,10,12,14,16,18,21,23,24,26,27,29,30,31,31,32,32,32,33,33,33,33,33,33,33
E01003952,EV motorcycles,Number,0,1,2,3,4,5,7,9,10,12,13,15,16,18,19,20,21,22,22,23,23,23,23,24,24,24,24,24,24,24
E01003953,EV motorcycles,Number,0,1,1,2,3,4,5,6,7,8,10,11,12,13,13,14,15,15,16,16,16,16,17,17,17,17,17,17,17,17
E01003954,EV motorcycles,Number,0,1,1,2,3,4,5,6,7,8,10,11,12,13,13,14,15,15,16,16,16,16,17,17,17,17,17,17,17,17
E01003955,EV motorcycles,Number,0,1,2,3,5,7,8,10,12,14,16,18,20,21,23,24,25,26,27,27,28,28,28,29,29,29,29,29,29,29
E01003956,EV motorcycles,Number,0,1,1,2,3,4,5,6,8,9,10,11,12,13,14,15,16,16,17,17,17,17,18,18,18,18,18,18,18,18
E01003957,EV motorcycles,Number,1,1,2,4,6,9,11,13,16,19,21,24,26,28,30,32,33,34,35,36,36,37,37,37,38,38,38,38,38,38
E01003958,EV motorcycles,Number,0,1,2,4,5,7,9,11,14,16,18,20,22,24,25,27,28,29,30,30,31,31,31,32,32,32,32,32,32,32
E01003960,EV motorcycles,Number,0,1,1,2,4,5,6,8,9,11,12,14,15,16,17,18,19,20,20,21,21,21,22,22,22,22,22,22,22,22
E01003961,EV motorcycles,Number,0,1,1,2,4,5,6,8,9,11,12,14,15,16,17,18,19,20,20,21,21,21,22,22,22,22,22,22,22,22
E01003963,EV motorcycles,Number,0,1,1,2,3,4,5,6,8,9,10,11,12,13,14,15,16,16,17,17,17,17,18,18,18,18,18,18,18,18
E01003964,EV motorcycles,Number,0,1,2,3,5,7,8,10,12,14,16,18,20,21,23,24,25,26,27,27,28,28,28,29,29,29,29,29,29,29
E01003966,EV motorcycles,Number,0,1,2,3,5,7,9,11,13,15,17,19,21,22,24,25,26,27,28,28,29,29,29,30,30,30,30,30,30,30
E01003967,EV motorcycles,Number,0,0,1,1,2,3,3,4,5,6,7,7,8,9,9,10,10,11,11,11,12,12,12,12,12,12,12,12,12,12
E01003968,EV motorcycles,Number,0,0,1,1,1,2,2,3,3,4,4,5,5,6,6,7,7,7,7,8,8,8,8,8,8,8,8,8,8,8
E01003969,EV motorcycles,Number,1,1,3,5,7,9,12,15,17,20,23,26,28,30,32,34,36,37,38,39,39,40,40,40,41,41,41,41,41,41
E01003970,EV motorcycles,Number,0,0,1,1,2,2,3,4,4,5,6,6,7,7,8,8,9,9,9,9,10,10,10,10,10,10,10,10,10,10
E01003971,EV motorcycles,Number,0,0,1,1,2,2,3,4,4,5,6,6,7,7,8,8,9,9,9,9,10,10,10,10,10,10,10,10,10,10
E01003972,EV motorcycles,Number,0,0,1,1,2,2,3,3,4,4,5,6,6,7,7,7,8,8,8,8,9,9,9,9,9,9,9,9,9,9
E01003973,EV motorcycles,Number,0,1,2,3,4,5,7,8,10,11,13,14,16,17,18,19,20,21,21,22,22,22,23,23,23,23,23,23,23,23
E01003974,EV motorcycles,Number,0,0,0,1,1,2,2,2,3,3,4,4,5,5,6,6,6,6,6,7,7,7,7,7,7,7,7,7,7,7
E01003975,EV motorcycles,Number,0,1,1,2,3,3,4,5,6,7,8,9,10,11,12,12,13,13,14,14,14,15,15,15,15,15,15,15,15,15
E01003976,EV motorcycles,Number,1,1,3,4,7,9,11,14,16,19,22,24,27,29,31,32,34,35,36,37,37,38,38,38,39,39,39,39,39,39
E01003977,EV motorcycles,Number,0,1,2,3,4,6,7,9,11,12,14,16,17,18,20,21,22,22,23,24,24,24,24,25,25,25,25,25,25,25
E01003978,EV motorcycles,Number,1,1,2,4,6,8,10,12,15,17,20,22,24,26,28,29,30,31,32,33,34,34,34,34,35,35,35,35,35,35
E01003979,EV motorcycles,Number,0,1,2,4,5,7,9,11,14,16,18,20,22,24,25,27,28,29,30,30,31,31,31,32,32,32,32,32,32,32
E01003980,EV motorcycles,Number,0,1,2,3,4,5,7,9,10,12,13,15,16,18,19,20,21,22,22,23,23,23,23,24,24,24,24,24,24,24
E01003981,EV motorcycles,Number,0,0,1,1,2,3,4,5,5,6,7,8,9,10,10,11,11,12,12,12,12,13,13,13,13,13,13,13,13,13
E01003983,EV motorcycles,Number,0,1,1,2,3,4,5,7,8,9,11,12,13,14,15,16,17,17,18,18,18,18,19,19,19,19,19,19,19,19
E01003984,EV motorcycles,Number,0,1,2,3,5,6,8,10,12,14,16,17,19,21,22,23,24,25,26,26,27,27,27,28,28,28,28,28,28,28
E01003986,EV motorcycles,Number,0,1,2,3,4,5,7,9,10,12,13,15,16,18,19,20,21,22,22,23,23,23,23,24,24,24,24,24,24,24
E01003987,EV motorcycles,Number,0,1,1,2,3,4,5,6,7,8,10,11,12,13,13,14,15,15,16,16,16,16,17,17,17,17,17,17,17,17
E01003988,EV motorcycles,Number,0,1,2,4,5,7,9,11,14,16,18,20,22,24,25,27,28,29,30,30,31,31,31,32,32,32,32,32,32,32
E01003989,EV motorcycles,Number,0,1,1,2,3,4,5,6,8,9,10,11,12,13,14,15,16,16,17,17,17,17,18,18,18,18,18,18,18,18
E01003990,EV motorcycles,Number,0,0,1,1,2,2,3,4,4,5,6,6,7,7,8,8,9,9,9,9,10,10,10,10,10,10,10,10,10,10
E01003991,EV motorcycles,Number,0,0,0,0,0,0,0,0,0,0,0,0,0,0,0,0,0,0,0,0,0,0,0,0,0,0,0,0,0,0
E01003992,EV motorcycles,Number,0,1,1,2,3,3,4,5,6,7,8,9,10,11,12,12,13,13,14,14,14,15,15,15,15,15,15,15,15,15
E01003993,EV motorcycles,Number,0,1,1,2,3,4,5,6,7,8,9,10,11,12,13,13,14,14,15,15,15,16,16,16,16,16,16,16,16,16
E01003994,EV motorcycles,Number,0,1,1,2,3,4,5,7,8,9,11,12,13,14,15,16,17,17,18,18,18,18,19,19,19,19,19,19,19,19
E01003995,EV motorcycles,Number,0,1,2,3,4,5,7,9,10,12,13,15,16,18,19,20,21,22,22,23,23,23,23,24,24,24,24,24,24,24
E01003997,EV motorcycles,Number,0,1,1,2,3,3,4,5,6,7,8,9,10,11,12,12,13,13,14,14,14,15,15,15,15,15,15,15,15,15
E01003998,EV motorcycles,Number,0,0,1,1,2,3,4,5,5,6,7,8,9,10,10,11,11,12,12,12,12,13,13,13,13,13,13,13,13,13
E01003999,EV motorcycles,Number,0,0,1,1,2,3,4,5,5,6,7,8,9,10,10,11,11,12,12,12,12,13,13,13,13,13,13,13,13,13
E01004000,EV motorcycles,Number,0,1,2,3,4,5,7,9,10,12,13,15,16,18,19,20,21,22,22,23,23,23,23,24,24,24,24,24,24,24
E01004001,EV motorcycles,Number,0,1,1,2,3,4,5,6,8,9,10,11,12,13,14,15,16,16,17,17,17,17,18,18,18,18,18,18,18,18
E01004002,EV motorcycles,Number,0,1,1,2,4,5,6,7,9,10,12,13,14,16,17,17,18,19,19,20,20,20,21,21,21,21,21,21,21,21
E01004003,EV motorcycles,Number,0,1,1,2,3,4,5,7,8,9,11,12,13,14,15,16,17,17,18,18,18,18,19,19,19,19,19,19,19,19
E01004004,EV motorcycles,Number,0,1,2,3,4,6,8,9,11,13,15,16,18,19,20,22,23,23,24,25,25,25,25,26,26,26,26,26,26,26
E01004005,EV motorcycles,Number,0,1,1,2,3,4,6,7,8,10,11,12,14,15,16,17,17,18,18,19,19,19,20,20,20,20,20,20,20,20
E01004006,EV motorcycles,Number,0,0,1,1,2,3,3,4,5,6,7,7,8,9,9,10,10,11,11,11,12,12,12,12,12,12,12,12,12,12
E01004007,EV motorcycles,Number,0,1,1,2,3,4,5,6,8,9,10,11,12,13,14,15,16,16,17,17,17,17,18,18,18,18,18,18,18,18
E01004008,EV motorcycles,Number,0,1,1,2,3,4,5,6,8,9,10,11,12,13,14,15,16,16,17,17,17,17,18,18,18,18,18,18,18,18
E01004010,EV motorcycles,Number,0,1,2,3,4,6,8,9,11,13,15,16,18,19,20,22,23,23,24,25,25,25,25,26,26,26,26,26,26,26
E01004011,EV motorcycles,Number,0,1,1,2,3,4,5,7,8,9,11,12,13,14,15,16,17,17,18,18,18,18,19,19,19,19,19,19,19,19
E01004012,EV motorcycles,Number,0,1,2,3,5,7,8,10,12,14,16,18,20,21,23,24,25,26,27,27,28,28,28,29,29,29,29,29,29,29
E01004013,EV motorcycles,Number,0,1,1,2,3,4,6,7,8,10,11,12,14,15,16,17,17,18,18,19,19,19,20,20,20,20,20,20,20,20
E01004014,EV motorcycles,Number,0,1,2,3,5,6,8,10,11,13,15,17,18,20,21,22,23,24,25,25,26,26,26,27,27,27,27,27,27,27
E01004015,EV motorcycles,Number,0,1,1,2,4,5,6,8,9,11,12,14,15,16,17,18,19,20,20,21,21,21,22,22,22,22,22,22,22,22
E01004016,EV motorcycles,Number,0,1,2,3,5,6,8,10,12,14,16,17,19,21,22,23,24,25,26,26,27,27,27,28,28,28,28,28,28,28
E01004017,EV motorcycles,Number,0,1,2,4,5,7,9,11,14,16,18,20,22,24,25,27,28,29,30,30,31,31,31,32,32,32,32,32,32,32
E01004018,EV motorcycles,Number,0,1,2,4,6,7,10,12,14,16,18,21,23,24,26,27,29,30,31,31,32,32,32,33,33,33,33,33,33,33
E01004019,EV motorcycles,Number,0,1,2,3,4,6,7,9,11,12,14,16,17,18,20,21,22,22,23,24,24,24,24,25,25,25,25,25,25,25
E01004020,EV motorcycles,Number,0,1,2,3,4,6,8,9,11,13,15,16,18,19,20,22,23,23,24,25,25,25,25,26,26,26,26,26,26,26
E01004021,EV motorcycles,Number,1,3,5,8,12,16,21,26,31,36,41,45,50,54,58,61,63,66,67,69,70,71,71,72,72,72,73,73,73,73
E01004022,EV motorcycles,Number,0,1,2,3,5,6,8,10,12,14,16,17,19,21,22,23,24,25,26,26,27,27,27,28,28,28,28,28,28,28
E01004023,EV motorcycles,Number,0,1,1,2,4,5,6,7,9,10,12,13,14,16,17,17,18,19,19,20,20,20,21,21,21,21,21,21,21,21
E01004024,EV motorcycles,Number,0,1,2,4,6,8,10,12,14,17,19,21,23,25,27,28,30,31,31,32,33,33,33,33,34,34,34,34,34,34
E01004027,EV motorcycles,Number,0,1,1,2,3,4,5,6,8,9,10,11,12,13,14,15,16,16,17,17,17,17,18,18,18,18,18,18,18,18
E01004028,EV motorcycles,Number,0,1,1,2,3,4,5,6,7,8,10,11,12,13,13,14,15,15,16,16,16,16,17,17,17,17,17,17,17,17
E01004029,EV motorcycles,Number,0,1,1,2,3,3,4,5,6,7,8,9,10,11,12,12,13,13,14,14,14,15,15,15,15,15,15,15,15,15
E01004030,EV motorcycles,Number,0,1,1,2,4,5,6,7,9,10,12,13,14,16,17,17,18,19,19,20,20,20,21,21,21,21,21,21,21,21
E01004031,EV motorcycles,Number,0,1,2,3,5,6,8,10,12,14,16,17,19,21,22,23,24,25,26,26,27,27,27,28,28,28,28,28,28,28
E01004032,EV motorcycles,Number,0,1,2,3,4,5,7,9,10,12,13,15,16,18,19,20,21,22,22,23,23,23,23,24,24,24,24,24,24,24
E01004033,EV motorcycles,Number,0,1,2,3,5,7,9,11,13,15,17,19,21,23,24,26,27,28,29,29,30,30,30,31,31,31,31,31,31,31
E01004034,EV motorcycles,Number,0,1,2,3,5,6,8,10,12,14,16,17,19,21,22,23,24,25,26,26,27,27,27,28,28,28,28,28,28,28
E01004035,EV motorcycles,Number,0,1,2,3,4,6,8,9,11,13,15,16,18,19,20,22,23,23,24,25,25,25,25,26,26,26,26,26,26,26
E01004036,EV motorcycles,Number,0,1,1,2,3,4,6,7,8,10,11,12,14,15,16,17,17,18,18,19,19,19,20,20,20,20,20,20,20,20
E01004037,EV motorcycles,Number,0,1,2,4,5,7,9,11,14,16,18,20,22,24,25,27,28,29,30,30,31,31,31,32,32,32,32,32,32,32
E01004038,EV motorcycles,Number,1,2,3,5,8,10,13,16,19,23,26,29,31,34,36,38,40,41,43,43,44,45,45,45,46,46,46,46,46,46
E01004039,EV motorcycles,Number,0,1,2,3,4,6,8,9,11,13,15,16,18,19,20,22,23,23,24,25,25,25,25,26,26,26,26,26,26,26
E01004040,EV motorcycles,Number,0,0,0,1,1,2,2,2,3,3,4,4,5,5,6,6,6,6,6,7,7,7,7,7,7,7,7,7,7,7
E01004041,EV motorcycles,Number,0,1,2,3,4,6,7,9,11,12,14,16,17,18,20,21,22,22,23,24,24,24,24,25,25,25,25,25,25,25
E01004042,EV motorcycles,Number,0,1,2,3,5,7,9,11,13,15,17,19,21,22,24,25,26,27,28,28,29,29,29,30,30,30,30,30,30,30
E01004043,EV motorcycles,Number,0,0,1,1,2,3,4,5,5,6,7,8,9,10,10,11,11,12,12,12,12,13,13,13,13,13,13,13,13,13
E01004044,EV motorcycles,Number,0,1,2,3,5,6,8,10,11,13,15,17,18,20,21,22,23,24,25,25,26,26,26,27,27,27,27,27,27,27
E01004045,EV motorcycles,Number,0,0,0,1,1,2,2,2,3,3,4,4,5,5,6,6,6,6,6,7,7,7,7,7,7,7,7,7,7,7
E01004046,EV motorcycles,Number,0,1,1,2,3,4,5,6,8,9,10,11,12,13,14,15,16,16,17,17,17,17,18,18,18,18,18,18,18,18
E01004047,EV motorcycles,Number,0,0,1,1,2,2,3,4,4,5,6,6,7,7,8,8,9,9,9,9,10,10,10,10,10,10,10,10,10,10
E01004048,EV motorcycles,Number,0,1,1,2,3,4,6,7,8,10,11,12,14,15,16,17,17,18,18,19,19,19,20,20,20,20,20,20,20,20
E01004049,EV motorcycles,Number,0,0,1,1,2,2,3,4,5,5,6,7,8,8,9,9,10,10,10,10,11,11,11,11,11,11,11,11,11,11
E01004050,EV motorcycles,Number,0,1,2,3,5,7,8,10,12,14,16,18,20,21,23,24,25,26,27,27,28,28,28,29,29,29,29,29,29,29
E01004051,EV motorcycles,Number,0,0,1,1,2,3,3,4,5,6,7,7,8,9,9,10,10,11,11,11,12,12,12,12,12,12,12,12,12,12
E01004052,EV motorcycles,Number,0,1,1,2,3,4,5,6,8,9,10,11,12,13,14,15,16,16,17,17,17,17,18,18,18,18,18,18,18,18
E01004053,EV motorcycles,Number,0,1,2,4,6,7,10,12,14,16,18,21,23,24,26,27,29,30,31,31,32,32,32,33,33,33,33,33,33,33
E01004054,EV motorcycles,Number,0,1,2,3,5,7,9,11,13,15,17,19,21,23,24,26,27,28,29,29,30,30,30,31,31,31,31,31,31,31
E01004055,EV motorcycles,Number,0,1,1,2,2,3,4,5,6,7,8,9,10,10,11,12,12,13,13,13,13,14,14,14,14,14,14,14,14,14
E01004056,EV motorcycles,Number,1,1,3,4,7,9,12,14,17,20,22,25,27,30,32,33,35,36,37,38,38,39,39,39,40,40,40,40,40,40
E01004057,EV motorcycles,Number,0,1,2,3,5,7,9,11,13,15,17,19,21,22,24,25,26,27,28,28,29,29,29,30,30,30,30,30,30,30
E01004058,EV motorcycles,Number,0,1,2,3,5,6,8,10,11,13,15,17,18,20,21,22,23,24,25,25,26,26,26,27,27,27,27,27,27,27
E01004059,EV motorcycles,Number,0,1,2,3,5,6,8,10,12,14,16,17,19,21,22,23,24,25,26,26,27,27,27,28,28,28,28,28,28,28
E01004060,EV motorcycles,Number,1,2,3,5,7,10,13,16,19,22,25,27,30,33,35,37,38,40,41,42,42,43,43,43,44,44,44,44,44,44
E01004061,EV motorcycles,Number,0,1,1,2,3,4,5,6,7,8,9,10,11,12,13,13,14,14,15,15,15,16,16,16,16,16,16,16,16,16
E01004062,EV motorcycles,Number,0,1,2,3,5,6,8,10,11,13,15,17,18,20,21,22,23,24,25,25,26,26,26,27,27,27,27,27,27,27
E01004063,EV motorcycles,Number,0,1,1,2,3,4,5,6,7,8,9,10,11,12,13,13,14,14,15,15,15,16,16,16,16,16,16,16,16,16
E01004064,EV motorcycles,Number,0,1,1,2,4,5,6,7,9,10,12,13,14,16,17,17,18,19,19,20,20,20,21,21,21,21,21,21,21,21
E01004065,EV motorcycles,Number,0,1,1,2,3,4,5,6,8,9,10,11,12,13,14,15,16,16,17,17,17,17,18,18,18,18,18,18,18,18
E01004066,EV motorcycles,Number,0,1,1,2,3,4,5,7,8,9,11,12,13,14,15,16,17,17,18,18,18,18,19,19,19,19,19,19,19,19
E01004067,EV motorcycles,Number,1,1,2,4,6,8,11,13,16,18,21,23,25,27,29,31,32,33,34,35,35,36,36,36,37,37,37,37,37,37
E01004068,EV motorcycles,Number,0,0,1,1,2,3,4,5,5,6,7,8,9,10,10,11,11,12,12,12,12,13,13,13,13,13,13,13,13,13
E01004069,EV motorcycles,Number,0,1,1,2,3,4,6,7,8,10,11,12,14,15,16,17,17,18,18,19,19,19,20,20,20,20,20,20,20,20
E01004070,EV motorcycles,Number,0,1,2,3,4,5,7,8,10,11,13,14,16,17,18,19,20,21,21,22,22,22,23,23,23,23,23,23,23,23
E01004071,EV motorcycles,Number,0,1,2,3,5,7,9,11,13,15,17,19,21,22,24,25,26,27,28,28,29,29,29,30,30,30,30,30,30,30
E01004072,EV motorcycles,Number,0,1,2,3,5,6,8,10,12,14,16,17,19,21,22,23,24,25,26,26,27,27,27,28,28,28,28,28,28,28
E01004073,EV motorcycles,Number,0,1,1,2,3,4,5,7,8,9,11,12,13,14,15,16,17,17,18,18,18,18,19,19,19,19,19,19,19,19
E01004074,EV motorcycles,Number,0,1,1,2,3,4,6,7,8,10,11,12,14,15,16,17,17,18,18,19,19,19,20,20,20,20,20,20,20,20
E01004075,EV motorcycles,Number,0,1,1,2,3,3,4,5,6,7,8,9,10,11,12,12,13,13,14,14,14,15,15,15,15,15,15,15,15,15
E01004076,EV motorcycles,Number,1,1,2,4,6,9,11,13,16,19,21,24,26,28,30,32,33,34,35,36,36,37,37,37,38,38,38,38,38,38
E01004077,EV motorcycles,Number,0,1,2,3,5,6,8,10,12,14,16,17,19,21,22,23,24,25,26,26,27,27,27,28,28,28,28,28,28,28
E01004078,EV motorcycles,Number,0,1,2,3,5,6,8,10,11,13,15,17,18,20,21,22,23,24,25,25,26,26,26,27,27,27,27,27,27,27
E01004079,EV motorcycles,Number,0,1,2,3,5,7,8,10,12,14,16,18,20,21,23,24,25,26,27,27,28,28,28,29,29,29,29,29,29,29
E01004080,EV motorcycles,Number,0,1,2,3,4,5,7,8,10,11,13,14,16,17,18,19,20,21,21,22,22,22,23,23,23,23,23,23,23,23
E01004081,EV motorcycles,Number,0,0,1,1,2,2,3,4,5,5,6,7,8,8,9,9,10,10,10,10,11,11,11,11,11,11,11,11,11,11
E01004082,EV motorcycles,Number,0,1,2,3,4,6,7,9,11,12,14,16,17,18,20,21,22,22,23,24,24,24,24,25,25,25,25,25,25,25
E01004083,EV motorcycles,Number,0,1,2,3,4,6,8,9,11,13,15,16,18,19,20,22,23,23,24,25,25,25,25,26,26,26,26,26,26,26
E01004084,EV motorcycles,Number,0,1,1,2,3,3,4,5,6,7,8,9,10,11,12,12,13,13,14,14,14,15,15,15,15,15,15,15,15,15
E01004085,EV motorcycles,Number,0,1,1,2,3,4,5,6,7,8,10,11,12,13,13,14,15,15,16,16,16,16,17,17,17,17,17,17,17,17
E01004086,EV motorcycles,Number,0,1,1,2,4,5,6,7,9,10,12,13,14,16,17,17,18,19,19,20,20,20,21,21,21,21,21,21,21,21
E01004087,EV motorcycles,Number,0,1,1,2,4,5,6,7,9,10,12,13,14,16,17,17,18,19,19,20,20,20,21,21,21,21,21,21,21,21
E01004088,EV motorcycles,Number,0,1,2,3,4,6,7,9,11,12,14,16,17,18,20,21,22,22,23,24,24,24,24,25,25,25,25,25,25,25
E01004089,EV motorcycles,Number,0,1,1,2,2,3,4,5,6,7,8,9,10,10,11,12,12,13,13,13,13,14,14,14,14,14,14,14,14,14
E01004090,EV motorcycles,Number,0,1,1,2,3,4,5,7,8,9,11,12,13,14,15,16,17,17,18,18,18,18,19,19,19,19,19,19,19,19
E01004091,EV motorcycles,Number,0,1,1,2,3,4,5,6,8,9,10,11,12,13,14,15,16,16,17,17,17,17,18,18,18,18,18,18,18,18
E01004092,EV motorcycles,Number,1,1,3,4,7,9,11,14,16,19,22,24,27,29,31,32,34,35,36,37,37,38,38,38,39,39,39,39,39,39
E01004093,EV motorcycles,Number,0,1,1,2,4,5,6,7,9,10,12,13,14,16,17,17,18,19,19,20,20,20,21,21,21,21,21,21,21,21
E01004094,EV motorcycles,Number,0,1,2,3,5,6,8,10,11,13,15,17,18,20,21,22,23,24,25,25,26,26,26,27,27,27,27,27,27,27
E01004095,EV motorcycles,Number,0,1,1,2,3,4,6,7,8,10,11,12,14,15,16,17,17,18,18,19,19,19,20,20,20,20,20,20,20,20
E01004096,EV motorcycles,Number,0,1,2,3,5,7,9,11,13,15,17,19,21,22,24,25,26,27,28,28,29,29,29,30,30,30,30,30,30,30
E01004097,EV motorcycles,Number,0,1,2,4,5,7,9,11,14,16,18,20,22,24,25,27,28,29,30,30,31,31,31,32,32,32,32,32,32,32
E01004098,EV motorcycles,Number,0,1,1,2,3,4,6,7,8,10,11,12,14,15,16,17,17,18,18,19,19,19,20,20,20,20,20,20,20,20
E01004099,EV motorcycles,Number,1,2,3,6,9,11,15,18,22,25,29,32,35,38,40,42,44,46,47,48,49,49,50,50,50,51,51,51,51,51
E01004100,EV motorcycles,Number,0,1,2,3,5,7,9,11,13,15,17,19,21,22,24,25,26,27,28,28,29,29,29,30,30,30,30,30,30,30
E01004101,EV motorcycles,Number,1,1,2,4,6,8,10,13,15,18,20,22,25,27,28,30,31,32,33,34,35,35,35,35,36,36,36,36,36,36
E01004102,EV motorcycles,Number,0,1,2,3,4,5,7,8,10,11,13,14,16,17,18,19,20,21,21,22,22,22,23,23,23,23,23,23,23,23
E01004103,EV motorcycles,Number,1,1,2,4,6,8,11,13,16,18,21,23,25,27,29,31,32,33,34,35,35,36,36,36,37,37,37,37,37,37
E01004104,EV motorcycles,Number,1,1,2,4,6,8,11,13,16,18,21,23,25,27,29,31,32,33,34,35,35,36,36,36,37,37,37,37,37,37
E01004105,EV motorcycles,Number,0,1,1,2,4,5,6,8,9,11,12,14,15,16,17,18,19,20,20,21,21,21,22,22,22,22,22,22,22,22
E01004106,EV motorcycles,Number,0,1,2,4,6,8,10,12,14,17,19,21,23,25,27,28,30,31,31,32,33,33,33,33,34,34,34,34,34,34
E01004107,EV motorcycles,Number,1,2,3,5,7,10,12,15,18,21,24,27,29,32,34,36,37,39,40,41,41,42,42,42,43,43,43,43,43,43
E01004108,EV motorcycles,Number,1,2,4,7,11,14,19,23,27,31,36,40,44,47,50,53,56,58,59,60,61,62,63,63,63,64,64,64,64,64
E01004109,EV motorcycles,Number,1,2,4,6,10,13,16,20,24,28,32,35,39,42,45,47,50,51,53,54,55,55,56,56,56,57,57,57,57,57
E01004110,EV motorcycles,Number,0,1,2,3,4,5,7,9,10,12,13,15,16,18,19,20,21,22,22,23,23,23,23,24,24,24,24,24,24,24
E01004111,EV motorcycles,Number,0,1,2,3,5,6,8,10,12,14,16,17,19,21,22,23,24,25,26,26,27,27,27,28,28,28,28,28,28,28
E01004112,EV motorcycles,Number,0,1,2,3,4,6,7,9,11,12,14,16,17,18,20,21,22,22,23,24,24,24,24,25,25,25,25,25,25,25
E01004114,EV motorcycles,Number,0,1,2,3,4,5,7,8,10,11,13,14,16,17,18,19,20,21,21,22,22,22,23,23,23,23,23,23,23,23
E01004115,EV motorcycles,Number,1,2,3,6,9,12,15,18,22,26,29,32,36,38,41,43,45,47,48,49,50,50,51,51,51,52,52,52,52,52
E01004116,EV motorcycles,Number,0,1,1,2,4,5,6,7,9,10,12,13,14,16,17,17,18,19,19,20,20,20,21,21,21,21,21,21,21,21
E01004117,EV motorcycles,Number,1,2,3,5,8,11,14,17,20,23,26,29,32,35,37,39,41,42,43,44,45,46,46,46,47,47,47,47,47,47
E01004118,EV motorcycles,Number,0,1,2,3,4,6,7,9,11,12,14,16,17,18,20,21,22,22,23,24,24,24,24,25,25,25,25,25,25,25
E01004119,EV motorcycles,Number,0,1,2,3,5,6,8,10,12,14,16,17,19,21,22,23,24,25,26,26,27,27,27,28,28,28,28,28,28,28
E01004120,EV motorcycles,Number,0,1,2,3,4,5,7,9,10,12,13,15,16,18,19,20,21,22,22,23,23,23,23,24,24,24,24,24,24,24
E01004121,EV motorcycles,Number,0,1,2,4,6,7,10,12,14,16,18,21,23,24,26,27,29,30,31,31,32,32,32,33,33,33,33,33,33,33
E01004122,EV motorcycles,Number,0,1,1,2,3,4,5,7,8,9,11,12,13,14,15,16,17,17,18,18,18,18,19,19,19,19,19,19,19,19
E01004123,EV motorcycles,Number,1,1,3,4,7,9,11,14,16,19,22,24,27,29,31,32,34,35,36,37,37,38,38,38,39,39,39,39,39,39
E01004124,EV motorcycles,Number,1,2,4,6,9,13,16,20,24,28,31,35,38,41,44,47,49,50,52,53,54,54,55,55,55,56,56,56,56,56
E01004125,EV motorcycles,Number,0,1,1,2,3,4,6,7,8,10,11,12,14,15,16,17,17,18,18,19,19,19,20,20,20,20,20,20,20,20
E01004126,EV motorcycles,Number,1,2,3,6,9,12,15,19,22,26,30,33,36,39,42,44,46,48,49,50,51,51,52,52,52,53,53,53,53,53
E01004127,EV motorcycles,Number,0,1,2,3,5,7,9,11,13,15,17,19,21,23,24,26,27,28,29,29,30,30,30,31,31,31,31,31,31,31
E01004128,EV motorcycles,Number,0,1,2,3,5,6,8,10,12,14,16,17,19,21,22,23,24,25,26,26,27,27,27,28,28,28,28,28,28,28
E01004129,EV motorcycles,Number,0,1,2,3,4,5,7,8,10,11,13,14,16,17,18,19,20,21,21,22,22,22,23,23,23,23,23,23,23,23
E01004130,EV motorcycles,Number,1,2,3,5,8,11,14,17,20,23,26,29,32,35,37,39,41,42,43,44,45,46,46,46,47,47,47,47,47,47
E01004131,EV motorcycles,Number,1,2,3,5,7,10,12,15,18,21,24,27,29,32,34,36,37,39,40,41,41,42,42,42,43,43,43,43,43,43
E01004132,EV motorcycles,Number,0,1,1,2,4,5,6,7,9,10,12,13,14,16,17,17,18,19,19,20,20,20,21,21,21,21,21,21,21,21
E01004133,EV motorcycles,Number,0,1,2,4,6,8,10,12,14,17,19,21,23,25,27,28,30,31,31,32,33,33,33,33,34,34,34,34,34,34
E01004134,EV motorcycles,Number,0,1,2,3,5,7,8,10,12,14,16,18,20,21,23,24,25,26,27,27,28,28,28,29,29,29,29,29,29,29
E01004135,EV motorcycles,Number,0,1,2,3,5,6,8,10,12,14,16,17,19,21,22,23,24,25,26,26,27,27,27,28,28,28,28,28,28,28
E01004136,EV motorcycles,Number,0,1,1,2,4,5,6,8,9,11,12,14,15,16,17,18,19,20,20,21,21,21,22,22,22,22,22,22,22,22
E01004137,EV motorcycles,Number,1,1,3,4,7,9,12,14,17,20,22,25,27,30,32,33,35,36,37,38,38,39,39,39,40,40,40,40,40,40
E01004138,EV motorcycles,Number,1,1,2,4,6,8,10,12,15,17,20,22,24,26,28,29,30,31,32,33,34,34,34,34,35,35,35,35,35,35
E01004139,EV motorcycles,Number,0,1,1,2,3,4,5,6,8,9,10,11,12,13,14,15,16,16,17,17,17,17,18,18,18,18,18,18,18,18
E01004140,EV motorcycles,Number,0,1,2,4,6,7,10,12,14,16,18,21,23,24,26,27,29,30,31,31,32,32,32,33,33,33,33,33,33,33
E01004141,EV motorcycles,Number,0,1,2,4,5,7,9,11,14,16,18,20,22,24,25,27,28,29,30,30,31,31,31,32,32,32,32,32,32,32
E01004142,EV motorcycles,Number,1,1,2,4,6,9,11,13,16,19,21,24,26,28,30,32,33,34,35,36,36,37,37,37,38,38,38,38,38,38
E01004143,EV motorcycles,Number,0,1,2,3,4,5,7,9,10,12,13,15,16,18,19,20,21,22,22,23,23,23,23,24,24,24,24,24,24,24
E01004144,EV motorcycles,Number,1,1,2,4,6,8,10,12,15,17,20,22,24,26,28,29,30,31,32,33,34,34,34,34,35,35,35,35,35,35
E01004145,EV motorcycles,Number,1,1,3,4,7,9,12,14,17,20,22,25,27,30,32,33,35,36,37,38,38,39,39,39,40,40,40,40,40,40
E01004146,EV motorcycles,Number,1,2,3,6,9,12,15,18,22,26,29,32,36,38,41,43,45,47,48,49,50,50,51,51,51,52,52,52,52,52
E01004147,EV motorcycles,Number,0,1,2,3,4,6,8,9,11,13,15,16,18,19,20,22,23,23,24,25,25,25,25,26,26,26,26,26,26,26
E01004148,EV motorcycles,Number,0,1,2,3,4,5,7,8,10,11,13,14,16,17,18,19,20,21,21,22,22,22,23,23,23,23,23,23,23,23
E01004149,EV motorcycles,Number,1,2,3,5,7,9,12,15,18,21,24,26,29,31,33,35,36,38,39,40,40,41,41,41,42,42,42,42,42,42
E01004150,EV motorcycles,Number,0,1,2,4,6,7,10,12,14,16,18,21,23,24,26,27,29,30,31,31,32,32,32,33,33,33,33,33,33,33
E01004151,EV motorcycles,Number,0,1,2,3,5,7,9,11,13,15,17,19,21,23,24,26,27,28,29,29,30,30,30,31,31,31,31,31,31,31
E01004152,EV motorcycles,Number,0,1,2,3,5,7,9,11,13,15,17,19,21,23,24,26,27,28,29,29,30,30,30,31,31,31,31,31,31,31
E01004153,EV motorcycles,Number,0,1,2,3,4,5,7,8,10,11,13,14,16,17,18,19,20,21,21,22,22,22,23,23,23,23,23,23,23,23
E01004154,EV motorcycles,Number,0,1,2,3,4,6,8,9,11,13,15,16,18,19,20,22,23,23,24,25,25,25,25,26,26,26,26,26,26,26
E01004155,EV motorcycles,Number,0,1,2,4,5,7,9,11,14,16,18,20,22,24,25,27,28,29,30,30,31,31,31,32,32,32,32,32,32,32
E01004156,EV motorcycles,Number,0,1,1,2,3,3,4,5,6,7,8,9,10,11,12,12,13,13,14,14,14,15,15,15,15,15,15,15,15,15
E01004157,EV motorcycles,Number,0,1,1,2,3,3,4,5,6,7,8,9,10,11,12,12,13,13,14,14,14,15,15,15,15,15,15,15,15,15
E01004158,EV motorcycles,Number,0,1,2,3,4,5,7,8,10,11,13,14,16,17,18,19,20,21,21,22,22,22,23,23,23,23,23,23,23,23
E01004159,EV motorcycles,Number,1,1,3,5,7,9,12,15,17,20,23,26,28,30,32,34,36,37,38,39,39,40,40,40,41,41,41,41,41,41
E01004160,EV motorcycles,Number,0,1,2,3,5,7,9,11,13,15,17,19,21,22,24,25,26,27,28,28,29,29,29,30,30,30,30,30,30,30
E01004161,EV motorcycles,Number,0,0,1,1,2,3,3,4,5,6,7,7,8,9,9,10,10,11,11,11,12,12,12,12,12,12,12,12,12,12
E01004162,EV motorcycles,Number,1,1,3,4,7,9,11,14,16,19,22,24,27,29,31,32,34,35,36,37,37,38,38,38,39,39,39,39,39,39
E01004163,EV motorcycles,Number,0,1,2,3,5,7,9,11,13,15,17,19,21,23,24,26,27,28,29,29,30,30,30,31,31,31,31,31,31,31
E01004164,EV motorcycles,Number,1,2,3,5,7,10,12,15,18,21,24,27,29,32,34,36,37,39,40,41,41,42,42,42,43,43,43,43,43,43
E01004165,EV motorcycles,Number,0,1,2,3,4,5,7,8,10,11,13,14,16,17,18,19,20,21,21,22,22,22,23,23,23,23,23,23,23,23
E01004166,EV motorcycles,Number,0,1,2,3,5,6,8,10,11,13,15,17,18,20,21,22,23,24,25,25,26,26,26,27,27,27,27,27,27,27
E01004167,EV motorcycles,Number,0,1,1,2,4,5,6,7,9,10,12,13,14,16,17,17,18,19,19,20,20,20,21,21,21,21,21,21,21,21
E01004168,EV motorcycles,Number,1,1,3,4,7,9,12,14,17,20,22,25,27,30,32,33,35,36,37,38,38,39,39,39,40,40,40,40,40,40
E01004169,EV motorcycles,Number,0,1,2,3,5,6,8,10,11,13,15,17,18,20,21,22,23,24,25,25,26,26,26,27,27,27,27,27,27,27
E01004170,EV motorcycles,Number,0,1,2,3,4,6,7,9,11,12,14,16,17,18,20,21,22,22,23,24,24,24,24,25,25,25,25,25,25,25
E01004171,EV motorcycles,Number,1,1,3,4,7,9,11,14,16,19,22,24,27,29,31,32,34,35,36,37,37,38,38,38,39,39,39,39,39,39
E01004172,EV motorcycles,Number,1,1,2,4,6,8,11,13,16,18,21,23,25,27,29,31,32,33,34,35,35,36,36,36,37,37,37,37,37,37
E01004173,EV motorcycles,Number,0,0,1,1,2,3,3,4,5,6,7,7,8,9,9,10,10,11,11,11,12,12,12,12,12,12,12,12,12,12
E01004174,EV motorcycles,Number,0,1,2,3,4,6,8,9,11,13,15,16,18,19,20,22,23,23,24,25,25,25,25,26,26,26,26,26,26,26
E01004175,EV motorcycles,Number,0,1,2,3,4,6,8,9,11,13,15,16,18,19,20,22,23,23,24,25,25,25,25,26,26,26,26,26,26,26
E01004176,EV motorcycles,Number,0,1,2,4,6,7,10,12,14,16,18,21,23,24,26,27,29,30,31,31,32,32,32,33,33,33,33,33,33,33
E01004177,EV motorcycles,Number,0,1,2,3,4,5,7,8,10,11,13,14,16,17,18,19,20,21,21,22,22,22,23,23,23,23,23,23,23,23
E01004178,EV motorcycles,Number,1,1,2,4,6,8,11,13,16,18,21,23,25,27,29,31,32,33,34,35,35,36,36,36,37,37,37,37,37,37
E01004179,EV motorcycles,Number,1,1,2,4,6,8,10,12,15,17,20,22,24,26,28,29,30,31,32,33,34,34,34,34,35,35,35,35,35,35
E01004180,EV motorcycles,Number,1,1,3,5,7,9,12,15,17,20,23,26,28,30,32,34,36,37,38,39,39,40,40,40,41,41,41,41,41,41
E01004181,EV motorcycles,Number,0,1,2,3,4,5,7,8,10,11,13,14,16,17,18,19,20,21,21,22,22,22,23,23,23,23,23,23,23,23
E01004182,EV motorcycles,Number,0,1,2,3,5,6,8,10,11,13,15,17,18,20,21,22,23,24,25,25,26,26,26,27,27,27,27,27,27,27
E01004183,EV motorcycles,Number,0,1,2,3,5,7,9,11,13,15,17,19,21,23,24,26,27,28,29,29,30,30,30,31,31,31,31,31,31,31
E01004184,EV motorcycles,Number,0,1,2,3,5,6,8,10,12,14,16,17,19,21,22,23,24,25,26,26,27,27,27,28,28,28,28,28,28,28
E01004185,EV motorcycles,Number,0,1,2,3,5,6,8,10,11,13,15,17,18,20,21,22,23,24,25,25,26,26,26,27,27,27,27,27,27,27
E01004186,EV motorcycles,Number,0,1,2,4,6,8,10,12,14,17,19,21,23,25,27,28,30,31,31,32,33,33,33,33,34,34,34,34,34,34
E01004187,EV motorcycles,Number,1,2,3,6,9,12,15,19,22,26,30,33,36,39,42,44,46,48,49,50,51,51,52,52,52,53,53,53,53,53
E01004188,EV motorcycles,Number,1,2,3,5,8,11,14,17,20,23,26,29,32,35,37,39,41,42,43,44,45,46,46,46,47,47,47,47,47,47
E01004189,EV motorcycles,Number,1,1,3,5,7,9,12,15,17,20,23,26,28,30,32,34,36,37,38,39,39,40,40,40,41,41,41,41,41,41
E01004190,EV motorcycles,Number,0,1,2,3,5,7,9,11,13,15,17,19,21,22,24,25,26,27,28,28,29,29,29,30,30,30,30,30,30,30
E01004191,EV motorcycles,Number,1,1,2,4,6,8,10,13,15,18,20,22,25,27,28,30,31,32,33,34,35,35,35,35,36,36,36,36,36,36
E01004192,EV motorcycles,Number,0,1,2,3,5,7,9,11,13,15,17,19,21,23,24,26,27,28,29,29,30,30,30,31,31,31,31,31,31,31
E01004193,EV motorcycles,Number,1,2,4,7,11,15,20,24,29,33,38,42,46,50,54,57,59,61,63,64,65,66,67,67,67,68,68,68,68,68
E01004194,EV motorcycles,Number,0,1,2,4,6,8,10,12,14,17,19,21,23,25,27,28,30,31,31,32,33,33,33,33,34,34,34,34,34,34
E01004195,EV motorcycles,Number,1,2,4,7,10,13,17,21,25,30,34,37,41,44,47,50,52,54,55,57,58,58,59,59,59,60,60,60,60,60
E01004196,EV motorcycles,Number,0,1,2,3,5,6,8,10,12,14,16,17,19,21,22,23,24,25,26,26,27,27,27,28,28,28,28,28,28,28
E01004197,EV motorcycles,Number,0,1,2,4,6,7,10,12,14,16,18,21,23,24,26,27,29,30,31,31,32,32,32,33,33,33,33,33,33,33
E01004198,EV motorcycles,Number,3,7,12,20,30,40,52,64,76,89,101,112,123,133,142,150,156,162,166,170,173,175,176,177,178,179,180,180,180,180
E01004199,EV motorcycles,Number,0,1,1,2,3,4,5,6,7,8,10,11,12,13,13,14,15,15,16,16,16,16,17,17,17,17,17,17,17,17
E01004200,EV motorcycles,Number,0,0,0,1,1,1,2,2,3,3,3,4,4,4,5,5,5,5,6,6,6,6,6,6,6,6,6,6,6,6
E01004201,EV motorcycles,Number,0,1,1,2,3,4,5,6,7,8,9,10,11,12,13,13,14,14,15,15,15,16,16,16,16,16,16,16,16,16
E01004202,EV motorcycles,Number,0,1,2,3,5,7,8,10,12,14,16,18,20,21,23,24,25,26,27,27,28,28,28,29,29,29,29,29,29,29
E01004203,EV motorcycles,Number,0,0,1,1,1,2,2,3,3,4,4,5,5,6,6,7,7,7,7,8,8,8,8,8,8,8,8,8,8,8
E01004204,EV motorcycles,Number,0,1,1,2,3,4,5,6,7,8,10,11,12,13,13,14,15,15,16,16,16,16,17,17,17,17,17,17,17,17
E01004205,EV motorcycles,Number,1,2,3,5,8,10,13,16,19,22,25,28,31,33,35,37,39,40,42,42,43,44,44,44,45,45,45,45,45,45
E01004206,EV motorcycles,Number,1,2,4,7,11,15,19,23,28,32,37,41,45,49,52,55,57,59,61,62,63,64,65,65,65,66,66,66,66,66
E01004207,EV motorcycles,Number,0,0,1,1,2,2,3,4,5,5,6,7,8,8,9,9,10,10,10,10,11,11,11,11,11,11,11,11,11,11
E01004208,EV motorcycles,Number,0,1,1,2,3,4,5,6,7,8,9,10,11,12,13,13,14,14,15,15,15,16,16,16,16,16,16,16,16,16
E01004209,EV motorcycles,Number,0,0,1,1,2,2,3,4,5,5,6,7,8,8,9,9,10,10,10,10,11,11,11,11,11,11,11,11,11,11
E01004211,EV motorcycles,Number,0,1,1,2,3,4,6,7,8,10,11,12,14,15,16,17,17,18,18,19,19,19,20,20,20,20,20,20,20,20
E01004212,EV motorcycles,Number,0,1,2,3,5,6,8,10,11,13,15,17,18,20,21,22,23,24,25,25,26,26,26,27,27,27,27,27,27,27
E01004214,EV motorcycles,Number,0,0,0,1,1,2,2,2,3,3,4,4,5,5,6,6,6,6,6,7,7,7,7,7,7,7,7,7,7,7
E01004215,EV motorcycles,Number,1,3,5,8,13,17,22,27,33,38,43,48,53,57,61,64,67,69,71,73,74,75,75,76,76,76,77,77,77,77
E01004216,EV motorcycles,Number,0,1,1,2,3,4,5,6,8,9,10,11,12,13,14,15,16,16,17,17,17,17,18,18,18,18,18,18,18,18
E01004217,EV motorcycles,Number,0,1,1,2,3,4,5,6,7,8,9,10,11,12,13,13,14,14,15,15,15,16,16,16,16,16,16,16,16,16
E01004218,EV motorcycles,Number,0,1,1,2,3,4,5,7,8,9,11,12,13,14,15,16,17,17,18,18,18,18,19,19,19,19,19,19,19,19
E01004219,EV motorcycles,Number,0,1,1,2,3,4,5,7,8,9,11,12,13,14,15,16,17,17,18,18,18,18,19,19,19,19,19,19,19,19
E01004221,EV motorcycles,Number,0,1,2,3,4,5,7,8,10,11,13,14,16,17,18,19,20,21,21,22,22,22,23,23,23,23,23,23,23,23
E01004222,EV motorcycles,Number,0,1,2,3,5,6,8,10,12,14,16,17,19,21,22,23,24,25,26,26,27,27,27,28,28,28,28,28,28,28
E01004223,EV motorcycles,Number,0,1,1,2,4,5,6,7,9,10,12,13,14,16,17,17,18,19,19,20,20,20,21,21,21,21,21,21,21,21
E01004224,EV motorcycles,Number,1,2,3,5,8,11,14,17,20,23,26,29,32,35,37,39,41,42,43,44,45,46,46,46,47,47,47,47,47,47
E01004225,EV motorcycles,Number,0,1,2,3,4,5,7,9,10,12,13,15,16,18,19,20,21,22,22,23,23,23,23,24,24,24,24,24,24,24
E01004226,EV motorcycles,Number,0,0,1,1,2,3,4,5,5,6,7,8,9,10,10,11,11,12,12,12,12,13,13,13,13,13,13,13,13,13
E01004228,EV motorcycles,Number,0,1,2,3,4,6,8,9,11,13,15,16,18,19,20,22,23,23,24,25,25,25,25,26,26,26,26,26,26,26
E01004229,EV motorcycles,Number,0,1,1,2,3,3,4,5,6,7,8,9,10,11,12,12,13,13,14,14,14,15,15,15,15,15,15,15,15,15
E01004230,EV motorcycles,Number,0,0,1,1,1,2,2,3,3,4,4,5,5,6,6,7,7,7,7,8,8,8,8,8,8,8,8,8,8,8
E01004231,EV motorcycles,Number,0,0,1,1,2,2,3,4,4,5,6,6,7,7,8,8,9,9,9,9,10,10,10,10,10,10,10,10,10,10
E01004232,EV motorcycles,Number,0,0,1,1,2,2,3,4,5,5,6,7,8,8,9,9,10,10,10,10,11,11,11,11,11,11,11,11,11,11
E01004233,EV motorcycles,Number,0,1,1,2,3,4,5,7,8,9,11,12,13,14,15,16,17,17,18,18,18,18,19,19,19,19,19,19,19,19
E01004234,EV motorcycles,Number,0,1,2,3,5,7,9,11,13,15,17,19,21,22,24,25,26,27,28,28,29,29,29,30,30,30,30,30,30,30
E01004235,EV motorcycles,Number,0,0,1,1,2,3,3,4,5,6,7,7,8,9,9,10,10,11,11,11,12,12,12,12,12,12,12,12,12,12
E01004236,EV motorcycles,Number,0,0,1,1,2,3,3,4,5,6,7,7,8,9,9,10,10,11,11,11,12,12,12,12,12,12,12,12,12,12
E01004237,EV motorcycles,Number,0,0,1,1,2,2,3,4,4,5,6,6,7,7,8,8,9,9,9,9,10,10,10,10,10,10,10,10,10,10
E01004238,EV motorcycles,Number,1,3,5,8,13,17,22,27,32,37,42,47,51,55,59,62,65,67,69,71,72,73,73,74,74,74,75,75,75,75
E01004239,EV motorcycles,Number,0,1,2,3,4,5,7,8,10,11,13,14,16,17,18,19,20,21,21,22,22,22,23,23,23,23,23,23,23,23
E01004240,EV motorcycles,Number,0,1,1,2,3,3,4,5,6,7,8,9,10,11,12,12,13,13,14,14,14,15,15,15,15,15,15,15,15,15
E01004241,EV motorcycles,Number,0,0,1,1,2,2,3,4,4,5,6,6,7,7,8,8,9,9,9,9,10,10,10,10,10,10,10,10,10,10
E01004242,EV motorcycles,Number,1,2,3,5,7,9,12,15,18,21,24,26,29,31,33,35,36,38,39,40,40,41,41,41,42,42,42,42,42,42
E01004243,EV motorcycles,Number,0,1,1,2,3,4,5,6,7,8,9,10,11,12,13,13,14,14,15,15,15,16,16,16,16,16,16,16,16,16
E01004244,EV motorcycles,Number,0,0,0,1,1,2,2,2,3,3,4,4,5,5,6,6,6,6,6,7,7,7,7,7,7,7,7,7,7,7
E01004245,EV motorcycles,Number,0,1,1,2,3,4,6,7,8,10,11,12,14,15,16,17,17,18,18,19,19,19,20,20,20,20,20,20,20,20
E01004246,EV motorcycles,Number,1,1,2,4,6,8,11,13,16,18,21,23,25,27,29,31,32,33,34,35,35,36,36,36,37,37,37,37,37,37
E01004247,EV motorcycles,Number,0,1,1,2,2,3,4,5,6,7,8,9,10,10,11,12,12,13,13,13,13,14,14,14,14,14,14,14,14,14
E01004248,EV motorcycles,Number,0,0,1,1,2,3,4,5,5,6,7,8,9,10,10,11,11,12,12,12,12,13,13,13,13,13,13,13,13,13
E01004249,EV motorcycles,Number,0,1,2,3,4,6,8,9,11,13,15,16,18,19,20,22,23,23,24,25,25,25,25,26,26,26,26,26,26,26
E01004250,EV motorcycles,Number,0,1,1,2,3,4,6,7,8,10,11,12,14,15,16,17,17,18,18,19,19,19,20,20,20,20,20,20,20,20
E01004251,EV motorcycles,Number,0,1,1,2,4,5,6,7,9,10,12,13,14,16,17,17,18,19,19,20,20,20,21,21,21,21,21,21,21,21
E01004252,EV motorcycles,Number,0,1,2,3,4,5,7,8,10,11,13,14,16,17,18,19,20,21,21,22,22,22,23,23,23,23,23,23,23,23
E01004253,EV motorcycles,Number,0,1,1,2,4,5,6,8,9,11,12,14,15,16,17,18,19,20,20,21,21,21,22,22,22,22,22,22,22,22
E01004254,EV motorcycles,Number,1,1,2,4,6,8,11,13,16,18,21,23,25,27,29,31,32,33,34,35,35,36,36,36,37,37,37,37,37,37
E01004255,EV motorcycles,Number,0,0,0,1,1,1,2,2,3,3,3,4,4,4,5,5,5,5,6,6,6,6,6,6,6,6,6,6,6,6
E01004256,EV motorcycles,Number,0,1,1,2,3,4,5,7,8,9,11,12,13,14,15,16,17,17,18,18,18,18,19,19,19,19,19,19,19,19
E01004257,EV motorcycles,Number,0,0,1,1,2,3,3,4,5,6,7,7,8,9,9,10,10,11,11,11,12,12,12,12,12,12,12,12,12,12
E01004258,EV motorcycles,Number,0,0,1,1,1,2,2,3,3,4,4,5,5,6,6,7,7,7,7,8,8,8,8,8,8,8,8,8,8,8
E01004259,EV motorcycles,Number,0,1,2,3,4,5,7,8,10,11,13,14,16,17,18,19,20,21,21,22,22,22,23,23,23,23,23,23,23,23
E01004260,EV motorcycles,Number,0,0,0,1,1,2,2,2,3,3,4,4,5,5,6,6,6,6,6,7,7,7,7,7,7,7,7,7,7,7
E01004261,EV motorcycles,Number,0,0,1,1,1,2,2,3,3,4,4,5,5,6,6,7,7,7,7,8,8,8,8,8,8,8,8,8,8,8
E01004262,EV motorcycles,Number,0,0,1,1,2,2,3,3,4,4,5,6,6,7,7,7,8,8,8,8,9,9,9,9,9,9,9,9,9,9
E01004263,EV motorcycles,Number,0,0,1,1,2,2,3,4,5,5,6,7,8,8,9,9,10,10,10,10,11,11,11,11,11,11,11,11,11,11
E01004264,EV motorcycles,Number,0,1,1,2,2,3,4,5,6,7,8,9,10,10,11,12,12,13,13,13,13,14,14,14,14,14,14,14,14,14
E01004266,EV motorcycles,Number,0,1,1,2,3,4,6,7,8,10,11,12,14,15,16,17,17,18,18,19,19,19,20,20,20,20,20,20,20,20
E01004267,EV motorcycles,Number,0,0,1,1,2,3,3,4,5,6,7,7,8,9,9,10,10,11,11,11,12,12,12,12,12,12,12,12,12,12
E01004268,EV motorcycles,Number,0,0,1,1,2,2,3,4,5,5,6,7,8,8,9,9,10,10,10,10,11,11,11,11,11,11,11,11,11,11
E01004269,EV motorcycles,Number,0,1,1,2,4,5,6,8,9,11,12,14,15,16,17,18,19,20,20,21,21,21,22,22,22,22,22,22,22,22
E01004270,EV motorcycles,Number,0,1,1,2,3,4,5,6,8,9,10,11,12,13,14,15,16,16,17,17,17,17,18,18,18,18,18,18,18,18
E01004271,EV motorcycles,Number,1,1,2,4,6,8,10,12,15,17,20,22,24,26,28,29,30,31,32,33,34,34,34,34,35,35,35,35,35,35
E01004272,EV motorcycles,Number,0,1,1,2,3,4,5,6,8,9,10,11,12,13,14,15,16,16,17,17,17,17,18,18,18,18,18,18,18,18
E01004273,EV motorcycles,Number,0,1,2,3,4,6,7,9,11,12,14,16,17,18,20,21,22,22,23,24,24,24,24,25,25,25,25,25,25,25
E01004274,EV motorcycles,Number,0,1,1,2,3,4,5,6,8,9,10,11,12,13,14,15,16,16,17,17,17,17,18,18,18,18,18,18,18,18
E01004275,EV motorcycles,Number,0,1,1,2,3,3,4,5,6,7,8,9,10,11,12,12,13,13,14,14,14,15,15,15,15,15,15,15,15,15
E01004276,EV motorcycles,Number,0,1,2,3,4,5,7,9,10,12,13,15,16,18,19,20,21,22,22,23,23,23,23,24,24,24,24,24,24,24
E01004277,EV motorcycles,Number,1,1,3,5,7,9,12,15,17,20,23,26,28,30,32,34,36,37,38,39,39,40,40,40,41,41,41,41,41,41
E01004280,EV motorcycles,Number,0,1,1,2,3,4,5,6,7,8,9,10,11,12,13,13,14,14,15,15,15,16,16,16,16,16,16,16,16,16
E01004281,EV motorcycles,Number,0,1,1,2,3,4,5,7,8,9,11,12,13,14,15,16,17,17,18,18,18,18,19,19,19,19,19,19,19,19
E01004283,EV motorcycles,Number,0,0,1,1,2,3,3,4,5,6,7,7,8,9,9,10,10,11,11,11,12,12,12,12,12,12,12,12,12,12
E01004284,EV motorcycles,Number,0,1,2,3,4,5,7,9,10,12,13,15,16,18,19,20,21,22,22,23,23,23,23,24,24,24,24,24,24,24
E01004285,EV motorcycles,Number,0,1,2,3,5,6,8,10,11,13,15,17,18,20,21,22,23,24,25,25,26,26,26,27,27,27,27,27,27,27
E01004286,EV motorcycles,Number,0,1,2,3,4,5,7,9,10,12,13,15,16,18,19,20,21,22,22,23,23,23,23,24,24,24,24,24,24,24
E01004287,EV motorcycles,Number,0,1,2,3,4,5,7,9,10,12,13,15,16,18,19,20,21,22,22,23,23,23,23,24,24,24,24,24,24,24
E01004288,EV motorcycles,Number,0,1,1,2,3,3,4,5,6,7,8,9,10,11,12,12,13,13,14,14,14,15,15,15,15,15,15,15,15,15
E01004289,EV motorcycles,Number,0,1,1,2,3,3,4,5,6,7,8,9,10,11,12,12,13,13,14,14,14,15,15,15,15,15,15,15,15,15
E01004290,EV motorcycles,Number,0,1,1,2,4,5,6,7,9,10,12,13,14,16,17,17,18,19,19,20,20,20,21,21,21,21,21,21,21,21
E01004291,EV motorcycles,Number,0,1,2,3,5,6,8,10,12,14,16,17,19,21,22,23,24,25,26,26,27,27,27,28,28,28,28,28,28,28
E01004292,EV motorcycles,Number,0,1,2,3,4,6,8,9,11,13,15,16,18,19,20,22,23,23,24,25,25,25,25,26,26,26,26,26,26,26
E01004293,EV motorcycles,Number,0,1,2,4,5,7,9,11,14,16,18,20,22,24,25,27,28,29,30,30,31,31,31,32,32,32,32,32,32,32
E01004294,EV motorcycles,Number,0,1,1,2,4,5,6,8,9,11,12,14,15,16,17,18,19,20,20,21,21,21,22,22,22,22,22,22,22,22
E01004295,EV motorcycles,Number,0,0,0,1,1,1,1,2,2,2,3,3,3,4,4,4,4,4,5,5,5,5,5,5,5,5,5,5,5,5
E01004296,EV motorcycles,Number,1,1,3,4,7,9,11,14,16,19,22,24,27,29,31,32,34,35,36,37,37,38,38,38,39,39,39,39,39,39
E01004297,EV motorcycles,Number,0,1,1,2,3,4,5,6,7,8,9,10,11,12,13,13,14,14,15,15,15,16,16,16,16,16,16,16,16,16
E01004298,EV motorcycles,Number,0,1,1,2,2,3,4,5,6,7,8,9,10,10,11,12,12,13,13,13,13,14,14,14,14,14,14,14,14,14
E01004300,EV motorcycles,Number,0,0,1,1,2,2,3,4,5,5,6,7,8,8,9,9,10,10,10,10,11,11,11,11,11,11,11,11,11,11
E01004301,EV motorcycles,Number,0,1,2,3,4,6,7,9,11,12,14,16,17,18,20,21,22,22,23,24,24,24,24,25,25,25,25,25,25,25
E01004302,EV motorcycles,Number,0,1,1,2,4,5,6,8,9,11,12,14,15,16,17,18,19,20,20,21,21,21,22,22,22,22,22,22,22,22
E01004303,EV motorcycles,Number,0,1,2,3,5,6,8,10,11,13,15,17,18,20,21,22,23,24,25,25,26,26,26,27,27,27,27,27,27,27
E01004304,EV motorcycles,Number,0,0,1,1,2,3,4,5,5,6,7,8,9,10,10,11,11,12,12,12,12,13,13,13,13,13,13,13,13,13
E01004305,EV motorcycles,Number,0,1,1,2,2,3,4,5,6,7,8,9,10,10,11,12,12,13,13,13,13,14,14,14,14,14,14,14,14,14
E01004306,EV motorcycles,Number,0,1,1,2,3,4,5,6,8,9,10,11,12,13,14,15,16,16,17,17,17,17,18,18,18,18,18,18,18,18
E01004307,EV motorcycles,Number,1,2,4,6,10,13,16,20,24,28,32,35,39,42,45,47,50,51,53,54,55,55,56,56,56,57,57,57,57,57
E01004308,EV motorcycles,Number,0,1,1,2,3,4,5,7,8,9,11,12,13,14,15,16,17,17,18,18,18,18,19,19,19,19,19,19,19,19
E01004309,EV motorcycles,Number,0,1,1,2,2,3,4,5,6,7,8,9,10,10,11,12,12,13,13,13,13,14,14,14,14,14,14,14,14,14
E01004310,EV motorcycles,Number,0,1,2,3,5,7,9,11,13,15,17,19,21,22,24,25,26,27,28,28,29,29,29,30,30,30,30,30,30,30
E01004311,EV motorcycles,Number,0,1,1,2,4,5,6,8,9,11,12,14,15,16,17,18,19,20,20,21,21,21,22,22,22,22,22,22,22,22
E01004312,EV motorcycles,Number,0,0,1,1,2,3,3,4,5,6,7,7,8,9,9,10,10,11,11,11,12,12,12,12,12,12,12,12,12,12
E01004313,EV motorcycles,Number,0,0,1,1,2,3,4,5,5,6,7,8,9,10,10,11,11,12,12,12,12,13,13,13,13,13,13,13,13,13
E01004314,EV motorcycles,Number,0,1,1,2,4,5,6,8,9,11,12,14,15,16,17,18,19,20,20,21,21,21,22,22,22,22,22,22,22,22
E01004315,EV motorcycles,Number,0,1,1,2,3,4,5,6,7,8,10,11,12,13,13,14,15,15,16,16,16,16,17,17,17,17,17,17,17,17
E01004316,EV motorcycles,Number,0,0,1,1,2,2,3,3,4,4,5,6,6,7,7,7,8,8,8,8,9,9,9,9,9,9,9,9,9,9
E01004317,EV motorcycles,Number,1,1,3,4,7,9,11,14,16,19,22,24,27,29,31,32,34,35,36,37,37,38,38,38,39,39,39,39,39,39
E01004318,EV motorcycles,Number,0,1,1,2,3,4,5,6,7,8,10,11,12,13,13,14,15,15,16,16,16,16,17,17,17,17,17,17,17,17
E01004319,EV motorcycles,Number,0,1,1,2,3,3,4,5,6,7,8,9,10,11,12,12,13,13,14,14,14,15,15,15,15,15,15,15,15,15
E01004321,EV motorcycles,Number,0,1,1,2,2,3,4,5,6,7,8,9,10,10,11,12,12,13,13,13,13,14,14,14,14,14,14,14,14,14
E01004322,EV motorcycles,Number,0,1,2,3,5,7,9,11,13,15,17,19,21,22,24,25,26,27,28,28,29,29,29,30,30,30,30,30,30,30
E01004323,EV motorcycles,Number,0,1,1,2,2,3,4,5,6,7,8,9,10,10,11,12,12,13,13,13,13,14,14,14,14,14,14,14,14,14
E01004324,EV motorcycles,Number,0,1,1,2,2,3,4,5,6,7,8,9,10,10,11,12,12,13,13,13,13,14,14,14,14,14,14,14,14,14
E01004325,EV motorcycles,Number,4,11,20,33,51,68,88,108,128,149,170,189,207,224,239,252,263,272,280,286,291,294,297,299,300,301,303,303,303,303
E01004326,EV motorcycles,Number,0,0,1,1,2,2,3,4,4,5,6,6,7,7,8,8,9,9,9,9,10,10,10,10,10,10,10,10,10,10
E01004327,EV motorcycles,Number,0,1,1,2,3,4,6,7,8,10,11,12,14,15,16,17,17,18,18,19,19,19,20,20,20,20,20,20,20,20
E01004328,EV motorcycles,Number,0,1,1,2,3,4,5,6,7,8,10,11,12,13,13,14,15,15,16,16,16,16,17,17,17,17,17,17,17,17
E01004329,EV motorcycles,Number,0,1,1,2,3,4,5,6,7,8,9,10,11,12,13,13,14,14,15,15,15,16,16,16,16,16,16,16,16,16
E01004330,EV motorcycles,Number,0,1,1,2,3,3,4,5,6,7,8,9,10,11,12,12,13,13,14,14,14,15,15,15,15,15,15,15,15,15
E01004331,EV motorcycles,Number,2,4,8,13,20,26,34,42,50,58,66,73,81,87,93,98,103,106,109,111,113,114,116,116,117,117,118,118,118,118
E01004332,EV motorcycles,Number,0,1,2,3,4,6,7,9,11,12,14,16,17,18,20,21,22,22,23,24,24,24,24,25,25,25,25,25,25,25
E01004333,EV motorcycles,Number,0,1,1,2,3,4,5,6,7,8,9,10,11,12,13,13,14,14,15,15,15,16,16,16,16,16,16,16,16,16
E01004334,EV motorcycles,Number,0,0,1,1,2,3,4,5,5,6,7,8,9,10,10,11,11,12,12,12,12,13,13,13,13,13,13,13,13,13
E01004335,EV motorcycles,Number,0,1,2,4,6,7,10,12,14,16,18,21,23,24,26,27,29,30,31,31,32,32,32,33,33,33,33,33,33,33
E01004336,EV motorcycles,Number,0,1,1,2,3,4,5,6,7,8,9,10,11,12,13,13,14,14,15,15,15,16,16,16,16,16,16,16,16,16
E01004337,EV motorcycles,Number,0,0,1,1,2,2,3,4,4,5,6,6,7,7,8,8,9,9,9,9,10,10,10,10,10,10,10,10,10,10
E01004338,EV motorcycles,Number,0,0,1,1,2,2,3,4,5,5,6,7,8,8,9,9,10,10,10,10,11,11,11,11,11,11,11,11,11,11
E01004339,EV motorcycles,Number,0,1,1,2,3,3,4,5,6,7,8,9,10,11,12,12,13,13,14,14,14,15,15,15,15,15,15,15,15,15
E01004340,EV motorcycles,Number,0,1,1,2,2,3,4,5,6,7,8,9,10,10,11,12,12,13,13,13,13,14,14,14,14,14,14,14,14,14
E01004341,EV motorcycles,Number,0,1,1,2,3,4,5,6,7,8,9,10,11,12,13,13,14,14,15,15,15,16,16,16,16,16,16,16,16,16
E01004342,EV motorcycles,Number,0,1,1,2,3,4,6,7,8,10,11,12,14,15,16,17,17,18,18,19,19,19,20,20,20,20,20,20,20,20
E01004343,EV motorcycles,Number,0,0,1,1,1,2,2,3,3,4,4,5,5,6,6,7,7,7,7,8,8,8,8,8,8,8,8,8,8,8
E01004344,EV motorcycles,Number,0,1,1,2,3,4,5,6,8,9,10,11,12,13,14,15,16,16,17,17,17,17,18,18,18,18,18,18,18,18
E01004345,EV motorcycles,Number,0,1,1,2,3,3,4,5,6,7,8,9,10,11,12,12,13,13,14,14,14,15,15,15,15,15,15,15,15,15
E01004346,EV motorcycles,Number,0,0,0,1,1,1,2,2,3,3,3,4,4,4,5,5,5,5,6,6,6,6,6,6,6,6,6,6,6,6
E01004347,EV motorcycles,Number,0,1,2,3,4,5,7,8,10,11,13,14,16,17,18,19,20,21,21,22,22,22,23,23,23,23,23,23,23,23
E01004348,EV motorcycles,Number,0,1,2,3,5,7,9,11,13,15,17,19,21,22,24,25,26,27,28,28,29,29,29,30,30,30,30,30,30,30
E01004349,EV motorcycles,Number,0,1,2,4,6,7,10,12,14,16,18,21,23,24,26,27,29,30,31,31,32,32,32,33,33,33,33,33,33,33
E01004350,EV motorcycles,Number,0,1,2,4,5,7,9,11,14,16,18,20,22,24,25,27,28,29,30,30,31,31,31,32,32,32,32,32,32,32
E01004351,EV motorcycles,Number,0,1,2,3,5,7,9,11,13,15,17,19,21,22,24,25,26,27,28,28,29,29,29,30,30,30,30,30,30,30
E01004352,EV motorcycles,Number,0,1,1,2,3,4,5,7,8,9,11,12,13,14,15,16,17,17,18,18,18,18,19,19,19,19,19,19,19,19
E01004353,EV motorcycles,Number,0,1,2,3,4,6,8,9,11,13,15,16,18,19,20,22,23,23,24,25,25,25,25,26,26,26,26,26,26,26
E01004354,EV motorcycles,Number,0,1,2,3,5,6,8,10,11,13,15,17,18,20,21,22,23,24,25,25,26,26,26,27,27,27,27,27,27,27
E01004355,EV motorcycles,Number,0,1,1,2,3,4,5,7,8,9,11,12,13,14,15,16,17,17,18,18,18,18,19,19,19,19,19,19,19,19
E01004356,EV motorcycles,Number,0,1,2,4,6,8,10,12,14,17,19,21,23,25,27,28,30,31,31,32,33,33,33,33,34,34,34,34,34,34
E01004357,EV motorcycles,Number,1,1,3,4,7,9,11,14,16,19,22,24,27,29,31,32,34,35,36,37,37,38,38,38,39,39,39,39,39,39
E01004358,EV motorcycles,Number,0,1,1,2,4,5,6,8,9,11,12,14,15,16,17,18,19,20,20,21,21,21,22,22,22,22,22,22,22,22
E01004359,EV motorcycles,Number,0,1,2,3,5,7,8,10,12,14,16,18,20,21,23,24,25,26,27,27,28,28,28,29,29,29,29,29,29,29
E01004360,EV motorcycles,Number,0,1,2,3,4,5,7,9,10,12,13,15,16,18,19,20,21,22,22,23,23,23,23,24,24,24,24,24,24,24
E01004361,EV motorcycles,Number,0,1,2,3,4,6,8,9,11,13,15,16,18,19,20,22,23,23,24,25,25,25,25,26,26,26,26,26,26,26
E01004362,EV motorcycles,Number,0,1,1,2,3,4,5,6,7,8,9,10,11,12,13,13,14,14,15,15,15,16,16,16,16,16,16,16,16,16
E01004363,EV motorcycles,Number,0,1,2,3,4,6,7,9,11,12,14,16,17,18,20,21,22,22,23,24,24,24,24,25,25,25,25,25,25,25
E01004364,EV motorcycles,Number,0,1,1,2,3,4,5,6,7,8,9,10,11,12,13,13,14,14,15,15,15,16,16,16,16,16,16,16,16,16
E01004365,EV motorcycles,Number,1,1,2,4,6,8,10,13,15,18,20,22,25,27,28,30,31,32,33,34,35,35,35,35,36,36,36,36,36,36
E01004366,EV motorcycles,Number,0,1,2,3,4,6,7,9,11,12,14,16,17,18,20,21,22,22,23,24,24,24,24,25,25,25,25,25,25,25
E01004367,EV motorcycles,Number,0,1,1,2,3,3,4,5,6,7,8,9,10,11,12,12,13,13,14,14,14,15,15,15,15,15,15,15,15,15
E01004368,EV motorcycles,Number,0,1,2,3,5,7,8,10,12,14,16,18,20,21,23,24,25,26,27,27,28,28,28,29,29,29,29,29,29,29
E01004369,EV motorcycles,Number,0,1,1,2,3,3,4,5,6,7,8,9,10,11,12,12,13,13,14,14,14,15,15,15,15,15,15,15,15,15
E01004370,EV motorcycles,Number,0,1,2,3,5,6,8,10,11,13,15,17,18,20,21,22,23,24,25,25,26,26,26,27,27,27,27,27,27,27
E01004371,EV motorcycles,Number,0,0,1,1,1,2,2,3,3,4,4,5,5,6,6,7,7,7,7,8,8,8,8,8,8,8,8,8,8,8
E01004372,EV motorcycles,Number,0,1,1,2,3,3,4,5,6,7,8,9,10,11,12,12,13,13,14,14,14,15,15,15,15,15,15,15,15,15
E01004373,EV motorcycles,Number,0,1,1,2,3,4,5,6,7,8,10,11,12,13,13,14,15,15,16,16,16,16,17,17,17,17,17,17,17,17
E01004374,EV motorcycles,Number,0,1,2,3,4,6,8,9,11,13,15,16,18,19,20,22,23,23,24,25,25,25,25,26,26,26,26,26,26,26
E01004375,EV motorcycles,Number,1,2,3,5,7,10,12,15,18,21,24,27,29,32,34,36,37,39,40,41,41,42,42,42,43,43,43,43,43,43
E01004376,EV motorcycles,Number,0,1,1,2,3,3,4,5,6,7,8,9,10,11,12,12,13,13,14,14,14,15,15,15,15,15,15,15,15,15
E01004377,EV motorcycles,Number,0,1,2,3,5,6,8,10,12,14,16,17,19,21,22,23,24,25,26,26,27,27,27,28,28,28,28,28,28,28
E01004378,EV motorcycles,Number,0,1,2,3,4,6,8,9,11,13,15,16,18,19,20,22,23,23,24,25,25,25,25,26,26,26,26,26,26,26
E01004379,EV motorcycles,Number,0,1,1,2,3,4,5,6,7,8,10,11,12,13,13,14,15,15,16,16,16,16,17,17,17,17,17,17,17,17
E01004380,EV motorcycles,Number,0,1,1,2,4,5,6,8,9,11,12,14,15,16,17,18,19,20,20,21,21,21,22,22,22,22,22,22,22,22
E01004381,EV motorcycles,Number,0,0,1,1,2,2,3,4,5,5,6,7,8,8,9,9,10,10,10,10,11,11,11,11,11,11,11,11,11,11
E01004382,EV motorcycles,Number,0,1,1,2,2,3,4,5,6,7,8,9,10,10,11,12,12,13,13,13,13,14,14,14,14,14,14,14,14,14
E01004383,EV motorcycles,Number,0,1,2,3,5,6,8,10,12,14,16,17,19,21,22,23,24,25,26,26,27,27,27,28,28,28,28,28,28,28
E01004384,EV motorcycles,Number,0,1,2,3,5,6,8,10,12,14,16,17,19,21,22,23,24,25,26,26,27,27,27,28,28,28,28,28,28,28
E01004385,EV motorcycles,Number,0,1,1,2,3,3,4,5,6,7,8,9,10,11,12,12,13,13,14,14,14,15,15,15,15,15,15,15,15,15
E01004386,EV motorcycles,Number,0,1,2,3,5,6,8,10,12,14,16,17,19,21,22,23,24,25,26,26,27,27,27,28,28,28,28,28,28,28
E01004387,EV motorcycles,Number,0,0,1,1,2,3,3,4,5,6,7,7,8,9,9,10,10,11,11,11,12,12,12,12,12,12,12,12,12,12
E01004388,EV motorcycles,Number,0,1,1,2,3,3,4,5,6,7,8,9,10,11,12,12,13,13,14,14,14,15,15,15,15,15,15,15,15,15
E01004389,EV motorcycles,Number,0,1,2,3,5,7,8,10,12,14,16,18,20,21,23,24,25,26,27,27,28,28,28,29,29,29,29,29,29,29
E01004390,EV motorcycles,Number,0,1,2,3,5,7,8,10,12,14,16,18,20,21,23,24,25,26,27,27,28,28,28,29,29,29,29,29,29,29
E01004391,EV motorcycles,Number,0,0,1,1,2,3,4,5,5,6,7,8,9,10,10,11,11,12,12,12,12,13,13,13,13,13,13,13,13,13
E01004392,EV motorcycles,Number,0,1,2,3,4,5,7,8,10,11,13,14,16,17,18,19,20,21,21,22,22,22,23,23,23,23,23,23,23,23
E01004393,EV motorcycles,Number,0,0,1,1,1,2,2,3,3,4,4,5,5,6,6,7,7,7,7,8,8,8,8,8,8,8,8,8,8,8
E01004394,EV motorcycles,Number,0,1,1,2,2,3,4,5,6,7,8,9,10,10,11,12,12,13,13,13,13,14,14,14,14,14,14,14,14,14
E01004395,EV motorcycles,Number,0,0,1,1,2,3,4,5,5,6,7,8,9,10,10,11,11,12,12,12,12,13,13,13,13,13,13,13,13,13
E01004396,EV motorcycles,Number,0,1,1,2,4,5,6,8,9,11,12,14,15,16,17,18,19,20,20,21,21,21,22,22,22,22,22,22,22,22
E01004397,EV motorcycles,Number,1,1,2,4,6,8,11,13,16,18,21,23,25,27,29,31,32,33,34,35,35,36,36,36,37,37,37,37,37,37
E01004398,EV motorcycles,Number,0,1,2,3,5,7,9,11,13,15,17,19,21,22,24,25,26,27,28,28,29,29,29,30,30,30,30,30,30,30
E01004399,EV motorcycles,Number,0,1,1,2,3,3,4,5,6,7,8,9,10,11,12,12,13,13,14,14,14,15,15,15,15,15,15,15,15,15
E01004400,EV motorcycles,Number,0,1,1,2,3,4,6,7,8,10,11,12,14,15,16,17,17,18,18,19,19,19,20,20,20,20,20,20,20,20
E01004401,EV motorcycles,Number,1,2,3,6,8,11,14,18,21,25,28,31,34,37,39,42,43,45,46,47,48,49,49,49,49,50,50,50,50,50
E01004402,EV motorcycles,Number,0,1,1,2,3,4,5,7,8,9,11,12,13,14,15,16,17,17,18,18,18,18,19,19,19,19,19,19,19,19
E01004403,EV motorcycles,Number,0,1,2,3,5,7,9,11,13,15,17,19,21,22,24,25,26,27,28,28,29,29,29,30,30,30,30,30,30,30
E01004404,EV motorcycles,Number,1,1,3,5,7,9,12,15,17,20,23,26,28,30,32,34,36,37,38,39,39,40,40,40,41,41,41,41,41,41
E01004405,EV motorcycles,Number,0,1,1,2,3,4,5,6,7,8,10,11,12,13,13,14,15,15,16,16,16,16,17,17,17,17,17,17,17,17
E01004406,EV motorcycles,Number,0,1,1,2,4,5,6,8,9,11,12,14,15,16,17,18,19,20,20,21,21,21,22,22,22,22,22,22,22,22
E01004407,EV motorcycles,Number,0,1,2,3,4,6,8,9,11,13,15,16,18,19,20,22,23,23,24,25,25,25,25,26,26,26,26,26,26,26
E01004408,EV motorcycles,Number,0,0,1,1,2,3,4,5,5,6,7,8,9,10,10,11,11,12,12,12,12,13,13,13,13,13,13,13,13,13
E01004409,EV motorcycles,Number,0,0,1,1,2,2,3,4,4,5,6,6,7,7,8,8,9,9,9,9,10,10,10,10,10,10,10,10,10,10
E01004410,EV motorcycles,Number,0,0,0,1,1,2,2,2,3,3,4,4,5,5,6,6,6,6,6,7,7,7,7,7,7,7,7,7,7,7
E01004411,EV motorcycles,Number,0,0,1,1,2,2,3,4,5,5,6,7,8,8,9,9,10,10,10,10,11,11,11,11,11,11,11,11,11,11
E01004412,EV motorcycles,Number,0,1,1,2,3,4,5,6,8,9,10,11,12,13,14,15,16,16,17,17,17,17,18,18,18,18,18,18,18,18
E01004413,EV motorcycles,Number,0,1,1,2,3,4,5,7,8,9,11,12,13,14,15,16,17,17,18,18,18,18,19,19,19,19,19,19,19,19
E01004414,EV motorcycles,Number,0,1,2,3,4,6,8,9,11,13,15,16,18,19,20,22,23,23,24,25,25,25,25,26,26,26,26,26,26,26
E01004415,EV motorcycles,Number,0,1,1,2,3,4,5,6,7,8,10,11,12,13,13,14,15,15,16,16,16,16,17,17,17,17,17,17,17,17
E01004416,EV motorcycles,Number,0,1,2,3,5,7,9,11,13,15,17,19,21,22,24,25,26,27,28,28,29,29,29,30,30,30,30,30,30,30
E01004417,EV motorcycles,Number,0,1,1,2,4,5,6,7,9,10,12,13,14,16,17,17,18,19,19,20,20,20,21,21,21,21,21,21,21,21
E01004418,EV motorcycles,Number,0,0,1,1,2,2,3,4,5,5,6,7,8,8,9,9,10,10,10,10,11,11,11,11,11,11,11,11,11,11
E01004419,EV motorcycles,Number,0,1,2,3,5,6,8,10,11,13,15,17,18,20,21,22,23,24,25,25,26,26,26,27,27,27,27,27,27,27
E01004420,EV motorcycles,Number,0,1,1,2,3,4,5,6,8,9,10,11,12,13,14,15,16,16,17,17,17,17,18,18,18,18,18,18,18,18
E01004421,EV motorcycles,Number,0,1,1,2,3,3,4,5,6,7,8,9,10,11,12,12,13,13,14,14,14,15,15,15,15,15,15,15,15,15
E01004422,EV motorcycles,Number,0,1,1,2,4,5,6,7,9,10,12,13,14,16,17,17,18,19,19,20,20,20,21,21,21,21,21,21,21,21
E01004423,EV motorcycles,Number,0,1,1,2,3,4,6,7,8,10,11,12,14,15,16,17,17,18,18,19,19,19,20,20,20,20,20,20,20,20
E01004424,EV motorcycles,Number,0,1,1,2,3,4,5,6,8,9,10,11,12,13,14,15,16,16,17,17,17,17,18,18,18,18,18,18,18,18
E01004425,EV motorcycles,Number,0,1,2,3,4,5,7,8,10,11,13,14,16,17,18,19,20,21,21,22,22,22,23,23,23,23,23,23,23,23
E01004426,EV motorcycles,Number,0,1,2,3,4,5,7,9,10,12,13,15,16,18,19,20,21,22,22,23,23,23,23,24,24,24,24,24,24,24
E01004427,EV motorcycles,Number,0,1,2,4,5,7,9,11,14,16,18,20,22,24,25,27,28,29,30,30,31,31,31,32,32,32,32,32,32,32
E01004428,EV motorcycles,Number,0,1,1,2,3,3,4,5,6,7,8,9,10,11,12,12,13,13,14,14,14,15,15,15,15,15,15,15,15,15
E01004429,EV motorcycles,Number,0,1,2,3,4,5,7,9,10,12,13,15,16,18,19,20,21,22,22,23,23,23,23,24,24,24,24,24,24,24
E01004430,EV motorcycles,Number,0,1,2,4,5,7,9,11,14,16,18,20,22,24,25,27,28,29,30,30,31,31,31,32,32,32,32,32,32,32
E01004432,EV motorcycles,Number,0,1,1,2,3,4,5,6,7,8,10,11,12,13,13,14,15,15,16,16,16,16,17,17,17,17,17,17,17,17
E01004434,EV motorcycles,Number,0,1,1,2,3,4,5,7,8,9,11,12,13,14,15,16,17,17,18,18,18,18,19,19,19,19,19,19,19,19
E01004435,EV motorcycles,Number,0,1,1,2,3,4,5,6,8,9,10,11,12,13,14,15,16,16,17,17,17,17,18,18,18,18,18,18,18,18
E01004436,EV motorcycles,Number,0,0,1,1,2,3,4,5,5,6,7,8,9,10,10,11,11,12,12,12,12,13,13,13,13,13,13,13,13,13
E01004437,EV motorcycles,Number,0,1,1,2,3,4,5,6,8,9,10,11,12,13,14,15,16,16,17,17,17,17,18,18,18,18,18,18,18,18
E01004438,EV motorcycles,Number,0,1,1,2,3,4,5,6,7,8,9,10,11,12,13,13,14,14,15,15,15,16,16,16,16,16,16,16,16,16
E01004439,EV motorcycles,Number,0,0,1,1,2,2,3,4,4,5,6,6,7,7,8,8,9,9,9,9,10,10,10,10,10,10,10,10,10,10
E01004440,EV motorcycles,Number,0,1,1,2,3,4,5,6,7,8,9,10,11,12,13,13,14,14,15,15,15,16,16,16,16,16,16,16,16,16
E01004441,EV motorcycles,Number,0,1,1,2,3,4,5,7,8,9,11,12,13,14,15,16,17,17,18,18,18,18,19,19,19,19,19,19,19,19
E01004442,EV motorcycles,Number,0,1,1,2,4,5,6,8,9,11,12,14,15,16,17,18,19,20,20,21,21,21,22,22,22,22,22,22,22,22
E01004443,EV motorcycles,Number,0,0,1,1,2,2,3,4,5,5,6,7,8,8,9,9,10,10,10,10,11,11,11,11,11,11,11,11,11,11
E01004444,EV motorcycles,Number,0,1,2,3,5,7,9,11,13,15,17,19,21,22,24,25,26,27,28,28,29,29,29,30,30,30,30,30,30,30
E01004445,EV motorcycles,Number,0,0,1,1,2,2,3,4,4,5,6,6,7,7,8,8,9,9,9,9,10,10,10,10,10,10,10,10,10,10
E01004446,EV motorcycles,Number,0,1,1,2,4,5,6,7,9,10,12,13,14,16,17,17,18,19,19,20,20,20,21,21,21,21,21,21,21,21
E01004447,EV motorcycles,Number,0,1,1,2,3,3,4,5,6,7,8,9,10,11,12,12,13,13,14,14,14,15,15,15,15,15,15,15,15,15
E01004448,EV motorcycles,Number,1,1,2,4,6,8,10,12,15,17,20,22,24,26,28,29,30,31,32,33,34,34,34,34,35,35,35,35,35,35
E01004449,EV motorcycles,Number,0,1,1,2,2,3,4,5,6,7,8,9,10,10,11,12,12,13,13,13,13,14,14,14,14,14,14,14,14,14
E01004450,EV motorcycles,Number,1,1,2,4,6,8,11,13,16,18,21,23,25,27,29,31,32,33,34,35,35,36,36,36,37,37,37,37,37,37
E01004451,EV motorcycles,Number,0,1,2,4,5,7,9,11,14,16,18,20,22,24,25,27,28,29,30,30,31,31,31,32,32,32,32,32,32,32
E01004452,EV motorcycles,Number,0,1,1,2,4,5,6,8,9,11,12,14,15,16,17,18,19,20,20,21,21,21,22,22,22,22,22,22,22,22
E01004453,EV motorcycles,Number,0,1,2,4,5,7,9,11,14,16,18,20,22,24,25,27,28,29,30,30,31,31,31,32,32,32,32,32,32,32
E01004454,EV motorcycles,Number,0,1,2,3,4,5,7,9,10,12,13,15,16,18,19,20,21,22,22,23,23,23,23,24,24,24,24,24,24,24
E01004455,EV motorcycles,Number,0,1,1,2,3,4,6,7,8,10,11,12,14,15,16,17,17,18,18,19,19,19,20,20,20,20,20,20,20,20
E01004456,EV motorcycles,Number,0,0,1,1,2,3,3,4,5,6,7,7,8,9,9,10,10,11,11,11,12,12,12,12,12,12,12,12,12,12
E01004457,EV motorcycles,Number,0,0,0,1,1,1,2,2,3,3,3,4,4,4,5,5,5,5,6,6,6,6,6,6,6,6,6,6,6,6
E01004458,EV motorcycles,Number,0,1,1,2,3,4,5,6,8,9,10,11,12,13,14,15,16,16,17,17,17,17,18,18,18,18,18,18,18,18
E01004459,EV motorcycles,Number,0,1,1,2,3,3,4,5,6,7,8,9,10,11,12,12,13,13,14,14,14,15,15,15,15,15,15,15,15,15
E01004460,EV motorcycles,Number,0,0,1,1,2,2,3,4,5,5,6,7,8,8,9,9,10,10,10,10,11,11,11,11,11,11,11,11,11,11
E01004461,EV motorcycles,Number,1,1,2,4,6,9,11,13,16,19,21,24,26,28,30,32,33,34,35,36,36,37,37,37,38,38,38,38,38,38
E01004462,EV motorcycles,Number,0,1,1,2,3,4,6,7,8,10,11,12,14,15,16,17,17,18,18,19,19,19,20,20,20,20,20,20,20,20
E01004463,EV motorcycles,Number,0,1,2,3,5,7,9,11,13,15,17,19,21,22,24,25,26,27,28,28,29,29,29,30,30,30,30,30,30,30
E01004464,EV motorcycles,Number,0,1,1,2,3,4,5,7,8,9,11,12,13,14,15,16,17,17,18,18,18,18,19,19,19,19,19,19,19,19
E01004465,EV motorcycles,Number,0,1,1,2,3,4,5,6,7,8,10,11,12,13,13,14,15,15,16,16,16,16,17,17,17,17,17,17,17,17
E01004466,EV motorcycles,Number,0,1,1,2,3,4,5,6,8,9,10,11,12,13,14,15,16,16,17,17,17,17,18,18,18,18,18,18,18,18
E01004467,EV motorcycles,Number,0,1,2,3,5,6,8,10,12,14,16,17,19,21,22,23,24,25,26,26,27,27,27,28,28,28,28,28,28,28
E01004468,EV motorcycles,Number,0,1,2,3,4,6,7,9,11,12,14,16,17,18,20,21,22,22,23,24,24,24,24,25,25,25,25,25,25,25
E01004469,EV motorcycles,Number,0,0,1,1,2,2,3,4,4,5,6,6,7,7,8,8,9,9,9,9,10,10,10,10,10,10,10,10,10,10
E01004470,EV motorcycles,Number,0,0,1,1,2,2,3,4,5,5,6,7,8,8,9,9,10,10,10,10,11,11,11,11,11,11,11,11,11,11
E01004471,EV motorcycles,Number,0,1,1,2,4,5,6,8,9,11,12,14,15,16,17,18,19,20,20,21,21,21,22,22,22,22,22,22,22,22
E01004472,EV motorcycles,Number,0,1,1,2,4,5,6,8,9,11,12,14,15,16,17,18,19,20,20,21,21,21,22,22,22,22,22,22,22,22
E01004473,EV motorcycles,Number,0,1,1,2,3,4,5,7,8,9,11,12,13,14,15,16,17,17,18,18,18,18,19,19,19,19,19,19,19,19
E01004474,EV motorcycles,Number,0,1,1,2,4,5,6,8,9,11,12,14,15,16,17,18,19,20,20,21,21,21,22,22,22,22,22,22,22,22
E01004475,EV motorcycles,Number,0,0,1,1,2,2,3,4,5,5,6,7,8,8,9,9,10,10,10,10,11,11,11,11,11,11,11,11,11,11
E01004476,EV motorcycles,Number,0,1,1,2,2,3,4,5,6,7,8,9,10,10,11,12,12,13,13,13,13,14,14,14,14,14,14,14,14,14
E01004477,EV motorcycles,Number,0,1,2,3,5,6,8,10,11,13,15,17,18,20,21,22,23,24,25,25,26,26,26,27,27,27,27,27,27,27
E01004478,EV motorcycles,Number,0,1,2,3,5,7,9,11,13,15,17,19,21,23,24,26,27,28,29,29,30,30,30,31,31,31,31,31,31,31
E01004479,EV motorcycles,Number,0,1,2,4,6,7,10,12,14,16,18,21,23,24,26,27,29,30,31,31,32,32,32,33,33,33,33,33,33,33
E01004480,EV motorcycles,Number,0,0,1,1,2,3,3,4,5,6,7,7,8,9,9,10,10,11,11,11,12,12,12,12,12,12,12,12,12,12
E01004481,EV motorcycles,Number,0,1,2,4,6,8,10,12,14,17,19,21,23,25,27,28,30,31,31,32,33,33,33,33,34,34,34,34,34,34
E01004482,EV motorcycles,Number,0,1,2,3,5,7,9,11,13,15,17,19,21,22,24,25,26,27,28,28,29,29,29,30,30,30,30,30,30,30
E01004483,EV motorcycles,Number,1,1,2,4,6,8,10,12,15,17,20,22,24,26,28,29,30,31,32,33,34,34,34,34,35,35,35,35,35,35
E01004484,EV motorcycles,Number,0,1,1,2,3,4,5,6,8,9,10,11,12,13,14,15,16,16,17,17,17,17,18,18,18,18,18,18,18,18
E01004485,EV motorcycles,Number,0,1,2,3,5,7,8,10,12,14,16,18,20,21,23,24,25,26,27,27,28,28,28,29,29,29,29,29,29,29
E01004486,EV motorcycles,Number,0,1,2,3,4,5,7,8,10,11,13,14,16,17,18,19,20,21,21,22,22,22,23,23,23,23,23,23,23,23
E01004487,EV motorcycles,Number,1,1,2,4,6,8,11,13,16,18,21,23,25,27,29,31,32,33,34,35,35,36,36,36,37,37,37,37,37,37
E01004488,EV motorcycles,Number,0,1,1,2,3,4,5,7,8,9,11,12,13,14,15,16,17,17,18,18,18,18,19,19,19,19,19,19,19,19
E01004489,EV motorcycles,Number,0,1,2,3,5,7,8,10,12,14,16,18,20,21,23,24,25,26,27,27,28,28,28,29,29,29,29,29,29,29
E01004490,EV motorcycles,Number,0,1,2,4,5,7,9,11,14,16,18,20,22,24,25,27,28,29,30,30,31,31,31,32,32,32,32,32,32,32
E01004491,EV motorcycles,Number,1,1,2,4,6,8,10,13,15,18,20,22,25,27,28,30,31,32,33,34,35,35,35,35,36,36,36,36,36,36
E01004492,EV motorcycles,Number,0,1,2,3,5,7,9,11,13,15,17,19,21,22,24,25,26,27,28,28,29,29,29,30,30,30,30,30,30,30
E01004493,EV motorcycles,Number,1,1,2,4,6,8,10,12,15,17,20,22,24,26,28,29,30,31,32,33,34,34,34,34,35,35,35,35,35,35
E01004494,EV motorcycles,Number,0,1,2,3,5,7,9,11,13,15,17,19,21,22,24,25,26,27,28,28,29,29,29,30,30,30,30,30,30,30
E01004495,EV motorcycles,Number,0,1,2,3,4,6,8,9,11,13,15,16,18,19,20,22,23,23,24,25,25,25,25,26,26,26,26,26,26,26
E01004496,EV motorcycles,Number,1,2,3,6,8,11,14,18,21,25,28,31,34,37,39,42,43,45,46,47,48,49,49,49,49,50,50,50,50,50
E01004497,EV motorcycles,Number,0,1,1,2,3,4,5,6,7,8,9,10,11,12,13,13,14,14,15,15,15,16,16,16,16,16,16,16,16,16
E01004498,EV motorcycles,Number,1,1,2,4,6,8,10,12,15,17,20,22,24,26,28,29,30,31,32,33,34,34,34,34,35,35,35,35,35,35
E01004499,EV motorcycles,Number,0,1,2,3,4,5,7,9,10,12,13,15,16,18,19,20,21,22,22,23,23,23,23,24,24,24,24,24,24,24
E01004500,EV motorcycles,Number,1,1,3,4,7,9,11,14,16,19,22,24,27,29,31,32,34,35,36,37,37,38,38,38,39,39,39,39,39,39
E01004501,EV motorcycles,Number,0,1,1,2,3,4,6,7,8,10,11,12,14,15,16,17,17,18,18,19,19,19,20,20,20,20,20,20,20,20
E01004502,EV motorcycles,Number,0,1,2,3,5,6,8,10,11,13,15,17,18,20,21,22,23,24,25,25,26,26,26,27,27,27,27,27,27,27
E01004503,EV motorcycles,Number,1,1,2,4,6,9,11,13,16,19,21,24,26,28,30,32,33,34,35,36,36,37,37,37,38,38,38,38,38,38
E01004504,EV motorcycles,Number,1,1,3,5,7,9,12,15,17,20,23,26,28,30,32,34,36,37,38,39,39,40,40,40,41,41,41,41,41,41
E01004505,EV motorcycles,Number,0,1,2,3,5,7,9,11,13,15,17,19,21,22,24,25,26,27,28,28,29,29,29,30,30,30,30,30,30,30
E01004506,EV motorcycles,Number,0,1,2,3,4,6,8,9,11,13,15,16,18,19,20,22,23,23,24,25,25,25,25,26,26,26,26,26,26,26
E01004507,EV motorcycles,Number,0,1,2,4,6,8,10,12,14,17,19,21,23,25,27,28,30,31,31,32,33,33,33,33,34,34,34,34,34,34
E01004508,EV motorcycles,Number,0,1,2,3,5,7,9,11,13,15,17,19,21,22,24,25,26,27,28,28,29,29,29,30,30,30,30,30,30,30
E01004509,EV motorcycles,Number,1,2,3,5,7,10,13,16,19,22,25,27,30,33,35,37,38,40,41,42,42,43,43,43,44,44,44,44,44,44
E01004510,EV motorcycles,Number,0,1,2,4,6,7,10,12,14,16,18,21,23,24,26,27,29,30,31,31,32,32,32,33,33,33,33,33,33,33
E01004511,EV motorcycles,Number,0,1,2,3,4,6,7,9,11,12,14,16,17,18,20,21,22,22,23,24,24,24,24,25,25,25,25,25,25,25
E01004512,EV motorcycles,Number,1,1,2,4,6,8,11,13,16,18,21,23,25,27,29,31,32,33,34,35,35,36,36,36,37,37,37,37,37,37
E01004513,EV motorcycles,Number,0,1,1,2,3,4,6,7,8,10,11,12,14,15,16,17,17,18,18,19,19,19,20,20,20,20,20,20,20,20
E01004514,EV motorcycles,Number,0,1,2,3,4,6,8,9,11,13,15,16,18,19,20,22,23,23,24,25,25,25,25,26,26,26,26,26,26,26
E01004515,EV motorcycles,Number,0,1,2,3,5,7,8,10,12,14,16,18,20,21,23,24,25,26,27,27,28,28,28,29,29,29,29,29,29,29
E01004516,EV motorcycles,Number,0,1,2,4,5,7,9,11,14,16,18,20,22,24,25,27,28,29,30,30,31,31,31,32,32,32,32,32,32,32
E01004517,EV motorcycles,Number,1,2,3,6,8,11,14,18,21,25,28,31,34,37,39,42,43,45,46,47,48,49,49,49,49,50,50,50,50,50
E01004518,EV motorcycles,Number,1,3,5,8,13,17,22,27,32,37,43,47,52,56,60,63,66,68,70,72,73,74,74,75,75,75,76,76,76,76
E01004519,EV motorcycles,Number,0,1,2,3,5,7,8,10,12,14,16,18,20,21,23,24,25,26,27,27,28,28,28,29,29,29,29,29,29,29
E01004520,EV motorcycles,Number,0,1,1,2,3,4,5,6,7,8,9,10,11,12,13,13,14,14,15,15,15,16,16,16,16,16,16,16,16,16
E01004521,EV motorcycles,Number,1,1,3,4,7,9,11,14,16,19,22,24,27,29,31,32,34,35,36,37,37,38,38,38,39,39,39,39,39,39
E01004522,EV motorcycles,Number,0,1,2,4,5,7,9,11,14,16,18,20,22,24,25,27,28,29,30,30,31,31,31,32,32,32,32,32,32,32
E01004523,EV motorcycles,Number,0,1,2,4,6,7,10,12,14,16,18,21,23,24,26,27,29,30,31,31,32,32,32,33,33,33,33,33,33,33
E01004524,EV motorcycles,Number,0,1,2,3,4,6,7,9,11,12,14,16,17,18,20,21,22,22,23,24,24,24,24,25,25,25,25,25,25,25
E01004525,EV motorcycles,Number,1,2,3,5,7,10,13,16,19,22,25,27,30,33,35,37,38,40,41,42,42,43,43,43,44,44,44,44,44,44
E01004526,EV motorcycles,Number,0,1,1,2,4,5,6,7,9,10,12,13,14,16,17,17,18,19,19,20,20,20,21,21,21,21,21,21,21,21
E01004527,EV motorcycles,Number,0,1,2,3,5,6,8,10,12,14,16,17,19,21,22,23,24,25,26,26,27,27,27,28,28,28,28,28,28,28
E01004528,EV motorcycles,Number,0,1,2,3,4,5,7,9,10,12,13,15,16,18,19,20,21,22,22,23,23,23,23,24,24,24,24,24,24,24
E01004529,EV motorcycles,Number,0,1,2,3,5,7,9,11,13,15,17,19,21,23,24,26,27,28,29,29,30,30,30,31,31,31,31,31,31,31
E01004530,EV motorcycles,Number,1,1,3,5,7,9,12,15,17,20,23,26,28,30,32,34,36,37,38,39,39,40,40,40,41,41,41,41,41,41
E01004531,EV motorcycles,Number,0,1,2,4,5,7,9,11,14,16,18,20,22,24,25,27,28,29,30,30,31,31,31,32,32,32,32,32,32,32
E01004532,EV motorcycles,Number,0,1,1,2,3,4,6,7,8,10,11,12,14,15,16,17,17,18,18,19,19,19,20,20,20,20,20,20,20,20
E01004533,EV motorcycles,Number,1,1,2,4,6,8,10,13,15,18,20,22,25,27,28,30,31,32,33,34,35,35,35,35,36,36,36,36,36,36
E01004534,EV motorcycles,Number,1,1,3,4,7,9,11,14,16,19,22,24,27,29,31,32,34,35,36,37,37,38,38,38,39,39,39,39,39,39
E01004535,EV motorcycles,Number,0,1,1,2,3,4,5,6,7,8,10,11,12,13,13,14,15,15,16,16,16,16,17,17,17,17,17,17,17,17
E01004536,EV motorcycles,Number,0,1,2,3,5,7,8,10,12,14,16,18,20,21,23,24,25,26,27,27,28,28,28,29,29,29,29,29,29,29
E01004537,EV motorcycles,Number,0,1,1,2,3,4,6,7,8,10,11,12,14,15,16,17,17,18,18,19,19,19,20,20,20,20,20,20,20,20
E01004538,EV motorcycles,Number,0,1,2,4,5,7,9,11,14,16,18,20,22,24,25,27,28,29,30,30,31,31,31,32,32,32,32,32,32,32
E01004539,EV motorcycles,Number,1,3,6,10,15,21,27,33,39,45,51,57,63,68,73,77,80,83,85,87,88,89,90,91,91,91,92,92,92,92
E01004540,EV motorcycles,Number,1,2,4,6,9,12,16,20,23,27,31,34,38,41,43,46,48,49,51,52,53,53,54,54,54,55,55,55,55,55
E01004541,EV motorcycles,Number,0,1,1,2,3,4,6,7,8,10,11,12,14,15,16,17,17,18,18,19,19,19,20,20,20,20,20,20,20,20
E01004542,EV motorcycles,Number,0,1,2,4,6,7,10,12,14,16,18,21,23,24,26,27,29,30,31,31,32,32,32,33,33,33,33,33,33,33
E01004543,EV motorcycles,Number,1,2,3,5,7,9,12,15,18,21,24,26,29,31,33,35,36,38,39,40,40,41,41,41,42,42,42,42,42,42
E01004544,EV motorcycles,Number,0,1,1,2,3,4,5,7,8,9,11,12,13,14,15,16,17,17,18,18,18,18,19,19,19,19,19,19,19,19
E01004545,EV motorcycles,Number,0,1,1,2,3,4,5,6,7,8,10,11,12,13,13,14,15,15,16,16,16,16,17,17,17,17,17,17,17,17
E01004546,EV motorcycles,Number,0,1,1,2,2,3,4,5,6,7,8,9,10,10,11,12,12,13,13,13,13,14,14,14,14,14,14,14,14,14
E01004547,EV motorcycles,Number,0,1,1,2,3,4,5,6,8,9,10,11,12,13,14,15,16,16,17,17,17,17,18,18,18,18,18,18,18,18
E01004548,EV motorcycles,Number,0,1,1,2,4,5,6,8,9,11,12,14,15,16,17,18,19,20,20,21,21,21,22,22,22,22,22,22,22,22
E01004549,EV motorcycles,Number,0,1,1,2,3,3,4,5,6,7,8,9,10,11,12,12,13,13,14,14,14,15,15,15,15,15,15,15,15,15
E01004550,EV motorcycles,Number,0,0,1,1,2,3,4,5,5,6,7,8,9,10,10,11,11,12,12,12,12,13,13,13,13,13,13,13,13,13
E01004551,EV motorcycles,Number,0,1,1,2,3,4,5,6,7,8,10,11,12,13,13,14,15,15,16,16,16,16,17,17,17,17,17,17,17,17
E01004552,EV motorcycles,Number,0,1,2,3,4,5,7,8,10,11,13,14,16,17,18,19,20,21,21,22,22,22,23,23,23,23,23,23,23,23
E01004553,EV motorcycles,Number,0,1,2,3,4,5,7,8,10,11,13,14,16,17,18,19,20,21,21,22,22,22,23,23,23,23,23,23,23,23
E01004554,EV motorcycles,Number,0,1,1,2,4,5,6,7,9,10,12,13,14,16,17,17,18,19,19,20,20,20,21,21,21,21,21,21,21,21
E01004555,EV motorcycles,Number,0,1,2,4,5,7,9,11,14,16,18,20,22,24,25,27,28,29,30,30,31,31,31,32,32,32,32,32,32,32
E01004556,EV motorcycles,Number,0,1,2,4,6,8,10,12,14,17,19,21,23,25,27,28,30,31,31,32,33,33,33,33,34,34,34,34,34,34
E01004557,EV motorcycles,Number,0,1,2,4,6,7,10,12,14,16,18,21,23,24,26,27,29,30,31,31,32,32,32,33,33,33,33,33,33,33
E01004558,EV motorcycles,Number,0,1,2,3,5,7,9,11,13,15,17,19,21,23,24,26,27,28,29,29,30,30,30,31,31,31,31,31,31,31
E01004559,EV motorcycles,Number,0,1,2,3,5,7,8,10,12,14,16,18,20,21,23,24,25,26,27,27,28,28,28,29,29,29,29,29,29,29
E01004560,EV motorcycles,Number,1,2,3,5,8,10,13,16,19,22,25,28,31,33,35,37,39,40,42,42,43,44,44,44,45,45,45,45,45,45
E01004562,EV motorcycles,Number,1,2,4,7,11,14,19,23,27,31,36,40,44,47,50,53,56,58,59,60,61,62,63,63,63,64,64,64,64,64
E01004563,EV motorcycles,Number,1,2,3,5,7,10,12,15,18,21,24,27,29,32,34,36,37,39,40,41,41,42,42,42,43,43,43,43,43,43
E01004564,EV motorcycles,Number,0,1,2,3,5,7,9,11,13,15,17,19,21,22,24,25,26,27,28,28,29,29,29,30,30,30,30,30,30,30
E01004565,EV motorcycles,Number,0,1,2,3,4,5,7,9,10,12,13,15,16,18,19,20,21,22,22,23,23,23,23,24,24,24,24,24,24,24
E01004566,EV motorcycles,Number,0,1,2,3,5,7,8,10,12,14,16,18,20,21,23,24,25,26,27,27,28,28,28,29,29,29,29,29,29,29
E01004567,EV motorcycles,Number,0,1,1,2,3,4,5,7,8,9,11,12,13,14,15,16,17,17,18,18,18,18,19,19,19,19,19,19,19,19
E01004568,EV motorcycles,Number,0,1,1,2,3,4,5,7,8,9,11,12,13,14,15,16,17,17,18,18,18,18,19,19,19,19,19,19,19,19
E01004569,EV motorcycles,Number,1,2,3,5,8,11,14,17,20,24,27,30,33,35,38,40,42,43,44,45,46,47,47,47,48,48,48,48,48,48
E01004570,EV motorcycles,Number,1,1,2,4,6,8,10,13,15,18,20,22,25,27,28,30,31,32,33,34,35,35,35,35,36,36,36,36,36,36
E01004571,EV motorcycles,Number,1,1,3,4,7,9,11,14,16,19,22,24,27,29,31,32,34,35,36,37,37,38,38,38,39,39,39,39,39,39
E01004572,EV motorcycles,Number,1,1,2,4,6,9,11,13,16,19,21,24,26,28,30,32,33,34,35,36,36,37,37,37,38,38,38,38,38,38
E01004573,EV motorcycles,Number,1,2,4,6,9,12,16,20,23,27,31,34,38,41,43,46,48,49,51,52,53,53,54,54,54,55,55,55,55,55
E01004574,EV motorcycles,Number,0,1,2,3,4,5,7,8,10,11,13,14,16,17,18,19,20,21,21,22,22,22,23,23,23,23,23,23,23,23
E01004575,EV motorcycles,Number,0,1,2,3,4,5,7,9,10,12,13,15,16,18,19,20,21,22,22,23,23,23,23,24,24,24,24,24,24,24
E01004576,EV motorcycles,Number,1,1,2,4,6,9,11,13,16,19,21,24,26,28,30,32,33,34,35,36,36,37,37,37,38,38,38,38,38,38
E01004577,EV motorcycles,Number,1,1,2,4,6,8,10,13,15,18,20,22,25,27,28,30,31,32,33,34,35,35,35,35,36,36,36,36,36,36
E01004579,EV motorcycles,Number,1,1,3,4,7,9,12,14,17,20,22,25,27,30,32,33,35,36,37,38,38,39,39,39,40,40,40,40,40,40
E01004580,EV motorcycles,Number,1,2,3,5,8,10,13,16,19,23,26,29,31,34,36,38,40,41,43,43,44,45,45,45,46,46,46,46,46,46
E01004581,EV motorcycles,Number,1,1,2,4,6,8,11,13,16,18,21,23,25,27,29,31,32,33,34,35,35,36,36,36,37,37,37,37,37,37
E01004582,EV motorcycles,Number,1,1,2,4,6,9,11,13,16,19,21,24,26,28,30,32,33,34,35,36,36,37,37,37,38,38,38,38,38,38
E01004583,EV motorcycles,Number,1,2,4,6,10,13,17,21,25,29,32,36,40,43,46,48,50,52,54,55,56,56,57,57,57,58,58,58,58,58
E01004584,EV motorcycles,Number,0,1,2,3,4,6,7,9,11,12,14,16,17,18,20,21,22,22,23,24,24,24,24,25,25,25,25,25,25,25
E01004585,EV motorcycles,Number,0,1,1,2,3,3,4,5,6,7,8,9,10,11,12,12,13,13,14,14,14,15,15,15,15,15,15,15,15,15
E01004586,EV motorcycles,Number,0,1,1,2,4,5,6,7,9,10,12,13,14,16,17,17,18,19,19,20,20,20,21,21,21,21,21,21,21,21
E01004587,EV motorcycles,Number,1,1,2,4,6,8,10,12,15,17,20,22,24,26,28,29,30,31,32,33,34,34,34,34,35,35,35,35,35,35
E01004588,EV motorcycles,Number,0,1,2,3,4,5,7,8,10,11,13,14,16,17,18,19,20,21,21,22,22,22,23,23,23,23,23,23,23,23
E01004589,EV motorcycles,Number,1,2,3,5,8,10,13,16,19,23,26,29,31,34,36,38,40,41,43,43,44,45,45,45,46,46,46,46,46,46
E01004590,EV motorcycles,Number,0,1,2,3,5,6,8,10,11,13,15,17,18,20,21,22,23,24,25,25,26,26,26,27,27,27,27,27,27,27
E01004591,EV motorcycles,Number,0,1,2,4,6,8,10,12,14,17,19,21,23,25,27,28,30,31,31,32,33,33,33,33,34,34,34,34,34,34
E01004592,EV motorcycles,Number,0,0,1,1,2,3,4,5,5,6,7,8,9,10,10,11,11,12,12,12,12,13,13,13,13,13,13,13,13,13
E01004593,EV motorcycles,Number,1,1,2,4,6,9,11,13,16,19,21,24,26,28,30,32,33,34,35,36,36,37,37,37,38,38,38,38,38,38
E01004594,EV motorcycles,Number,0,1,2,3,4,5,7,9,10,12,13,15,16,18,19,20,21,22,22,23,23,23,23,24,24,24,24,24,24,24
E01004595,EV motorcycles,Number,1,1,3,4,7,9,11,14,16,19,22,24,27,29,31,32,34,35,36,37,37,38,38,38,39,39,39,39,39,39
E01004596,EV motorcycles,Number,0,1,2,3,4,6,8,9,11,13,15,16,18,19,20,22,23,23,24,25,25,25,25,26,26,26,26,26,26,26
E01004597,EV motorcycles,Number,0,1,2,3,4,5,7,9,10,12,13,15,16,18,19,20,21,22,22,23,23,23,23,24,24,24,24,24,24,24
E01004598,EV motorcycles,Number,0,1,1,2,3,4,6,7,8,10,11,12,14,15,16,17,17,18,18,19,19,19,20,20,20,20,20,20,20,20
E01004599,EV motorcycles,Number,0,1,1,2,3,4,5,7,8,9,11,12,13,14,15,16,17,17,18,18,18,18,19,19,19,19,19,19,19,19
E01004600,EV motorcycles,Number,1,1,2,4,6,8,10,13,15,18,20,22,25,27,28,30,31,32,33,34,35,35,35,35,36,36,36,36,36,36
E01004601,EV motorcycles,Number,1,2,4,6,9,12,16,20,23,27,31,34,38,41,43,46,48,49,51,52,53,53,54,54,54,55,55,55,55,55
E01004602,EV motorcycles,Number,1,2,3,5,7,10,13,16,19,22,25,27,30,33,35,37,38,40,41,42,42,43,43,43,44,44,44,44,44,44
E01004604,EV motorcycles,Number,0,1,2,4,6,7,10,12,14,16,18,21,23,24,26,27,29,30,31,31,32,32,32,33,33,33,33,33,33,33
E01004605,EV motorcycles,Number,1,1,2,4,6,8,10,13,15,18,20,22,25,27,28,30,31,32,33,34,35,35,35,35,36,36,36,36,36,36
E01004606,EV motorcycles,Number,0,1,2,3,4,6,8,9,11,13,15,16,18,19,20,22,23,23,24,25,25,25,25,26,26,26,26,26,26,26
E01004607,EV motorcycles,Number,0,1,2,3,5,7,9,11,13,15,17,19,21,22,24,25,26,27,28,28,29,29,29,30,30,30,30,30,30,30
E01004608,EV motorcycles,Number,0,1,1,2,3,4,5,6,8,9,10,11,12,13,14,15,16,16,17,17,17,17,18,18,18,18,18,18,18,18
E01004609,EV motorcycles,Number,0,1,2,3,5,6,8,10,11,13,15,17,18,20,21,22,23,24,25,25,26,26,26,27,27,27,27,27,27,27
E01004610,EV motorcycles,Number,0,1,1,2,4,5,6,8,9,11,12,14,15,16,17,18,19,20,20,21,21,21,22,22,22,22,22,22,22,22
E01004611,EV motorcycles,Number,0,1,1,2,3,4,5,7,8,9,11,12,13,14,15,16,17,17,18,18,18,18,19,19,19,19,19,19,19,19
E01004612,EV motorcycles,Number,1,1,2,4,6,8,11,13,16,18,21,23,25,27,29,31,32,33,34,35,35,36,36,36,37,37,37,37,37,37
E01004613,EV motorcycles,Number,0,1,2,3,4,6,7,9,11,12,14,16,17,18,20,21,22,22,23,24,24,24,24,25,25,25,25,25,25,25
E01004614,EV motorcycles,Number,0,1,1,2,3,4,6,7,8,10,11,12,14,15,16,17,17,18,18,19,19,19,20,20,20,20,20,20,20,20
E01004615,EV motorcycles,Number,0,1,2,4,6,7,10,12,14,16,18,21,23,24,26,27,29,30,31,31,32,32,32,33,33,33,33,33,33,33
E01004616,EV motorcycles,Number,1,2,3,5,7,10,12,15,18,21,24,27,29,32,34,36,37,39,40,41,41,42,42,42,43,43,43,43,43,43
E01004617,EV motorcycles,Number,1,1,3,4,7,9,11,14,16,19,22,24,27,29,31,32,34,35,36,37,37,38,38,38,39,39,39,39,39,39
E01004618,EV motorcycles,Number,0,1,1,2,3,4,5,6,7,8,9,10,11,12,13,13,14,14,15,15,15,16,16,16,16,16,16,16,16,16
E01004619,EV motorcycles,Number,0,1,1,2,3,4,5,7,8,9,11,12,13,14,15,16,17,17,18,18,18,18,19,19,19,19,19,19,19,19
E01004620,EV motorcycles,Number,1,2,3,5,8,11,14,17,20,23,26,29,32,35,37,39,41,42,43,44,45,46,46,46,47,47,47,47,47,47
E01004621,EV motorcycles,Number,1,1,2,4,6,8,10,13,15,18,20,22,25,27,28,30,31,32,33,34,35,35,35,35,36,36,36,36,36,36
E01004622,EV motorcycles,Number,0,1,1,2,4,5,6,8,9,11,12,14,15,16,17,18,19,20,20,21,21,21,22,22,22,22,22,22,22,22
E01004623,EV motorcycles,Number,0,1,2,3,5,6,8,10,12,14,16,17,19,21,22,23,24,25,26,26,27,27,27,28,28,28,28,28,28,28
E01004624,EV motorcycles,Number,0,1,2,3,5,6,8,10,11,13,15,17,18,20,21,22,23,24,25,25,26,26,26,27,27,27,27,27,27,27
E01004625,EV motorcycles,Number,1,1,3,4,7,9,11,14,16,19,22,24,27,29,31,32,34,35,36,37,37,38,38,38,39,39,39,39,39,39
E01004626,EV motorcycles,Number,1,1,3,4,7,9,11,14,16,19,22,24,27,29,31,32,34,35,36,37,37,38,38,38,39,39,39,39,39,39
E01004627,EV motorcycles,Number,0,1,2,3,5,7,9,11,13,15,17,19,21,23,24,26,27,28,29,29,30,30,30,31,31,31,31,31,31,31
E01004628,EV motorcycles,Number,1,1,3,4,7,9,12,14,17,20,22,25,27,30,32,33,35,36,37,38,38,39,39,39,40,40,40,40,40,40
E01004629,EV motorcycles,Number,1,2,3,5,8,10,13,16,19,22,25,28,31,33,35,37,39,40,42,42,43,44,44,44,45,45,45,45,45,45
E01004630,EV motorcycles,Number,0,1,2,3,4,6,8,9,11,13,15,16,18,19,20,22,23,23,24,25,25,25,25,26,26,26,26,26,26,26
E01004631,EV motorcycles,Number,1,2,3,5,8,11,14,17,20,23,26,29,32,35,37,39,41,42,43,44,45,46,46,46,47,47,47,47,47,47
E01004632,EV motorcycles,Number,0,1,2,4,6,7,10,12,14,16,18,21,23,24,26,27,29,30,31,31,32,32,32,33,33,33,33,33,33,33
E01004633,EV motorcycles,Number,1,1,2,4,6,9,11,13,16,19,21,24,26,28,30,32,33,34,35,36,36,37,37,37,38,38,38,38,38,38
E01004634,EV motorcycles,Number,0,1,2,4,5,7,9,11,14,16,18,20,22,24,25,27,28,29,30,30,31,31,31,32,32,32,32,32,32,32
E01004635,EV motorcycles,Number,1,4,7,11,17,23,30,37,44,51,58,64,70,76,81,86,89,93,95,97,99,100,101,101,102,102,103,103,103,103
E01004636,EV motorcycles,Number,1,1,2,4,6,8,11,13,16,18,21,23,25,27,29,31,32,33,34,35,35,36,36,36,37,37,37,37,37,37
E01004637,EV motorcycles,Number,1,1,2,4,6,8,10,13,15,18,20,22,25,27,28,30,31,32,33,34,35,35,35,35,36,36,36,36,36,36
E01004638,EV motorcycles,Number,0,1,2,4,5,7,9,11,14,16,18,20,22,24,25,27,28,29,30,30,31,31,31,32,32,32,32,32,32,32
E01004639,EV motorcycles,Number,1,2,3,5,8,11,14,17,20,23,26,29,32,35,37,39,41,42,43,44,45,46,46,46,47,47,47,47,47,47
E01004640,EV motorcycles,Number,0,1,2,4,5,7,9,11,14,16,18,20,22,24,25,27,28,29,30,30,31,31,31,32,32,32,32,32,32,32
E01004641,EV motorcycles,Number,1,1,2,4,6,8,10,12,15,17,20,22,24,26,28,29,30,31,32,33,34,34,34,34,35,35,35,35,35,35
E01004642,EV motorcycles,Number,1,1,3,4,7,9,12,14,17,20,22,25,27,30,32,33,35,36,37,38,38,39,39,39,40,40,40,40,40,40
E01004643,EV motorcycles,Number,0,1,2,4,6,8,10,12,14,17,19,21,23,25,27,28,30,31,31,32,33,33,33,33,34,34,34,34,34,34
E01004644,EV motorcycles,Number,1,2,4,7,10,13,17,21,25,29,33,37,40,44,47,49,51,53,55,56,57,57,58,58,58,59,59,59,59,59
E01004645,EV motorcycles,Number,0,1,2,4,6,8,10,12,14,17,19,21,23,25,27,28,30,31,31,32,33,33,33,33,34,34,34,34,34,34
E01004646,EV motorcycles,Number,0,1,1,2,2,3,4,5,6,7,8,9,10,10,11,12,12,13,13,13,13,14,14,14,14,14,14,14,14,14
E01004647,EV motorcycles,Number,0,1,1,2,3,3,4,5,6,7,8,9,10,11,12,12,13,13,14,14,14,15,15,15,15,15,15,15,15,15
E01004648,EV motorcycles,Number,0,1,1,2,3,4,6,7,8,10,11,12,14,15,16,17,17,18,18,19,19,19,20,20,20,20,20,20,20,20
E01004649,EV motorcycles,Number,0,0,0,1,1,1,2,2,3,3,3,4,4,4,5,5,5,5,6,6,6,6,6,6,6,6,6,6,6,6
E01004650,EV motorcycles,Number,0,0,1,1,2,3,3,4,5,6,7,7,8,9,9,10,10,11,11,11,12,12,12,12,12,12,12,12,12,12
E01004651,EV motorcycles,Number,0,0,0,1,1,2,2,2,3,3,4,4,5,5,6,6,6,6,6,7,7,7,7,7,7,7,7,7,7,7
E01004652,EV motorcycles,Number,0,1,1,2,4,5,6,8,9,11,12,14,15,16,17,18,19,20,20,21,21,21,22,22,22,22,22,22,22,22
E01004653,EV motorcycles,Number,0,1,2,3,5,6,8,10,12,14,16,17,19,21,22,23,24,25,26,26,27,27,27,28,28,28,28,28,28,28
E01004654,EV motorcycles,Number,0,1,2,3,4,6,7,9,11,12,14,16,17,18,20,21,22,22,23,24,24,24,24,25,25,25,25,25,25,25
E01004656,EV motorcycles,Number,0,1,2,3,4,5,7,8,10,11,13,14,16,17,18,19,20,21,21,22,22,22,23,23,23,23,23,23,23,23
E01004657,EV motorcycles,Number,0,0,1,1,2,3,3,4,5,6,7,7,8,9,9,10,10,11,11,11,12,12,12,12,12,12,12,12,12,12
E01004658,EV motorcycles,Number,0,1,1,2,2,3,4,5,6,7,8,9,10,10,11,12,12,13,13,13,13,14,14,14,14,14,14,14,14,14
E01004659,EV motorcycles,Number,0,0,1,1,2,3,3,4,5,6,7,7,8,9,9,10,10,11,11,11,12,12,12,12,12,12,12,12,12,12
E01004660,EV motorcycles,Number,0,0,0,1,1,1,1,2,2,2,3,3,3,4,4,4,4,4,5,5,5,5,5,5,5,5,5,5,5,5
E01004661,EV motorcycles,Number,0,1,2,3,4,5,7,8,10,11,13,14,16,17,18,19,20,21,21,22,22,22,23,23,23,23,23,23,23,23
E01004662,EV motorcycles,Number,0,1,1,2,2,3,4,5,6,7,8,9,10,10,11,12,12,13,13,13,13,14,14,14,14,14,14,14,14,14
E01004663,EV motorcycles,Number,0,1,1,2,3,4,6,7,8,10,11,12,14,15,16,17,17,18,18,19,19,19,20,20,20,20,20,20,20,20
E01004665,EV motorcycles,Number,0,1,1,2,3,4,6,7,8,10,11,12,14,15,16,17,17,18,18,19,19,19,20,20,20,20,20,20,20,20
E01004666,EV motorcycles,Number,0,0,0,1,1,2,2,2,3,3,4,4,5,5,6,6,6,6,6,7,7,7,7,7,7,7,7,7,7,7
E01004667,EV motorcycles,Number,0,1,2,3,4,5,7,9,10,12,13,15,16,18,19,20,21,22,22,23,23,23,23,24,24,24,24,24,24,24
E01004668,EV motorcycles,Number,0,1,1,2,3,4,5,7,8,9,11,12,13,14,15,16,17,17,18,18,18,18,19,19,19,19,19,19,19,19
E01004669,EV motorcycles,Number,0,1,1,2,3,3,4,5,6,7,8,9,10,11,12,12,13,13,14,14,14,15,15,15,15,15,15,15,15,15
E01004670,EV motorcycles,Number,0,1,2,3,4,5,7,8,10,11,13,14,16,17,18,19,20,21,21,22,22,22,23,23,23,23,23,23,23,23
E01004674,EV motorcycles,Number,0,1,2,3,4,6,7,9,11,12,14,16,17,18,20,21,22,22,23,24,24,24,24,25,25,25,25,25,25,25
E01004675,EV motorcycles,Number,1,1,2,4,6,8,10,13,15,18,20,22,25,27,28,30,31,32,33,34,35,35,35,35,36,36,36,36,36,36
E01004676,EV motorcycles,Number,0,1,2,3,5,7,8,10,12,14,16,18,20,21,23,24,25,26,27,27,28,28,28,29,29,29,29,29,29,29
E01004677,EV motorcycles,Number,0,1,2,3,4,6,8,9,11,13,15,16,18,19,20,22,23,23,24,25,25,25,25,26,26,26,26,26,26,26
E01004678,EV motorcycles,Number,0,1,2,3,5,7,8,10,12,14,16,18,20,21,23,24,25,26,27,27,28,28,28,29,29,29,29,29,29,29
E01004679,EV motorcycles,Number,0,1,2,3,5,7,9,11,13,15,17,19,21,22,24,25,26,27,28,28,29,29,29,30,30,30,30,30,30,30
E01004680,EV motorcycles,Number,0,1,1,2,2,3,4,5,6,7,8,9,10,10,11,12,12,13,13,13,13,14,14,14,14,14,14,14,14,14
E01004681,EV motorcycles,Number,0,1,1,2,2,3,4,5,6,7,8,9,10,10,11,12,12,13,13,13,13,14,14,14,14,14,14,14,14,14
E01004682,EV motorcycles,Number,0,0,1,1,2,2,3,3,4,4,5,6,6,7,7,7,8,8,8,8,9,9,9,9,9,9,9,9,9,9
E01004683,EV motorcycles,Number,0,1,1,2,3,4,5,6,7,8,9,10,11,12,13,13,14,14,15,15,15,16,16,16,16,16,16,16,16,16
E01004684,EV motorcycles,Number,0,0,1,1,2,3,3,4,5,6,7,7,8,9,9,10,10,11,11,11,12,12,12,12,12,12,12,12,12,12
E01004686,EV motorcycles,Number,0,1,1,2,3,4,5,6,8,9,10,11,12,13,14,15,16,16,17,17,17,17,18,18,18,18,18,18,18,18
E01004687,EV motorcycles,Number,0,1,1,2,2,3,4,5,6,7,8,9,10,10,11,12,12,13,13,13,13,14,14,14,14,14,14,14,14,14
E01004688,EV motorcycles,Number,0,0,1,1,2,3,3,4,5,6,7,7,8,9,9,10,10,11,11,11,12,12,12,12,12,12,12,12,12,12
E01004689,EV motorcycles,Number,0,0,1,1,1,2,2,3,3,4,4,5,5,6,6,7,7,7,7,8,8,8,8,8,8,8,8,8,8,8
E01004690,EV motorcycles,Number,0,1,1,2,4,5,6,8,9,11,12,14,15,16,17,18,19,20,20,21,21,21,22,22,22,22,22,22,22,22
E01004691,EV motorcycles,Number,0,0,1,1,2,2,3,4,5,5,6,7,8,8,9,9,10,10,10,10,11,11,11,11,11,11,11,11,11,11
E01004692,EV motorcycles,Number,0,1,1,2,3,4,5,6,7,8,10,11,12,13,13,14,15,15,16,16,16,16,17,17,17,17,17,17,17,17
E01004693,EV motorcycles,Number,0,0,1,1,1,2,2,3,3,4,4,5,5,6,6,7,7,7,7,8,8,8,8,8,8,8,8,8,8,8
E01004694,EV motorcycles,Number,0,1,1,2,3,4,5,7,8,9,11,12,13,14,15,16,17,17,18,18,18,18,19,19,19,19,19,19,19,19
E01004695,EV motorcycles,Number,0,0,1,1,2,2,3,3,4,4,5,6,6,7,7,7,8,8,8,8,9,9,9,9,9,9,9,9,9,9
E01004696,EV motorcycles,Number,0,0,1,1,2,2,3,4,5,5,6,7,8,8,9,9,10,10,10,10,11,11,11,11,11,11,11,11,11,11
E01004697,EV motorcycles,Number,0,0,1,1,2,2,3,4,4,5,6,6,7,7,8,8,9,9,9,9,10,10,10,10,10,10,10,10,10,10
E01004698,EV motorcycles,Number,0,0,1,1,2,3,4,5,5,6,7,8,9,10,10,11,11,12,12,12,12,13,13,13,13,13,13,13,13,13
E01004699,EV motorcycles,Number,0,1,2,3,4,5,7,9,10,12,13,15,16,18,19,20,21,22,22,23,23,23,23,24,24,24,24,24,24,24
E01004700,EV motorcycles,Number,0,0,0,1,1,1,2,2,3,3,3,4,4,4,5,5,5,5,6,6,6,6,6,6,6,6,6,6,6,6
E01004701,EV motorcycles,Number,0,0,1,1,2,2,3,4,5,5,6,7,8,8,9,9,10,10,10,10,11,11,11,11,11,11,11,11,11,11
E01004702,EV motorcycles,Number,0,1,1,2,3,4,5,6,8,9,10,11,12,13,14,15,16,16,17,17,17,17,18,18,18,18,18,18,18,18
E01004703,EV motorcycles,Number,0,0,1,1,2,3,4,5,5,6,7,8,9,10,10,11,11,12,12,12,12,13,13,13,13,13,13,13,13,13
E01004705,EV motorcycles,Number,0,1,1,2,3,3,4,5,6,7,8,9,10,11,12,12,13,13,14,14,14,15,15,15,15,15,15,15,15,15
E01004706,EV motorcycles,Number,0,1,1,2,3,4,5,6,7,8,9,10,11,12,13,13,14,14,15,15,15,16,16,16,16,16,16,16,16,16
E01004707,EV motorcycles,Number,0,1,1,2,4,5,6,8,9,11,12,14,15,16,17,18,19,20,20,21,21,21,22,22,22,22,22,22,22,22
E01004708,EV motorcycles,Number,0,1,1,2,3,3,4,5,6,7,8,9,10,11,12,12,13,13,14,14,14,15,15,15,15,15,15,15,15,15
E01004709,EV motorcycles,Number,0,0,1,1,2,3,4,5,5,6,7,8,9,10,10,11,11,12,12,12,12,13,13,13,13,13,13,13,13,13
E01004710,EV motorcycles,Number,0,1,1,2,3,4,5,6,8,9,10,11,12,13,14,15,16,16,17,17,17,17,18,18,18,18,18,18,18,18
E01004711,EV motorcycles,Number,0,1,1,2,4,5,6,8,9,11,12,14,15,16,17,18,19,20,20,21,21,21,22,22,22,22,22,22,22,22
E01004712,EV motorcycles,Number,0,1,1,2,3,4,6,7,8,10,11,12,14,15,16,17,17,18,18,19,19,19,20,20,20,20,20,20,20,20
E01004713,EV motorcycles,Number,0,0,1,1,2,3,4,5,5,6,7,8,9,10,10,11,11,12,12,12,12,13,13,13,13,13,13,13,13,13
E01004714,EV motorcycles,Number,0,1,2,3,4,6,7,9,11,12,14,16,17,18,20,21,22,22,23,24,24,24,24,25,25,25,25,25,25,25
E01004715,EV motorcycles,Number,0,1,2,3,4,5,7,9,10,12,13,15,16,18,19,20,21,22,22,23,23,23,23,24,24,24,24,24,24,24
E01004716,EV motorcycles,Number,0,1,1,2,3,4,5,6,8,9,10,11,12,13,14,15,16,16,17,17,17,17,18,18,18,18,18,18,18,18
E01004717,EV motorcycles,Number,0,0,1,1,2,2,3,4,5,5,6,7,8,8,9,9,10,10,10,10,11,11,11,11,11,11,11,11,11,11
E01004718,EV motorcycles,Number,0,1,2,3,4,5,7,9,10,12,13,15,16,18,19,20,21,22,22,23,23,23,23,24,24,24,24,24,24,24
E01004719,EV motorcycles,Number,1,1,2,4,6,8,11,13,16,18,21,23,25,27,29,31,32,33,34,35,35,36,36,36,37,37,37,37,37,37
E01004720,EV motorcycles,Number,0,1,2,3,4,6,8,9,11,13,15,16,18,19,20,22,23,23,24,25,25,25,25,26,26,26,26,26,26,26
E01004721,EV motorcycles,Number,0,1,1,2,3,4,5,6,8,9,10,11,12,13,14,15,16,16,17,17,17,17,18,18,18,18,18,18,18,18
E01004722,EV motorcycles,Number,1,1,2,4,6,8,10,12,15,17,20,22,24,26,28,29,30,31,32,33,34,34,34,34,35,35,35,35,35,35
E01004723,EV motorcycles,Number,0,1,2,3,4,6,7,9,11,12,14,16,17,18,20,21,22,22,23,24,24,24,24,25,25,25,25,25,25,25
E01004724,EV motorcycles,Number,0,0,1,1,2,2,3,4,4,5,6,6,7,7,8,8,9,9,9,9,10,10,10,10,10,10,10,10,10,10
E01004725,EV motorcycles,Number,0,0,1,1,2,3,3,4,5,6,7,7,8,9,9,10,10,11,11,11,12,12,12,12,12,12,12,12,12,12
E01004726,EV motorcycles,Number,0,0,1,1,2,2,3,4,5,5,6,7,8,8,9,9,10,10,10,10,11,11,11,11,11,11,11,11,11,11
E01004727,EV motorcycles,Number,0,0,0,1,1,1,2,2,3,3,3,4,4,4,5,5,5,5,6,6,6,6,6,6,6,6,6,6,6,6
E01004728,EV motorcycles,Number,0,0,1,1,2,2,3,4,5,5,6,7,8,8,9,9,10,10,10,10,11,11,11,11,11,11,11,11,11,11
E01004729,EV motorcycles,Number,0,0,1,1,2,2,3,4,4,5,6,6,7,7,8,8,9,9,9,9,10,10,10,10,10,10,10,10,10,10
E01004730,EV motorcycles,Number,0,0,0,0,0,0,0,0,0,0,0,0,0,0,0,0,0,0,0,0,0,0,0,0,0,0,0,0,0,0
E01004731,EV motorcycles,Number,0,1,1,2,4,5,6,8,9,11,12,14,15,16,17,18,19,20,20,21,21,21,22,22,22,22,22,22,22,22
E01004732,EV motorcycles,Number,0,1,1,2,4,5,6,8,9,11,12,14,15,16,17,18,19,20,20,21,21,21,22,22,22,22,22,22,22,22
E01004733,EV motorcycles,Number,0,1,2,4,6,7,10,12,14,16,18,21,23,24,26,27,29,30,31,31,32,32,32,33,33,33,33,33,33,33
E01004734,EV motorcycles,Number,0,1,1,2,3,4,5,6,8,9,10,11,12,13,14,15,16,16,17,17,17,17,18,18,18,18,18,18,18,18
E01004735,EV motorcycles,Number,0,1,1,2,3,4,5,6,7,8,9,10,11,12,13,13,14,14,15,15,15,16,16,16,16,16,16,16,16,16
E01004736,EV motorcycles,Number,0,1,1,2,3,4,6,7,8,10,11,12,14,15,16,17,17,18,18,19,19,19,20,20,20,20,20,20,20,20
E01004737,EV motorcycles,Number,0,0,1,1,2,2,3,4,5,5,6,7,8,8,9,9,10,10,10,10,11,11,11,11,11,11,11,11,11,11
E01004738,EV motorcycles,Number,0,1,1,2,2,3,4,5,6,7,8,9,10,10,11,12,12,13,13,13,13,14,14,14,14,14,14,14,14,14
E01004739,EV motorcycles,Number,0,0,0,1,1,1,1,2,2,2,3,3,3,4,4,4,4,4,5,5,5,5,5,5,5,5,5,5,5,5
E01004740,EV motorcycles,Number,0,0,1,1,2,2,3,4,5,5,6,7,8,8,9,9,10,10,10,10,11,11,11,11,11,11,11,11,11,11
E01004741,EV motorcycles,Number,0,0,1,1,2,3,3,4,5,6,7,7,8,9,9,10,10,11,11,11,12,12,12,12,12,12,12,12,12,12
E01004742,EV motorcycles,Number,0,1,2,3,5,7,9,11,13,15,17,19,21,23,24,26,27,28,29,29,30,30,30,31,31,31,31,31,31,31
E01004743,EV motorcycles,Number,0,0,1,1,2,3,3,4,5,6,7,7,8,9,9,10,10,11,11,11,12,12,12,12,12,12,12,12,12,12
E01004744,EV motorcycles,Number,0,0,1,1,2,3,4,5,5,6,7,8,9,10,10,11,11,12,12,12,12,13,13,13,13,13,13,13,13,13
E01004745,EV motorcycles,Number,0,0,1,1,2,2,3,4,5,5,6,7,8,8,9,9,10,10,10,10,11,11,11,11,11,11,11,11,11,11
E01004746,EV motorcycles,Number,0,1,1,2,3,3,4,5,6,7,8,9,10,11,12,12,13,13,14,14,14,15,15,15,15,15,15,15,15,15
E01004747,EV motorcycles,Number,0,1,2,3,4,5,7,9,10,12,13,15,16,18,19,20,21,22,22,23,23,23,23,24,24,24,24,24,24,24
E01004748,EV motorcycles,Number,0,0,1,1,2,2,3,4,4,5,6,6,7,7,8,8,9,9,9,9,10,10,10,10,10,10,10,10,10,10
E01004749,EV motorcycles,Number,0,1,2,3,5,7,8,10,12,14,16,18,20,21,23,24,25,26,27,27,28,28,28,29,29,29,29,29,29,29
E01004750,EV motorcycles,Number,0,1,1,2,3,4,6,7,8,10,11,12,14,15,16,17,17,18,18,19,19,19,20,20,20,20,20,20,20,20
E01004751,EV motorcycles,Number,0,1,1,2,4,5,6,7,9,10,12,13,14,16,17,17,18,19,19,20,20,20,21,21,21,21,21,21,21,21
E01004752,EV motorcycles,Number,0,1,2,3,5,7,9,11,13,15,17,19,21,23,24,26,27,28,29,29,30,30,30,31,31,31,31,31,31,31
E01004753,EV motorcycles,Number,0,1,1,2,2,3,4,5,6,7,8,9,10,10,11,12,12,13,13,13,13,14,14,14,14,14,14,14,14,14
E01004754,EV motorcycles,Number,0,0,1,1,2,3,3,4,5,6,7,7,8,9,9,10,10,11,11,11,12,12,12,12,12,12,12,12,12,12
E01004755,EV motorcycles,Number,1,1,3,4,7,9,11,14,16,19,22,24,27,29,31,32,34,35,36,37,37,38,38,38,39,39,39,39,39,39
E01004756,EV motorcycles,Number,0,1,1,2,3,4,5,7,8,9,11,12,13,14,15,16,17,17,18,18,18,18,19,19,19,19,19,19,19,19
E01004757,EV motorcycles,Number,0,1,1,2,3,3,4,5,6,7,8,9,10,11,12,12,13,13,14,14,14,15,15,15,15,15,15,15,15,15
E01004760,EV motorcycles,Number,0,1,1,2,3,4,6,7,8,10,11,12,14,15,16,17,17,18,18,19,19,19,20,20,20,20,20,20,20,20
E01004761,EV motorcycles,Number,0,1,2,3,5,7,9,11,13,15,17,19,21,23,24,26,27,28,29,29,30,30,30,31,31,31,31,31,31,31
E01004762,EV motorcycles,Number,1,3,6,10,15,20,26,32,38,45,51,57,62,67,72,76,79,82,84,86,87,88,89,90,90,90,91,91,91,91
E01004763,EV motorcycles,Number,0,1,2,3,4,6,8,9,11,13,15,16,18,19,20,22,23,23,24,25,25,25,25,26,26,26,26,26,26,26
E01004765,EV motorcycles,Number,0,1,1,2,3,4,6,7,8,10,11,12,14,15,16,17,17,18,18,19,19,19,20,20,20,20,20,20,20,20
E01015589,EV motorcycles,Number,0,1,2,3,4,5,7,9,10,12,14,15,17,18,19,20,21,22,22,23,23,24,24,24,24,24,24,24,24,24
E01015591,EV motorcycles,Number,0,1,2,4,6,7,10,12,14,16,18,21,23,24,26,27,29,30,31,31,32,32,32,33,33,33,33,33,33,33
E01015592,EV motorcycles,Number,0,1,2,3,5,6,8,10,11,13,15,17,18,20,21,22,23,24,25,25,26,26,26,27,27,27,27,27,27,27
E01015593,EV motorcycles,Number,0,1,2,3,5,7,9,11,13,15,17,19,21,23,24,26,27,28,29,29,30,30,30,31,31,31,31,31,31,31
E01015594,EV motorcycles,Number,0,1,2,3,5,6,8,10,12,14,16,17,19,21,22,23,24,25,26,26,27,27,27,28,28,28,28,28,28,28
E01015595,EV motorcycles,Number,0,1,2,3,4,6,8,9,11,13,15,16,18,19,20,22,23,23,24,25,25,25,25,26,26,26,26,26,26,26
E01015596,EV motorcycles,Number,0,1,1,2,3,4,5,7,8,9,11,12,13,14,15,16,17,17,18,18,18,18,19,19,19,19,19,19,19,19
E01015597,EV motorcycles,Number,0,1,1,2,4,5,6,8,9,11,12,14,15,16,17,18,19,20,20,21,21,21,22,22,22,22,22,22,22,22
E01015598,EV motorcycles,Number,0,1,2,3,4,6,7,9,11,12,14,16,17,18,20,21,22,22,23,24,24,24,24,25,25,25,25,25,25,25
E01015599,EV motorcycles,Number,0,0,0,1,1,2,2,2,3,3,4,4,5,5,6,6,6,6,6,7,7,7,7,7,7,7,7,7,7,7
E01015600,EV motorcycles,Number,0,0,0,1,1,1,1,2,2,2,3,3,3,4,4,4,4,4,5,5,5,5,5,5,5,5,5,5,5,5
E01015601,EV motorcycles,Number,0,0,0,1,1,1,2,2,3,3,3,4,4,4,5,5,5,5,6,6,6,6,6,6,6,6,6,6,6,6
E01015602,EV motorcycles,Number,0,0,1,1,2,2,3,4,5,5,6,7,8,8,9,9,10,10,10,10,11,11,11,11,11,11,11,11,11,11
E01015603,EV motorcycles,Number,0,1,2,3,4,6,8,9,11,13,15,16,18,19,20,22,23,23,24,25,25,25,25,26,26,26,26,26,26,26
E01015604,EV motorcycles,Number,0,0,0,0,0,0,0,0,0,0,0,0,0,0,0,0,0,0,0,0,0,0,0,0,0,0,0,0,0,0
E01015605,EV motorcycles,Number,0,1,1,2,3,4,6,7,8,10,11,12,14,15,16,17,17,18,18,19,19,19,20,20,20,20,20,20,20,20
E01015606,EV motorcycles,Number,0,1,2,3,4,6,7,9,11,12,14,16,17,18,20,21,22,22,23,24,24,24,24,25,25,25,25,25,25,25
E01015607,EV motorcycles,Number,0,1,1,2,3,4,5,6,7,8,9,10,11,12,13,13,14,14,15,15,15,16,16,16,16,16,16,16,16,16
E01015608,EV motorcycles,Number,0,1,2,4,6,7,10,12,14,16,18,21,23,24,26,27,29,30,31,31,32,32,32,33,33,33,33,33,33,33
E01015609,EV motorcycles,Number,0,1,2,4,5,7,9,11,14,16,18,20,22,24,25,27,28,29,30,30,31,31,31,32,32,32,32,32,32,32
E01015610,EV motorcycles,Number,0,1,2,4,5,7,9,11,14,16,18,20,22,24,25,27,28,29,30,30,31,31,31,32,32,32,32,32,32,32
E01015611,EV motorcycles,Number,1,3,5,9,14,18,24,29,35,40,46,51,56,61,65,68,71,74,76,77,79,80,80,81,81,81,82,82,82,82
E01015612,EV motorcycles,Number,0,1,2,3,4,5,7,8,10,11,13,14,16,17,18,19,20,21,21,22,22,22,23,23,23,23,23,23,23,23
E01015613,EV motorcycles,Number,0,1,1,2,3,4,6,7,8,10,11,12,14,15,16,17,17,18,18,19,19,19,20,20,20,20,20,20,20,20
E01015614,EV motorcycles,Number,0,1,2,4,5,7,9,11,14,16,18,20,22,24,25,27,28,29,30,30,31,31,31,32,32,32,32,32,32,32
E01015615,EV motorcycles,Number,0,0,1,1,2,2,3,4,4,5,6,6,7,7,8,8,9,9,9,9,10,10,10,10,10,10,10,10,10,10
E01015616,EV motorcycles,Number,0,1,1,2,3,4,5,6,7,8,9,10,11,12,13,13,14,14,15,15,15,16,16,16,16,16,16,16,16,16
E01015617,EV motorcycles,Number,1,2,4,7,11,15,19,23,27,32,36,40,44,48,51,54,56,58,60,61,62,63,64,64,64,65,65,65,65,65
E01015618,EV motorcycles,Number,0,1,2,3,5,7,9,11,13,15,17,19,21,23,25,26,27,28,29,29,30,30,31,31,31,31,31,31,31,31
E01015619,EV motorcycles,Number,1,1,3,4,7,9,11,14,17,19,22,25,27,29,31,33,34,35,36,37,38,38,39,39,39,39,39,39,39,39
E01015620,EV motorcycles,Number,1,2,3,5,8,11,14,17,21,24,27,31,33,36,39,41,43,44,45,46,47,48,48,48,48,49,49,49,49,49
E01015621,EV motorcycles,Number,1,2,3,6,9,12,15,19,22,26,30,33,36,39,42,44,46,48,49,50,51,51,52,52,52,53,53,53,53,53
E01015622,EV motorcycles,Number,0,1,2,3,5,7,9,11,13,15,17,19,21,22,24,25,26,27,28,28,29,29,29,30,30,30,30,30,30,30
E01015623,EV motorcycles,Number,1,1,2,4,6,8,10,13,15,18,20,22,25,27,28,30,31,32,33,34,35,35,35,35,36,36,36,36,36,36
E01015624,EV motorcycles,Number,0,1,2,3,5,7,8,10,12,14,16,18,20,21,23,24,25,26,27,27,28,28,28,29,29,29,29,29,29,29
E01015627,EV motorcycles,Number,1,2,4,7,11,15,19,23,28,32,36,41,45,48,51,54,57,59,60,62,63,63,64,64,65,65,65,65,65,65
E01015628,EV motorcycles,Number,0,0,0,0,0,0,0,0,0,0,0,0,0,0,0,0,0,0,0,0,0,0,0,0,0,0,0,0,0,0
E01015629,EV motorcycles,Number,1,2,4,7,10,13,17,21,25,29,33,37,40,44,47,49,51,53,55,56,57,57,58,58,58,59,59,59,59,59
E01015630,EV motorcycles,Number,0,1,2,3,5,7,9,11,13,16,18,20,22,23,25,26,28,28,29,30,30,31,31,31,31,31,32,32,32,32
E01015632,EV motorcycles,Number,0,1,1,2,2,3,4,5,6,7,8,9,10,10,11,12,12,13,13,13,13,14,14,14,14,14,14,14,14,14
E01015633,EV motorcycles,Number,0,1,2,4,6,8,10,12,14,17,19,21,23,25,27,28,30,31,31,32,33,33,33,33,34,34,34,34,34,34
E01015634,EV motorcycles,Number,0,1,1,2,3,4,5,6,7,8,10,11,12,13,13,14,15,15,16,16,16,16,17,17,17,17,17,17,17,17
E01015635,EV motorcycles,Number,0,0,0,0,0,0,0,0,0,0,0,0,0,0,0,0,0,0,0,0,0,0,0,0,0,0,0,0,0,0
E01015636,EV motorcycles,Number,0,0,0,0,0,0,1,1,1,1,1,1,1,1,2,2,2,2,2,2,2,2,2,2,2,2,2,2,2,2
E01015637,EV motorcycles,Number,0,1,1,2,3,4,5,6,8,9,10,11,12,13,14,15,16,16,17,17,17,17,18,18,18,18,18,18,18,18
E01015638,EV motorcycles,Number,1,1,2,4,6,8,10,13,15,18,20,22,25,27,28,30,31,32,33,34,35,35,35,35,36,36,36,36,36,36
E01015639,EV motorcycles,Number,0,1,2,3,4,6,8,9,11,13,15,16,18,19,20,22,23,23,24,25,25,25,25,26,26,26,26,26,26,26
E01015640,EV motorcycles,Number,0,1,2,3,4,6,7,9,11,12,14,16,17,18,20,21,22,22,23,24,24,24,24,25,25,25,25,25,25,25
E01015641,EV motorcycles,Number,0,1,1,2,3,4,5,6,7,8,10,11,12,13,13,14,15,15,16,16,16,16,17,17,17,17,17,17,17,17
E01015642,EV motorcycles,Number,0,1,1,2,3,4,5,6,8,9,10,11,12,13,14,15,16,16,17,17,17,17,18,18,18,18,18,18,18,18
E01015643,EV motorcycles,Number,0,1,2,3,4,5,7,9,10,12,13,15,16,18,19,20,21,22,22,23,23,23,23,24,24,24,24,24,24,24
E01015644,EV motorcycles,Number,1,2,3,5,7,10,12,15,18,21,24,27,29,32,34,36,37,39,40,41,41,42,42,42,43,43,43,43,43,43
E01015645,EV motorcycles,Number,0,1,2,3,4,6,7,9,11,12,14,16,17,18,20,21,22,22,23,24,24,24,24,25,25,25,25,25,25,25
E01015646,EV motorcycles,Number,1,2,3,5,8,10,13,16,19,23,26,29,31,34,36,38,40,41,43,43,44,45,45,45,46,46,46,46,46,46
E01015647,EV motorcycles,Number,0,1,1,2,3,4,5,6,8,9,10,11,12,13,14,15,16,16,17,17,17,17,18,18,18,18,18,18,18,18
E01015648,EV motorcycles,Number,1,1,2,4,6,9,11,13,16,19,21,24,26,28,30,32,33,34,35,36,36,37,37,37,38,38,38,38,38,38
E01015650,EV motorcycles,Number,1,2,3,5,8,11,14,17,20,24,27,30,33,35,38,40,42,43,44,45,46,47,47,47,48,48,48,48,48,48
E01015651,EV motorcycles,Number,0,1,2,3,4,6,8,9,11,13,15,16,18,19,20,22,23,23,24,25,25,25,25,26,26,26,26,26,26,26
E01015652,EV motorcycles,Number,0,1,1,2,3,4,5,6,7,8,9,10,11,12,13,13,14,14,15,15,15,16,16,16,16,16,16,16,16,16
E01015653,EV motorcycles,Number,0,1,1,2,3,4,5,7,8,9,11,12,13,14,15,16,17,17,18,18,18,18,19,19,19,19,19,19,19,19
E01015654,EV motorcycles,Number,1,1,3,4,7,9,11,14,16,19,22,24,27,29,31,32,34,35,36,37,37,38,38,38,39,39,39,39,39,39
E01015655,EV motorcycles,Number,0,1,1,2,3,3,4,5,6,7,8,9,10,11,12,12,13,13,14,14,14,15,15,15,15,15,15,15,15,15
E01015656,EV motorcycles,Number,1,1,2,4,6,9,11,13,16,19,21,24,26,28,30,32,33,34,35,36,36,37,37,37,38,38,38,38,38,38
E01015657,EV motorcycles,Number,1,1,3,4,6,9,11,14,16,19,21,24,26,28,30,32,33,34,35,36,37,37,38,38,38,38,38,38,38,38
E01015658,EV motorcycles,Number,0,1,1,2,4,5,6,7,9,10,12,13,14,16,17,17,18,19,19,20,20,20,21,21,21,21,21,21,21,21
E01015659,EV motorcycles,Number,1,2,3,5,7,9,12,15,18,21,24,26,29,31,33,35,36,38,39,40,40,41,41,41,42,42,42,42,42,42
E01015660,EV motorcycles,Number,0,1,2,3,5,7,9,11,13,15,17,19,21,22,24,25,26,27,28,28,29,29,29,30,30,30,30,30,30,30
E01015661,EV motorcycles,Number,0,1,2,3,5,6,8,10,11,13,15,17,18,20,21,22,23,24,25,25,26,26,26,27,27,27,27,27,27,27
E01015662,EV motorcycles,Number,0,1,2,3,4,6,7,9,11,12,14,16,17,18,20,21,22,22,23,24,24,24,24,25,25,25,25,25,25,25
E01015663,EV motorcycles,Number,0,1,1,2,3,4,5,6,7,8,10,11,12,13,13,14,15,15,16,16,16,16,17,17,17,17,17,17,17,17
E01015664,EV motorcycles,Number,0,1,2,3,5,7,8,10,12,14,16,18,20,21,23,24,25,26,27,27,28,28,28,29,29,29,29,29,29,29
E01015665,EV motorcycles,Number,0,1,1,2,4,5,6,8,9,11,12,14,15,16,17,18,19,20,20,21,21,21,22,22,22,22,22,22,22,22
E01015666,EV motorcycles,Number,0,1,2,4,6,7,10,12,14,16,18,21,23,24,26,27,29,30,31,31,32,32,32,33,33,33,33,33,33,33
E01015667,EV motorcycles,Number,0,1,2,3,5,7,9,11,13,15,17,19,21,22,24,25,26,27,28,28,29,29,29,30,30,30,30,30,30,30
E01015668,EV motorcycles,Number,0,1,1,2,3,4,6,7,8,10,11,12,14,15,16,17,17,18,18,19,19,19,20,20,20,20,20,20,20,20
E01015669,EV motorcycles,Number,1,1,3,4,7,9,11,14,16,19,22,24,27,29,31,32,34,35,36,37,37,38,38,38,39,39,39,39,39,39
E01015670,EV motorcycles,Number,0,1,2,3,5,7,8,10,12,14,16,18,20,21,23,24,25,26,27,27,28,28,28,29,29,29,29,29,29,29
E01015671,EV motorcycles,Number,2,4,7,12,18,24,32,39,46,54,61,68,75,81,86,91,95,98,101,103,105,106,107,107,108,108,109,109,109,109
E01015672,EV motorcycles,Number,1,1,2,4,6,9,11,13,16,19,21,24,26,28,30,32,33,34,35,36,36,37,37,37,38,38,38,38,38,38
E01015673,EV motorcycles,Number,0,1,2,3,5,7,8,10,12,14,16,18,20,21,23,24,25,26,27,27,28,28,28,29,29,29,29,29,29,29
E01015674,EV motorcycles,Number,1,1,2,4,6,8,11,13,16,18,21,23,25,27,29,31,32,33,34,35,35,36,36,36,37,37,37,37,37,37
E01015675,EV motorcycles,Number,0,1,2,3,5,7,9,11,13,15,17,19,21,22,24,25,26,27,28,28,29,29,29,30,30,30,30,30,30,30
E01015676,EV motorcycles,Number,1,3,6,10,15,20,26,32,38,44,50,56,62,67,71,75,78,81,83,85,86,87,88,89,89,89,90,90,90,90
E01015677,EV motorcycles,Number,0,1,2,3,4,5,7,9,10,12,13,15,16,18,19,20,21,22,22,23,23,23,23,24,24,24,24,24,24,24
E01015678,EV motorcycles,Number,0,1,2,3,4,5,7,9,10,12,13,15,16,18,19,20,21,22,22,23,23,23,23,24,24,24,24,24,24,24
E01015679,EV motorcycles,Number,1,1,3,4,7,9,12,14,17,20,22,25,27,30,32,33,35,36,37,38,38,39,39,39,40,40,40,40,40,40
E01015680,EV motorcycles,Number,0,1,1,2,3,4,5,7,8,9,11,12,13,14,15,16,17,17,18,18,18,18,19,19,19,19,19,19,19,19
E01015681,EV motorcycles,Number,0,1,1,2,4,5,7,8,10,11,13,14,15,17,18,19,20,20,21,21,22,22,22,22,22,23,23,23,23,23
E01015682,EV motorcycles,Number,1,1,2,4,6,8,10,12,15,17,20,22,24,26,28,29,30,31,32,33,34,34,34,34,35,35,35,35,35,35
E01015683,EV motorcycles,Number,1,1,3,4,7,9,12,14,17,20,22,25,27,30,32,33,35,36,37,38,38,39,39,39,40,40,40,40,40,40
E01015684,EV motorcycles,Number,0,1,2,3,5,7,9,11,13,15,17,19,21,22,24,25,26,27,28,28,29,29,29,30,30,30,30,30,30,30
E01015685,EV motorcycles,Number,0,1,2,3,4,5,7,8,10,11,13,14,16,17,18,19,20,21,21,22,22,22,23,23,23,23,23,23,23,23
E01015686,EV motorcycles,Number,1,1,2,4,6,8,10,13,15,18,20,22,25,27,28,30,31,32,33,34,35,35,35,35,36,36,36,36,36,36
E01015687,EV motorcycles,Number,0,1,1,2,3,4,5,6,8,9,10,11,12,13,14,15,16,16,17,17,17,17,18,18,18,18,18,18,18,18
E01015688,EV motorcycles,Number,0,1,2,3,5,7,8,10,12,14,16,18,20,21,23,24,25,26,27,27,28,28,28,29,29,29,29,29,29,29
E01015689,EV motorcycles,Number,0,1,2,3,5,6,8,10,11,13,15,17,18,20,21,22,23,24,25,25,26,26,26,27,27,27,27,27,27,27
E01015690,EV motorcycles,Number,0,1,2,3,5,7,9,11,13,15,17,19,21,23,24,26,27,28,29,29,30,30,30,31,31,31,31,31,31,31
E01015691,EV motorcycles,Number,0,0,1,1,2,3,4,5,5,6,7,8,9,10,10,11,11,12,12,12,12,13,13,13,13,13,13,13,13,13
E01015692,EV motorcycles,Number,0,0,1,1,2,2,3,3,4,4,5,6,6,7,7,7,8,8,8,8,9,9,9,9,9,9,9,9,9,9
E01015693,EV motorcycles,Number,0,1,1,2,3,4,5,6,7,8,9,10,11,12,13,13,14,14,15,15,15,16,16,16,16,16,16,16,16,16
E01015694,EV motorcycles,Number,0,0,1,1,2,2,3,3,4,4,5,6,6,7,7,7,8,8,8,8,9,9,9,9,9,9,9,9,9,9
E01015695,EV motorcycles,Number,0,1,1,2,3,4,5,6,7,8,9,10,11,12,13,13,14,14,15,15,15,16,16,16,16,16,16,16,16,16
E01015696,EV motorcycles,Number,0,0,1,1,2,3,4,5,5,6,7,8,9,10,10,11,11,12,12,12,12,13,13,13,13,13,13,13,13,13
E01015697,EV motorcycles,Number,0,1,1,2,4,5,6,7,9,10,12,13,14,16,17,17,18,19,19,20,20,20,21,21,21,21,21,21,21,21
E01015698,EV motorcycles,Number,0,0,0,1,1,1,2,2,3,3,3,4,4,4,5,5,5,5,6,6,6,6,6,6,6,6,6,6,6,6
E01015699,EV motorcycles,Number,0,0,1,1,1,2,2,3,3,4,4,5,5,6,6,7,7,7,7,8,8,8,8,8,8,8,8,8,8,8
E01015700,EV motorcycles,Number,0,0,0,1,1,1,1,2,2,2,3,3,3,4,4,4,4,4,5,5,5,5,5,5,5,5,5,5,5,5
E01015701,EV motorcycles,Number,0,0,0,0,0,0,0,0,0,0,0,0,0,0,0,0,0,0,0,0,0,0,0,0,0,0,0,0,0,0
E01015702,EV motorcycles,Number,0,0,1,1,1,2,2,3,3,4,4,5,5,6,6,7,7,7,7,8,8,8,8,8,8,8,8,8,8,8
E01015703,EV motorcycles,Number,0,0,0,1,1,1,2,2,3,3,3,4,4,4,5,5,5,5,6,6,6,6,6,6,6,6,6,6,6,6
E01015704,EV motorcycles,Number,0,0,0,0,0,0,0,0,0,0,0,0,0,0,0,0,0,0,0,0,0,0,0,0,0,0,0,0,0,0
E01015705,EV motorcycles,Number,0,0,0,1,1,2,2,2,3,3,4,4,5,5,6,6,6,6,6,7,7,7,7,7,7,7,7,7,7,7
E01015706,EV motorcycles,Number,0,1,2,4,5,7,9,11,14,16,18,20,22,24,25,27,28,29,30,30,31,31,31,32,32,32,32,32,32,32
E01015707,EV motorcycles,Number,0,1,2,3,4,6,8,9,11,13,15,16,18,19,20,22,23,23,24,25,25,25,25,26,26,26,26,26,26,26
E01015708,EV motorcycles,Number,0,1,1,2,3,3,4,5,6,7,8,9,10,11,12,12,13,13,14,14,14,15,15,15,15,15,15,15,15,15
E01015709,EV motorcycles,Number,0,1,2,3,4,5,7,8,10,11,13,14,16,17,18,19,20,21,21,22,22,22,23,23,23,23,23,23,23,23
E01015710,EV motorcycles,Number,0,1,2,3,5,7,9,11,13,15,17,19,21,23,24,26,27,28,29,29,30,30,30,31,31,31,31,31,31,31
E01015711,EV motorcycles,Number,0,0,0,0,0,0,0,0,0,0,0,0,0,0,0,0,0,0,0,0,0,0,0,0,0,0,0,0,0,0
E01015712,EV motorcycles,Number,0,1,1,2,3,4,5,6,7,8,10,11,12,13,13,14,15,15,16,16,16,16,17,17,17,17,17,17,17,17
E01015713,EV motorcycles,Number,0,0,1,1,2,2,3,4,5,5,6,7,8,8,9,9,10,10,10,10,11,11,11,11,11,11,11,11,11,11
E01015714,EV motorcycles,Number,0,1,1,2,3,4,5,6,7,8,10,11,12,13,13,14,15,15,16,16,16,16,17,17,17,17,17,17,17,17
E01015715,EV motorcycles,Number,0,0,0,0,0,0,0,0,0,0,0,0,0,0,0,0,0,0,0,0,0,0,0,0,0,0,0,0,0,0
E01015716,EV motorcycles,Number,0,0,1,1,1,2,2,3,3,4,4,5,5,6,6,7,7,7,7,8,8,8,8,8,8,8,8,8,8,8
E01015717,EV motorcycles,Number,0,0,1,1,2,2,3,4,5,5,6,7,8,8,9,9,10,10,10,10,11,11,11,11,11,11,11,11,11,11
E01015718,EV motorcycles,Number,0,0,1,1,1,2,2,3,3,4,4,5,5,6,6,7,7,7,7,8,8,8,8,8,8,8,8,8,8,8
E01015719,EV motorcycles,Number,1,1,2,4,6,8,11,13,16,18,21,23,25,27,29,31,32,33,34,35,35,36,36,36,37,37,37,37,37,37
E01015720,EV motorcycles,Number,0,1,1,2,3,4,5,7,8,9,11,12,13,14,15,16,17,17,18,18,18,18,19,19,19,19,19,19,19,19
E01015721,EV motorcycles,Number,0,1,2,3,4,6,7,9,11,12,14,16,17,18,20,21,22,22,23,24,24,24,24,25,25,25,25,25,25,25
E01015722,EV motorcycles,Number,0,1,1,2,3,4,5,6,8,9,10,11,12,13,14,15,16,16,17,17,17,17,18,18,18,18,18,18,18,18
E01015723,EV motorcycles,Number,0,1,1,2,3,4,5,6,8,9,10,11,12,13,14,15,16,16,17,17,17,17,18,18,18,18,18,18,18,18
E01015724,EV motorcycles,Number,0,0,1,1,1,2,2,3,3,4,4,5,5,6,6,7,7,7,7,8,8,8,8,8,8,8,8,8,8,8
E01015725,EV motorcycles,Number,0,0,1,1,2,2,3,4,5,5,6,7,8,8,9,9,10,10,10,10,11,11,11,11,11,11,11,11,11,11
E01015726,EV motorcycles,Number,0,0,1,1,1,2,2,3,3,4,4,5,5,6,6,7,7,7,7,8,8,8,8,8,8,8,8,8,8,8
E01015727,EV motorcycles,Number,0,0,0,1,1,2,2,2,3,3,4,4,5,5,6,6,6,6,6,7,7,7,7,7,7,7,7,7,7,7
E01015728,EV motorcycles,Number,0,0,0,1,1,2,2,2,3,3,4,4,5,5,6,6,6,6,6,7,7,7,7,7,7,7,7,7,7,7
E01015729,EV motorcycles,Number,0,0,1,1,2,2,3,4,5,5,6,7,8,8,9,9,10,10,10,10,11,11,11,11,11,11,11,11,11,11
E01015730,EV motorcycles,Number,0,0,0,1,1,1,2,2,3,3,3,4,4,4,5,5,5,5,6,6,6,6,6,6,6,6,6,6,6,6
E01015731,EV motorcycles,Number,0,0,0,0,0,0,0,0,0,0,0,0,0,0,0,0,0,0,0,0,0,0,0,0,0,0,0,0,0,0
E01015732,EV motorcycles,Number,0,1,1,2,3,4,5,6,7,8,10,11,12,13,13,14,15,15,16,16,16,16,17,17,17,17,17,17,17,17
E01015733,EV motorcycles,Number,0,1,1,2,3,4,5,6,7,8,9,10,11,12,13,13,14,14,15,15,15,16,16,16,16,16,16,16,16,16
E01015734,EV motorcycles,Number,0,1,2,3,4,5,7,8,10,11,13,14,16,17,18,19,20,21,21,22,22,22,23,23,23,23,23,23,23,23
E01015735,EV motorcycles,Number,0,1,1,2,2,3,4,5,6,7,8,9,10,10,11,12,12,13,13,13,13,14,14,14,14,14,14,14,14,14
E01015736,EV motorcycles,Number,0,0,1,1,2,2,3,4,5,5,6,7,8,8,9,9,10,10,10,10,11,11,11,11,11,11,11,11,11,11
E01015737,EV motorcycles,Number,0,1,1,2,2,3,4,5,6,7,8,9,10,10,11,12,12,13,13,13,13,14,14,14,14,14,14,14,14,14
E01015738,EV motorcycles,Number,0,1,1,2,3,4,5,6,7,8,9,10,11,12,13,13,14,14,15,15,15,16,16,16,16,16,16,16,16,16
E01015739,EV motorcycles,Number,0,1,1,2,3,3,4,5,6,7,8,9,10,11,12,12,13,13,14,14,14,15,15,15,15,15,15,15,15,15
E01015740,EV motorcycles,Number,0,1,1,2,3,4,5,6,7,8,10,11,12,13,13,14,15,15,16,16,16,16,17,17,17,17,17,17,17,17
E01015741,EV motorcycles,Number,0,1,1,2,3,4,5,6,7,8,9,10,11,12,13,13,14,14,15,15,15,16,16,16,16,16,16,16,16,16
E01015742,EV motorcycles,Number,0,0,1,1,2,2,3,4,4,5,6,6,7,7,8,8,9,9,9,9,10,10,10,10,10,10,10,10,10,10
E01015743,EV motorcycles,Number,0,1,2,3,4,5,7,8,10,11,13,14,16,17,18,19,20,21,21,22,22,22,23,23,23,23,23,23,23,23
E01015744,EV motorcycles,Number,0,0,1,1,2,3,4,5,5,6,7,8,9,10,10,11,11,12,12,12,12,13,13,13,13,13,13,13,13,13
E01015745,EV motorcycles,Number,0,1,1,2,3,4,6,7,8,10,11,12,14,15,16,17,17,18,18,19,19,19,20,20,20,20,20,20,20,20
E01015746,EV motorcycles,Number,0,1,1,2,2,3,4,5,6,7,8,9,10,10,11,12,12,13,13,13,13,14,14,14,14,14,14,14,14,14
E01015747,EV motorcycles,Number,0,1,2,3,4,6,8,9,11,13,15,16,18,19,20,22,23,23,24,25,25,25,25,26,26,26,26,26,26,26
E01015748,EV motorcycles,Number,0,1,2,3,4,5,7,8,10,11,13,14,16,17,18,19,20,21,21,22,22,22,23,23,23,23,23,23,23,23
E01015749,EV motorcycles,Number,0,0,1,1,2,2,3,4,5,5,6,7,8,8,9,9,10,10,10,10,11,11,11,11,11,11,11,11,11,11
E01015750,EV motorcycles,Number,0,0,1,1,2,2,3,4,4,5,6,6,7,7,8,8,9,9,9,9,10,10,10,10,10,10,10,10,10,10
E01015751,EV motorcycles,Number,0,0,1,1,2,3,4,5,5,6,7,8,9,10,10,11,11,12,12,12,12,13,13,13,13,13,13,13,13,13
E01015752,EV motorcycles,Number,0,0,1,1,2,2,3,4,4,5,6,6,7,7,8,8,9,9,9,9,10,10,10,10,10,10,10,10,10,10
E01015753,EV motorcycles,Number,0,1,2,3,5,7,8,10,12,14,16,18,20,21,23,24,25,26,27,27,28,28,28,29,29,29,29,29,29,29
E01015754,EV motorcycles,Number,0,0,1,1,2,2,3,4,5,5,6,7,8,8,9,9,10,10,10,10,11,11,11,11,11,11,11,11,11,11
E01015755,EV motorcycles,Number,0,0,1,1,2,3,4,5,5,6,7,8,9,10,10,11,11,12,12,12,12,13,13,13,13,13,13,13,13,13
E01015756,EV motorcycles,Number,0,1,2,3,5,6,8,10,12,14,16,17,19,21,22,23,24,25,26,26,27,27,27,28,28,28,28,28,28,28
E01015757,EV motorcycles,Number,0,0,1,1,1,2,2,3,3,4,4,5,5,6,6,7,7,7,7,8,8,8,8,8,8,8,8,8,8,8
E01015758,EV motorcycles,Number,0,0,1,1,2,2,3,4,5,5,6,7,8,8,9,9,10,10,10,10,11,11,11,11,11,11,11,11,11,11
E01015759,EV motorcycles,Number,0,1,1,2,3,4,6,7,8,10,11,12,14,15,16,17,17,18,18,19,19,19,20,20,20,20,20,20,20,20
E01015760,EV motorcycles,Number,0,1,1,2,2,3,4,5,6,7,8,9,10,10,11,12,12,13,13,13,13,14,14,14,14,14,14,14,14,14
E01015761,EV motorcycles,Number,0,1,1,2,3,4,6,7,8,10,11,12,14,15,16,17,17,18,18,19,19,19,20,20,20,20,20,20,20,20
E01015762,EV motorcycles,Number,0,1,1,2,4,5,6,7,9,10,12,13,14,16,17,17,18,19,19,20,20,20,21,21,21,21,21,21,21,21
E01015763,EV motorcycles,Number,0,1,1,2,2,3,4,5,6,7,8,9,10,10,11,12,12,13,13,13,13,14,14,14,14,14,14,14,14,14
E01015764,EV motorcycles,Number,0,0,1,1,2,3,3,4,5,6,7,7,8,9,9,10,10,11,11,11,12,12,12,12,12,12,12,12,12,12
E01015765,EV motorcycles,Number,0,1,1,2,3,4,5,6,7,8,9,10,11,12,13,13,14,14,15,15,15,16,16,16,16,16,16,16,16,16
E01015766,EV motorcycles,Number,0,0,1,1,2,2,3,4,5,5,6,7,8,8,9,9,10,10,10,10,11,11,11,11,11,11,11,11,11,11
E01015767,EV motorcycles,Number,0,0,1,1,2,3,3,4,5,6,7,7,8,9,9,10,10,11,11,11,12,12,12,12,12,12,12,12,12,12
E01015768,EV motorcycles,Number,0,1,1,2,3,4,5,6,8,9,10,11,12,13,14,15,16,16,17,17,17,17,18,18,18,18,18,18,18,18
E01015769,EV motorcycles,Number,0,1,2,3,4,6,8,9,11,13,15,16,18,19,20,22,23,23,24,25,25,25,25,26,26,26,26,26,26,26
E01015770,EV motorcycles,Number,0,1,2,3,5,7,8,10,12,14,16,18,20,21,23,24,25,26,27,27,28,28,28,29,29,29,29,29,29,29
E01015771,EV motorcycles,Number,0,0,1,1,2,3,4,5,5,6,7,8,9,10,10,11,11,12,12,12,12,13,13,13,13,13,13,13,13,13
E01015772,EV motorcycles,Number,0,0,0,1,1,1,2,2,3,3,3,4,4,4,5,5,5,5,6,6,6,6,6,6,6,6,6,6,6,6
E01015773,EV motorcycles,Number,0,0,1,1,2,2,3,4,4,5,6,6,7,7,8,8,9,9,9,9,10,10,10,10,10,10,10,10,10,10
E01015774,EV motorcycles,Number,0,1,2,3,4,5,7,8,10,11,13,14,16,17,18,19,20,21,21,22,22,22,23,23,23,23,23,23,23,23
E01015775,EV motorcycles,Number,0,1,2,3,5,7,8,10,12,14,16,18,20,21,23,24,25,26,27,27,28,28,28,29,29,29,29,29,29,29
E01015776,EV motorcycles,Number,1,1,2,4,6,8,10,12,15,17,20,22,24,26,28,29,30,31,32,33,34,34,34,34,35,35,35,35,35,35
E01015777,EV motorcycles,Number,0,1,2,3,4,5,7,9,10,12,13,15,16,18,19,20,21,22,22,23,23,23,23,24,24,24,24,24,24,24
E01015778,EV motorcycles,Number,0,1,1,2,3,4,5,7,8,9,11,12,13,14,15,16,17,17,18,18,18,18,19,19,19,19,19,19,19,19
E01015779,EV motorcycles,Number,0,1,1,2,3,4,5,7,8,9,11,12,13,14,15,16,17,17,18,18,18,18,19,19,19,19,19,19,19,19
E01015780,EV motorcycles,Number,0,1,1,2,3,4,5,6,7,8,9,10,11,12,13,13,14,14,15,15,15,16,16,16,16,16,16,16,16,16
E01015781,EV motorcycles,Number,0,1,1,2,3,4,5,6,7,8,9,10,11,12,13,13,14,14,15,15,15,16,16,16,16,16,16,16,16,16
E01015782,EV motorcycles,Number,0,1,2,3,5,7,9,11,13,15,17,19,21,23,24,26,27,28,29,29,30,30,30,31,31,31,31,31,31,31
E01015783,EV motorcycles,Number,0,0,0,1,1,2,2,2,3,3,4,4,5,5,6,6,6,6,6,7,7,7,7,7,7,7,7,7,7,7
E01015784,EV motorcycles,Number,0,0,1,1,2,2,3,4,4,5,6,6,7,7,8,8,9,9,9,9,10,10,10,10,10,10,10,10,10,10
E01015785,EV motorcycles,Number,0,1,1,2,3,4,6,7,8,10,11,12,14,15,16,17,17,18,18,19,19,19,20,20,20,20,20,20,20,20
E01015786,EV motorcycles,Number,0,0,0,1,1,1,2,2,3,3,3,4,4,4,5,5,5,5,6,6,6,6,6,6,6,6,6,6,6,6
E01015787,EV motorcycles,Number,0,1,1,2,3,4,5,6,7,8,10,11,12,13,13,14,15,15,16,16,16,16,17,17,17,17,17,17,17,17
E01015788,EV motorcycles,Number,0,0,0,0,0,0,0,0,0,0,0,0,0,0,0,0,0,0,0,0,0,0,0,0,0,0,0,0,0,0
E01015789,EV motorcycles,Number,0,0,0,0,0,0,0,0,0,0,0,0,0,0,0,0,0,0,0,0,0,0,0,0,0,0,0,0,0,0
E01015790,EV motorcycles,Number,0,1,1,2,3,4,5,6,7,8,9,10,11,12,13,13,14,14,15,15,15,16,16,16,16,16,16,16,16,16
E01015791,EV motorcycles,Number,0,0,1,1,2,2,3,4,5,5,6,7,8,8,9,9,10,10,10,10,11,11,11,11,11,11,11,11,11,11
E01015792,EV motorcycles,Number,0,0,1,1,2,3,3,4,5,6,7,7,8,9,9,10,10,11,11,11,12,12,12,12,12,12,12,12,12,12
E01015793,EV motorcycles,Number,0,1,1,2,3,4,6,7,8,10,11,12,14,15,16,17,17,18,18,19,19,19,20,20,20,20,20,20,20,20
E01015794,EV motorcycles,Number,0,1,2,3,4,6,7,9,11,12,14,16,17,18,20,21,22,22,23,24,24,24,24,25,25,25,25,25,25,25
E01015795,EV motorcycles,Number,0,0,1,1,1,2,2,3,3,4,4,5,5,6,6,7,7,7,7,8,8,8,8,8,8,8,8,8,8,8
E01015796,EV motorcycles,Number,0,0,1,1,2,3,3,4,5,6,7,7,8,9,9,10,10,11,11,11,12,12,12,12,12,12,12,12,12,12
E01015797,EV motorcycles,Number,1,1,2,4,6,8,10,13,15,18,20,22,25,27,28,30,31,32,33,34,35,35,35,35,36,36,36,36,36,36
E01015798,EV motorcycles,Number,0,1,1,2,4,5,6,8,9,11,12,14,15,16,17,18,19,20,20,21,21,21,22,22,22,22,22,22,22,22
E01015799,EV motorcycles,Number,0,1,2,3,5,7,8,10,12,14,16,18,20,21,23,24,25,26,27,27,28,28,28,29,29,29,29,29,29,29
E01015800,EV motorcycles,Number,0,1,2,3,5,7,9,11,13,15,17,19,21,22,24,25,26,27,28,28,29,29,29,30,30,30,30,30,30,30
E01015801,EV motorcycles,Number,0,1,2,3,4,6,8,9,11,13,15,16,18,19,20,22,23,23,24,25,25,25,25,26,26,26,26,26,26,26
E01015802,EV motorcycles,Number,0,0,1,1,2,3,3,4,5,6,7,7,8,9,9,10,10,11,11,11,12,12,12,12,12,12,12,12,12,12
E01015803,EV motorcycles,Number,0,1,2,4,6,7,10,12,14,16,18,21,23,24,26,27,29,30,31,31,32,32,32,33,33,33,33,33,33,33
E01015804,EV motorcycles,Number,1,2,3,5,7,9,12,15,18,21,24,26,29,31,33,35,36,38,39,40,40,41,41,41,42,42,42,42,42,42
E01015805,EV motorcycles,Number,0,1,2,3,4,5,7,9,10,12,13,15,16,18,19,20,21,22,22,23,23,23,23,24,24,24,24,24,24,24
E01015806,EV motorcycles,Number,0,1,2,3,4,5,7,8,10,11,13,14,16,17,18,19,20,21,21,22,22,22,23,23,23,23,23,23,23,23
E01015807,EV motorcycles,Number,0,1,2,3,4,6,8,9,11,13,15,16,18,19,20,22,23,23,24,25,25,25,25,26,26,26,26,26,26,26
E01015808,EV motorcycles,Number,0,1,2,3,5,6,8,10,12,14,16,17,19,21,22,23,24,25,26,26,27,27,27,28,28,28,28,28,28,28
E01015809,EV motorcycles,Number,0,1,2,3,4,6,8,9,11,13,15,16,18,19,20,22,23,23,24,25,25,25,25,26,26,26,26,26,26,26
E01015810,EV motorcycles,Number,0,1,1,2,3,4,5,6,7,8,9,10,11,12,13,13,14,14,15,15,15,16,16,16,16,16,16,16,16,16
E01015811,EV motorcycles,Number,0,1,2,3,4,5,7,9,10,12,13,15,16,18,19,20,21,22,22,23,23,23,23,24,24,24,24,24,24,24
E01015812,EV motorcycles,Number,0,1,2,3,5,7,9,11,13,15,17,19,21,22,24,25,26,27,28,28,29,29,29,30,30,30,30,30,30,30
E01015813,EV motorcycles,Number,0,1,1,2,2,3,4,5,6,7,8,9,10,10,11,12,12,13,13,13,13,14,14,14,14,14,14,14,14,14
E01015814,EV motorcycles,Number,0,1,2,4,6,8,10,12,14,17,19,21,23,25,27,28,30,31,31,32,33,33,33,33,34,34,34,34,34,34
E01015815,EV motorcycles,Number,0,1,2,4,6,8,10,12,14,17,19,21,23,25,27,28,30,31,31,32,33,33,33,33,34,34,34,34,34,34
E01015816,EV motorcycles,Number,1,2,3,5,8,10,13,16,19,22,25,28,31,33,35,37,39,40,42,42,43,44,44,44,45,45,45,45,45,45
E01015817,EV motorcycles,Number,0,1,2,4,5,7,9,11,14,16,18,20,22,24,25,27,28,29,30,30,31,31,31,32,32,32,32,32,32,32
E01015818,EV motorcycles,Number,1,1,2,4,6,8,10,12,15,17,20,22,24,26,28,29,30,31,32,33,34,34,34,34,35,35,35,35,35,35
E01015819,EV motorcycles,Number,0,1,2,3,5,7,9,11,13,15,17,19,21,22,24,25,26,27,28,28,29,29,29,30,30,30,30,30,30,30
E01015820,EV motorcycles,Number,0,1,2,4,5,7,9,11,14,16,18,20,22,24,25,27,28,29,30,30,31,31,31,32,32,32,32,32,32,32
E01015821,EV motorcycles,Number,1,2,3,5,8,10,13,16,19,22,25,28,31,33,35,37,39,40,42,42,43,44,44,44,45,45,45,45,45,45
E01015822,EV motorcycles,Number,0,1,2,3,4,6,7,9,11,12,14,16,17,18,20,21,22,22,23,24,24,24,24,25,25,25,25,25,25,25
E01015823,EV motorcycles,Number,0,1,2,3,5,7,9,11,13,15,17,19,21,23,24,26,27,28,29,29,30,30,30,31,31,31,31,31,31,31
E01015824,EV motorcycles,Number,0,1,2,3,5,6,8,10,12,14,16,17,19,21,22,23,24,25,26,26,27,27,27,28,28,28,28,28,28,28
E01015825,EV motorcycles,Number,1,1,2,4,6,9,11,13,16,19,21,24,26,28,30,32,33,34,35,36,36,37,37,37,38,38,38,38,38,38
E01015826,EV motorcycles,Number,0,1,2,3,5,7,9,11,13,15,17,19,21,22,24,25,26,27,28,28,29,29,29,30,30,30,30,30,30,30
E01015827,EV motorcycles,Number,0,1,2,3,4,6,8,9,11,13,15,16,18,19,20,22,23,23,24,25,25,25,25,26,26,26,26,26,26,26
E01015828,EV motorcycles,Number,0,1,2,3,4,5,7,8,10,11,13,14,16,17,18,19,20,21,21,22,22,22,23,23,23,23,23,23,23,23
E01015829,EV motorcycles,Number,0,1,2,3,5,6,8,10,12,14,16,17,19,21,22,23,24,25,26,26,27,27,27,28,28,28,28,28,28,28
E01015830,EV motorcycles,Number,0,1,2,3,4,5,7,9,10,12,13,15,16,18,19,20,21,22,22,23,23,23,23,24,24,24,24,24,24,24
E01015831,EV motorcycles,Number,0,1,1,2,4,5,6,8,9,11,12,14,15,16,17,18,19,20,20,21,21,21,22,22,22,22,22,22,22,22
E01015832,EV motorcycles,Number,0,1,1,2,4,5,6,7,9,10,12,13,14,16,17,17,18,19,19,20,20,20,21,21,21,21,21,21,21,21
E01015833,EV motorcycles,Number,1,1,2,4,6,8,11,13,16,18,21,23,25,27,29,31,32,33,34,35,35,36,36,36,37,37,37,37,37,37
E01015834,EV motorcycles,Number,1,1,2,4,6,8,10,12,15,17,20,22,24,26,28,29,30,31,32,33,34,34,34,34,35,35,35,35,35,35
E01015835,EV motorcycles,Number,0,1,2,4,6,8,10,12,14,17,19,21,23,25,27,28,30,31,31,32,33,33,33,33,34,34,34,34,34,34
E01015836,EV motorcycles,Number,0,1,2,3,4,5,7,9,10,12,13,15,16,18,19,20,21,22,22,23,23,23,23,24,24,24,24,24,24,24
E01015837,EV motorcycles,Number,1,2,4,7,10,13,17,21,25,30,34,37,41,44,47,50,52,54,55,57,58,58,59,59,59,60,60,60,60,60
E01015838,EV motorcycles,Number,0,1,1,2,4,5,6,8,9,11,12,14,15,16,17,18,19,20,20,21,21,21,22,22,22,22,22,22,22,22
E01015839,EV motorcycles,Number,0,1,2,3,4,6,8,9,11,13,15,16,18,19,20,22,23,23,24,25,25,25,25,26,26,26,26,26,26,26
E01015840,EV motorcycles,Number,1,1,2,4,6,8,11,13,16,18,21,23,25,27,29,31,32,33,34,35,35,36,36,36,37,37,37,37,37,37
E01015841,EV motorcycles,Number,0,1,2,4,5,7,9,11,14,16,18,20,22,24,25,27,28,29,30,30,31,31,31,32,32,32,32,32,32,32
E01015842,EV motorcycles,Number,0,1,1,2,3,3,4,5,6,7,8,9,10,11,12,12,13,13,14,14,14,15,15,15,15,15,15,15,15,15
E01015843,EV motorcycles,Number,1,1,2,4,6,8,11,13,16,18,21,23,25,27,29,31,32,33,34,35,35,36,36,36,37,37,37,37,37,37
E01015844,EV motorcycles,Number,1,2,3,5,7,10,13,16,19,22,25,27,30,33,35,37,38,40,41,42,42,43,43,43,44,44,44,44,44,44
E01015845,EV motorcycles,Number,0,1,2,3,4,6,7,9,11,12,14,16,17,18,20,21,22,22,23,24,24,24,24,25,25,25,25,25,25,25
E01015846,EV motorcycles,Number,0,1,2,3,4,6,7,9,11,12,14,16,17,18,20,21,22,22,23,24,24,24,24,25,25,25,25,25,25,25
E01015847,EV motorcycles,Number,0,1,1,2,4,5,6,8,9,11,12,14,15,16,17,18,19,20,20,21,21,21,22,22,22,22,22,22,22,22
E01015848,EV motorcycles,Number,1,1,3,4,7,9,11,14,16,19,22,24,27,29,31,32,34,35,36,37,37,38,38,38,39,39,39,39,39,39
E01015849,EV motorcycles,Number,0,1,1,2,3,3,4,5,6,7,8,9,10,11,12,12,13,13,14,14,14,15,15,15,15,15,15,15,15,15
E01015850,EV motorcycles,Number,0,1,2,4,6,7,10,12,14,16,18,21,23,24,26,27,29,30,31,31,32,32,32,33,33,33,33,33,33,33
E01015851,EV motorcycles,Number,0,1,1,2,3,3,4,5,6,7,8,9,10,11,12,12,13,13,14,14,14,15,15,15,15,15,15,15,15,15
E01015852,EV motorcycles,Number,0,1,2,3,5,7,9,11,13,15,17,19,21,23,24,26,27,28,29,29,30,30,30,31,31,31,31,31,31,31
E01015853,EV motorcycles,Number,0,1,1,2,4,5,6,8,9,11,12,14,15,16,17,18,19,20,20,21,21,21,22,22,22,22,22,22,22,22
E01015854,EV motorcycles,Number,0,1,2,3,4,5,7,8,10,11,13,14,16,17,18,19,20,21,21,22,22,22,23,23,23,23,23,23,23,23
E01015855,EV motorcycles,Number,0,1,2,3,5,7,8,10,12,14,16,18,20,21,23,24,25,26,27,27,28,28,28,29,29,29,29,29,29,29
E01015856,EV motorcycles,Number,0,1,2,3,4,6,7,9,11,12,14,16,17,18,20,21,22,22,23,24,24,24,24,25,25,25,25,25,25,25
E01015857,EV motorcycles,Number,1,2,3,6,9,12,15,19,22,26,30,33,36,39,42,44,46,48,49,50,51,51,52,52,52,53,53,53,53,53
E01015858,EV motorcycles,Number,1,2,3,6,8,11,14,18,21,25,28,31,34,37,39,42,43,45,46,47,48,49,49,49,49,50,50,50,50,50
E01015859,EV motorcycles,Number,1,2,3,5,8,11,14,17,20,24,27,30,33,35,38,40,42,43,44,45,46,47,47,47,48,48,48,48,48,48
E01015860,EV motorcycles,Number,1,2,3,5,7,9,12,15,18,21,24,26,29,31,33,35,36,38,39,40,40,41,41,41,42,42,42,42,42,42
E01015861,EV motorcycles,Number,0,1,2,4,6,8,10,12,14,17,19,21,23,25,27,28,30,31,31,32,33,33,33,33,34,34,34,34,34,34
E01015862,EV motorcycles,Number,0,1,1,2,3,4,5,6,7,8,10,11,12,13,13,14,15,15,16,16,16,16,17,17,17,17,17,17,17,17
E01015863,EV motorcycles,Number,0,1,2,4,6,8,10,12,14,17,19,21,23,25,27,28,30,31,31,32,33,33,33,33,34,34,34,34,34,34
E01015864,EV motorcycles,Number,1,2,3,5,7,10,13,16,19,22,25,27,30,33,35,37,38,40,41,42,42,43,43,43,44,44,44,44,44,44
E01015865,EV motorcycles,Number,1,2,3,6,9,12,15,19,22,26,30,33,36,39,42,44,46,48,49,50,51,51,52,52,52,53,53,53,53,53
E01015866,EV motorcycles,Number,1,2,3,6,9,11,15,18,22,25,29,32,35,38,40,42,44,46,47,48,49,49,50,50,50,51,51,51,51,51
E01015867,EV motorcycles,Number,0,1,2,3,5,6,8,10,12,14,16,17,19,21,22,23,24,25,26,26,27,27,27,28,28,28,28,28,28,28
E01015868,EV motorcycles,Number,1,2,3,5,8,11,14,17,21,24,27,31,33,36,39,41,43,44,45,46,47,48,48,48,48,49,49,49,49,49
E01015869,EV motorcycles,Number,1,1,3,4,7,9,11,14,16,19,22,24,27,29,31,32,34,35,36,37,37,38,38,38,39,39,39,39,39,39
E01015870,EV motorcycles,Number,1,2,3,5,7,10,12,15,18,21,24,27,29,32,34,36,37,39,40,41,41,42,42,42,43,43,43,43,43,43
E01015871,EV motorcycles,Number,1,1,3,4,7,9,11,14,16,19,22,24,27,29,31,32,34,35,36,37,37,38,38,38,39,39,39,39,39,39
E01015872,EV motorcycles,Number,0,1,2,4,6,7,10,12,14,16,18,21,23,24,26,27,29,30,31,31,32,32,32,33,33,33,33,33,33,33
E01015873,EV motorcycles,Number,0,0,1,1,2,3,4,5,5,6,7,8,9,10,10,11,11,12,12,12,12,13,13,13,13,13,13,13,13,13
E01015874,EV motorcycles,Number,1,2,4,7,11,15,19,24,28,33,37,42,46,50,53,56,58,60,62,63,64,65,66,66,66,67,67,67,67,67
E01015875,EV motorcycles,Number,1,2,3,5,8,11,14,17,20,23,26,29,32,35,37,39,41,42,43,44,45,46,46,46,47,47,47,47,47,47
E01015876,EV motorcycles,Number,1,2,3,6,9,11,15,18,22,25,29,32,35,38,40,42,44,46,47,48,49,49,50,50,50,51,51,51,51,51
E01015877,EV motorcycles,Number,1,1,3,5,7,9,12,15,17,20,23,26,28,30,32,34,36,37,38,39,39,40,40,40,41,41,41,41,41,41
E01015878,EV motorcycles,Number,0,1,2,4,5,7,9,11,14,16,18,20,22,24,25,27,28,29,30,30,31,31,31,32,32,32,32,32,32,32
E01015879,EV motorcycles,Number,0,1,2,4,5,7,9,11,14,16,18,20,22,24,25,27,28,29,30,30,31,31,31,32,32,32,32,32,32,32
E01015880,EV motorcycles,Number,0,1,2,3,5,7,9,11,13,15,17,19,21,22,24,25,26,27,28,28,29,29,29,30,30,30,30,30,30,30
E01015881,EV motorcycles,Number,0,1,2,3,4,6,7,9,11,12,14,16,17,18,20,21,22,22,23,24,24,24,24,25,25,25,25,25,25,25
E01015882,EV motorcycles,Number,1,2,3,6,9,12,15,19,22,26,30,33,36,39,42,44,46,48,49,50,51,51,52,52,52,53,53,53,53,53
E01015883,EV motorcycles,Number,0,1,2,4,6,8,10,12,14,17,19,21,23,25,27,28,30,31,31,32,33,33,33,33,34,34,34,34,34,34
E01015884,EV motorcycles,Number,1,2,3,5,7,10,12,15,18,21,24,27,29,32,34,36,37,39,40,41,41,42,42,42,43,43,43,43,43,43
E01015885,EV motorcycles,Number,0,1,2,3,4,5,7,9,10,12,13,15,16,18,19,20,21,22,22,23,23,23,23,24,24,24,24,24,24,24
E01015886,EV motorcycles,Number,1,1,3,4,7,9,12,14,17,20,22,25,27,30,32,33,35,36,37,38,38,39,39,39,40,40,40,40,40,40
E01015887,EV motorcycles,Number,1,1,3,4,7,9,11,14,16,19,22,24,27,29,31,32,34,35,36,37,37,38,38,38,39,39,39,39,39,39
E01015888,EV motorcycles,Number,1,1,2,4,6,8,10,13,15,18,20,22,25,27,28,30,31,32,33,34,35,35,35,35,36,36,36,36,36,36
E01015889,EV motorcycles,Number,0,1,2,3,5,7,9,11,13,15,17,19,21,22,24,25,26,27,28,28,29,29,29,30,30,30,30,30,30,30
E01015890,EV motorcycles,Number,1,1,2,4,6,8,10,13,15,18,20,22,25,27,28,30,31,32,33,34,35,35,35,35,36,36,36,36,36,36
E01015891,EV motorcycles,Number,0,1,2,3,5,6,8,10,12,14,16,17,19,21,22,23,24,25,26,26,27,27,27,28,28,28,28,28,28,28
E01015892,EV motorcycles,Number,0,1,2,4,6,7,10,12,14,16,18,21,23,24,26,27,29,30,31,31,32,32,32,33,33,33,33,33,33,33
E01015893,EV motorcycles,Number,0,1,2,3,5,7,9,11,13,15,17,19,21,22,24,25,26,27,28,28,29,29,29,30,30,30,30,30,30,30
E01015894,EV motorcycles,Number,1,3,5,8,12,16,21,25,30,35,40,44,49,52,56,59,62,64,66,67,68,69,70,70,70,71,71,71,71,71
E01015895,EV motorcycles,Number,1,2,3,5,8,10,13,16,19,22,25,28,31,33,35,37,39,40,42,42,43,44,44,44,45,45,45,45,45,45
E01015896,EV motorcycles,Number,0,1,1,2,4,5,6,8,9,11,12,14,15,16,17,18,19,20,20,21,21,21,22,22,22,22,22,22,22,22
E01015897,EV motorcycles,Number,0,1,2,3,5,7,9,11,13,15,17,19,21,22,24,25,26,27,28,28,29,29,29,30,30,30,30,30,30,30
E01015898,EV motorcycles,Number,0,1,2,3,5,6,8,10,12,14,16,17,19,21,22,23,24,25,26,26,27,27,27,28,28,28,28,28,28,28
E01015899,EV motorcycles,Number,1,2,3,5,8,10,13,16,19,22,25,28,31,33,35,37,39,40,42,42,43,44,44,44,45,45,45,45,45,45
E01015900,EV motorcycles,Number,0,1,1,2,2,3,4,5,6,7,8,9,10,10,11,12,12,13,13,13,13,14,14,14,14,14,14,14,14,14
E01015901,EV motorcycles,Number,0,1,1,2,3,4,5,6,8,9,10,11,12,13,14,15,16,16,17,17,17,17,18,18,18,18,18,18,18,18
E01015902,EV motorcycles,Number,0,0,1,1,2,3,4,5,5,6,7,8,9,10,10,11,11,12,12,12,12,13,13,13,13,13,13,13,13,13
E01015903,EV motorcycles,Number,0,1,1,2,3,4,5,6,8,9,10,11,12,13,14,15,16,16,17,17,17,17,18,18,18,18,18,18,18,18
E01015904,EV motorcycles,Number,0,1,2,4,5,7,9,11,14,16,18,20,22,24,25,27,28,29,30,30,31,31,31,32,32,32,32,32,32,32
E01015905,EV motorcycles,Number,0,1,1,2,3,4,6,7,8,10,11,12,14,15,16,17,17,18,18,19,19,19,20,20,20,20,20,20,20,20
E01015906,EV motorcycles,Number,0,0,1,1,2,2,3,3,4,4,5,6,6,7,7,7,8,8,8,8,9,9,9,9,9,9,9,9,9,9
E01015907,EV motorcycles,Number,0,1,1,2,4,5,6,7,9,10,12,13,14,16,17,17,18,19,19,20,20,20,21,21,21,21,21,21,21,21
E01015908,EV motorcycles,Number,0,1,2,3,5,7,9,11,13,15,17,19,21,23,24,26,27,28,29,29,30,30,30,31,31,31,31,31,31,31
E01015909,EV motorcycles,Number,0,1,1,2,2,3,4,5,6,7,8,9,10,10,11,12,12,13,13,13,13,14,14,14,14,14,14,14,14,14
E01015910,EV motorcycles,Number,0,1,1,2,4,5,6,7,9,10,12,13,14,16,17,17,18,19,19,20,20,20,21,21,21,21,21,21,21,21
E01015911,EV motorcycles,Number,1,1,3,5,7,9,12,15,17,20,23,26,28,30,32,34,36,37,38,39,39,40,40,40,41,41,41,41,41,41
E01015912,EV motorcycles,Number,0,1,1,2,3,3,4,5,6,7,8,9,10,11,12,12,13,13,14,14,14,15,15,15,15,15,15,15,15,15
E01015913,EV motorcycles,Number,1,2,3,5,8,10,13,16,19,23,26,29,31,34,36,38,40,41,43,43,44,45,45,45,46,46,46,46,46,46
E01015914,EV motorcycles,Number,0,1,1,2,3,4,5,6,7,8,10,11,12,13,13,14,15,15,16,16,16,16,17,17,17,17,17,17,17,17
E01015915,EV motorcycles,Number,1,1,2,4,6,8,10,12,15,17,20,22,24,26,28,29,30,31,32,33,34,34,34,34,35,35,35,35,35,35
E01015916,EV motorcycles,Number,0,1,2,4,5,7,9,11,14,16,18,20,22,24,25,27,28,29,30,30,31,31,31,32,32,32,32,32,32,32
E01015917,EV motorcycles,Number,1,1,3,4,7,9,12,14,17,20,22,25,27,30,32,33,35,36,37,38,38,39,39,39,40,40,40,40,40,40
E01015918,EV motorcycles,Number,0,1,2,4,6,7,10,12,14,16,18,21,23,24,26,27,29,30,31,31,32,32,32,33,33,33,33,33,33,33
E01015919,EV motorcycles,Number,0,1,2,3,5,6,8,10,11,13,15,17,18,20,21,22,23,24,25,25,26,26,26,27,27,27,27,27,27,27
E01015920,EV motorcycles,Number,1,2,3,5,8,10,13,16,19,22,25,28,31,33,35,37,39,40,42,42,43,44,44,44,45,45,45,45,45,45
E01015921,EV motorcycles,Number,1,1,2,4,6,9,11,13,16,19,21,24,26,28,30,32,33,34,35,36,36,37,37,37,38,38,38,38,38,38
E01015922,EV motorcycles,Number,1,1,3,4,7,9,12,14,17,20,22,25,27,30,32,33,35,36,37,38,38,39,39,39,40,40,40,40,40,40
E01015923,EV motorcycles,Number,1,2,3,5,8,11,14,17,20,23,26,29,32,35,37,39,41,42,43,44,45,46,46,46,47,47,47,47,47,47
E01015924,EV motorcycles,Number,0,1,2,3,4,5,7,8,10,11,13,14,16,17,18,19,20,21,21,22,22,22,23,23,23,23,23,23,23,23
E01015925,EV motorcycles,Number,1,1,2,4,6,8,10,12,15,17,20,22,24,26,28,29,30,31,32,33,34,34,34,34,35,35,35,35,35,35
E01015926,EV motorcycles,Number,1,1,3,5,7,9,12,15,17,20,23,26,28,30,32,34,36,37,38,39,39,40,40,40,41,41,41,41,41,41
E01015927,EV motorcycles,Number,0,1,2,4,5,7,9,11,14,16,18,20,22,24,25,27,28,29,30,30,31,31,31,32,32,32,32,32,32,32
E01015928,EV motorcycles,Number,1,1,3,4,7,9,12,14,17,20,22,25,27,30,32,33,35,36,37,38,38,39,39,39,40,40,40,40,40,40
E01015929,EV motorcycles,Number,0,1,2,3,4,5,7,8,10,11,13,14,16,17,18,19,20,21,21,22,22,22,23,23,23,23,23,23,23,23
E01015930,EV motorcycles,Number,0,1,1,2,3,4,5,7,8,9,11,12,13,14,15,16,17,17,18,18,18,18,19,19,19,19,19,19,19,19
E01015931,EV motorcycles,Number,0,1,2,3,4,6,7,9,11,12,14,16,17,18,20,21,22,22,23,24,24,24,24,25,25,25,25,25,25,25
E01015932,EV motorcycles,Number,1,2,3,6,8,11,14,18,21,25,28,31,34,37,39,42,43,45,46,47,48,49,49,49,49,50,50,50,50,50
E01015933,EV motorcycles,Number,0,1,2,3,4,6,8,9,11,13,15,16,18,19,20,22,23,23,24,25,25,25,25,26,26,26,26,26,26,26
E01015934,EV motorcycles,Number,0,1,1,2,3,4,5,6,7,8,9,10,11,12,13,13,14,14,15,15,15,16,16,16,16,16,16,16,16,16
E01015935,EV motorcycles,Number,0,1,2,3,5,7,8,10,12,14,16,18,20,21,23,24,25,26,27,27,28,28,28,29,29,29,29,29,29,29
E01015936,EV motorcycles,Number,0,1,2,3,5,7,8,10,12,14,16,18,20,21,23,24,25,26,27,27,28,28,28,29,29,29,29,29,29,29
E01015937,EV motorcycles,Number,1,1,2,4,6,8,10,12,15,17,20,22,24,26,28,29,30,31,32,33,34,34,34,34,35,35,35,35,35,35
E01015938,EV motorcycles,Number,0,1,1,2,3,4,5,6,8,9,10,11,12,13,14,15,16,16,17,17,17,17,18,18,18,18,18,18,18,18
E01015939,EV motorcycles,Number,1,1,2,4,6,8,10,13,15,18,20,22,25,27,28,30,31,32,33,34,35,35,35,35,36,36,36,36,36,36
E01015941,EV motorcycles,Number,0,1,2,3,4,5,7,9,10,12,13,15,16,18,19,20,21,22,22,23,23,23,23,24,24,24,24,24,24,24
E01015942,EV motorcycles,Number,0,1,2,3,4,6,8,9,11,13,15,16,18,19,20,22,23,23,24,25,25,25,25,26,26,26,26,26,26,26
E01015943,EV motorcycles,Number,1,1,2,4,6,8,10,12,15,17,20,22,24,26,28,29,30,31,32,33,34,34,34,34,35,35,35,35,35,35
E01015944,EV motorcycles,Number,0,1,2,3,4,5,7,8,10,11,13,14,16,17,18,19,20,21,21,22,22,22,23,23,23,23,23,23,23,23
E01015945,EV motorcycles,Number,1,1,2,4,6,8,10,12,15,17,20,22,24,26,28,29,30,31,32,33,34,34,34,34,35,35,35,35,35,35
E01015946,EV motorcycles,Number,0,1,2,3,5,7,9,11,13,15,17,19,21,23,24,26,27,28,29,29,30,30,30,31,31,31,31,31,31,31
E01015947,EV motorcycles,Number,0,1,1,2,4,5,6,8,9,11,12,14,15,16,17,18,19,20,20,21,21,21,22,22,22,22,22,22,22,22
E01015948,EV motorcycles,Number,1,2,3,6,8,11,14,18,21,25,28,31,34,37,39,42,43,45,46,47,48,49,49,49,49,50,50,50,50,50
E01015949,EV motorcycles,Number,1,2,3,5,8,11,14,17,20,23,26,29,32,35,37,39,41,42,43,44,45,46,46,46,47,47,47,47,47,47
E01015950,EV motorcycles,Number,1,2,3,5,7,10,12,15,18,21,24,27,29,32,34,36,37,39,40,41,41,42,42,42,43,43,43,43,43,43
E01015951,EV motorcycles,Number,0,0,1,1,2,2,3,3,4,4,5,6,6,7,7,7,8,8,8,8,9,9,9,9,9,9,9,9,9,9
E01015952,EV motorcycles,Number,0,1,1,2,3,4,6,7,8,10,11,12,14,15,16,17,17,18,18,19,19,19,20,20,20,20,20,20,20,20
E01015953,EV motorcycles,Number,0,1,2,3,4,6,8,9,11,13,15,16,18,19,20,22,23,23,24,25,25,25,25,26,26,26,26,26,26,26
E01015954,EV motorcycles,Number,0,1,1,2,3,4,5,6,7,8,10,11,12,13,13,14,15,15,16,16,16,16,17,17,17,17,17,17,17,17
E01015955,EV motorcycles,Number,0,1,2,3,5,7,9,11,13,15,17,19,21,22,24,25,26,27,28,28,29,29,29,30,30,30,30,30,30,30
E01015956,EV motorcycles,Number,0,1,2,3,4,6,8,9,11,13,15,16,18,19,20,22,23,23,24,25,25,25,25,26,26,26,26,26,26,26
E01015957,EV motorcycles,Number,0,1,2,3,5,6,8,10,11,13,15,17,18,20,21,22,23,24,25,25,26,26,26,27,27,27,27,27,27,27
E01015958,EV motorcycles,Number,0,1,1,2,2,3,4,5,6,7,8,9,10,10,11,12,12,13,13,13,13,14,14,14,14,14,14,14,14,14
E01015959,EV motorcycles,Number,0,1,1,2,3,4,5,6,8,9,10,11,12,13,14,15,16,16,17,17,17,17,18,18,18,18,18,18,18,18
E01015960,EV motorcycles,Number,0,1,1,2,2,3,4,5,6,7,8,9,10,10,11,12,12,13,13,13,13,14,14,14,14,14,14,14,14,14
E01015961,EV motorcycles,Number,0,1,2,3,4,6,7,9,11,12,14,16,17,18,20,21,22,22,23,24,24,24,24,25,25,25,25,25,25,25
E01015962,EV motorcycles,Number,0,1,1,2,3,4,5,6,8,9,10,11,12,13,14,15,16,16,17,17,17,17,18,18,18,18,18,18,18,18
E01015963,EV motorcycles,Number,0,0,1,1,2,3,4,5,5,6,7,8,9,10,10,11,11,12,12,12,12,13,13,13,13,13,13,13,13,13
E01015964,EV motorcycles,Number,0,1,2,3,4,6,7,9,11,12,14,16,17,18,20,21,22,22,23,24,24,24,24,25,25,25,25,25,25,25
E01015965,EV motorcycles,Number,1,1,2,4,6,8,11,13,16,18,21,23,25,27,29,31,32,33,34,35,35,36,36,36,37,37,37,37,37,37
E01015966,EV motorcycles,Number,0,1,2,3,5,7,9,11,13,15,17,19,21,23,24,26,27,28,29,29,30,30,30,31,31,31,31,31,31,31
E01015967,EV motorcycles,Number,0,1,1,2,4,5,6,8,9,11,12,14,15,16,17,18,19,20,20,21,21,21,22,22,22,22,22,22,22,22
E01015968,EV motorcycles,Number,0,1,2,3,5,6,8,10,12,14,16,17,19,21,22,23,24,25,26,26,27,27,27,28,28,28,28,28,28,28
E01015969,EV motorcycles,Number,1,2,3,5,8,10,13,16,19,23,26,29,31,34,36,38,40,41,43,43,44,45,45,45,46,46,46,46,46,46
E01015970,EV motorcycles,Number,0,1,2,3,5,7,9,11,13,15,17,19,21,23,24,26,27,28,29,29,30,30,30,31,31,31,31,31,31,31
E01015971,EV motorcycles,Number,0,1,2,4,5,7,9,11,14,16,18,20,22,24,25,27,28,29,30,30,31,31,31,32,32,32,32,32,32,32
E01015972,EV motorcycles,Number,0,1,1,2,4,5,6,7,9,10,12,13,14,16,17,17,18,19,19,20,20,20,21,21,21,21,21,21,21,21
E01015973,EV motorcycles,Number,1,1,3,5,7,9,12,15,17,20,23,26,28,30,32,34,36,37,38,39,39,40,40,40,41,41,41,41,41,41
E01015974,EV motorcycles,Number,0,1,1,2,3,4,6,7,8,10,11,12,14,15,16,17,17,18,18,19,19,19,20,20,20,20,20,20,20,20
E01015975,EV motorcycles,Number,0,1,2,3,5,7,8,10,12,14,16,18,20,21,23,24,25,26,27,27,28,28,28,29,29,29,29,29,29,29
E01015976,EV motorcycles,Number,0,1,2,3,5,6,8,10,11,13,15,17,18,20,21,22,23,24,25,25,26,26,26,27,27,27,27,27,27,27
E01015977,EV motorcycles,Number,1,2,3,6,8,11,14,18,21,25,28,31,34,37,39,42,43,45,46,47,48,49,49,49,49,50,50,50,50,50
E01015978,EV motorcycles,Number,1,2,4,7,10,13,17,21,25,29,33,37,40,44,47,49,51,53,55,56,57,57,58,58,58,59,59,59,59,59
E01015979,EV motorcycles,Number,0,1,2,4,6,8,10,12,14,17,19,21,23,25,27,28,30,31,31,32,33,33,33,33,34,34,34,34,34,34
E01015980,EV motorcycles,Number,1,2,3,5,7,10,12,15,18,21,24,27,29,32,34,36,37,39,40,41,41,42,42,42,43,43,43,43,43,43
E01015982,EV motorcycles,Number,0,1,2,3,5,7,9,11,13,15,17,19,21,23,24,26,27,28,29,29,30,30,30,31,31,31,31,31,31,31
E01015983,EV motorcycles,Number,0,1,2,3,5,6,8,10,12,14,16,17,19,21,22,23,24,25,26,26,27,27,27,28,28,28,28,28,28,28
E01015984,EV motorcycles,Number,1,1,3,5,7,9,12,15,17,20,23,26,28,30,32,34,36,37,38,39,39,40,40,40,41,41,41,41,41,41
E01015985,EV motorcycles,Number,1,1,3,5,7,9,12,15,17,20,23,26,28,30,32,34,36,37,38,39,39,40,40,40,41,41,41,41,41,41
E01015986,EV motorcycles,Number,0,1,1,2,4,5,6,7,9,10,12,13,14,16,17,17,18,19,19,20,20,20,21,21,21,21,21,21,21,21
E01015987,EV motorcycles,Number,0,1,1,2,3,4,6,7,8,10,11,12,14,15,16,17,17,18,18,19,19,19,20,20,20,20,20,20,20,20
E01015988,EV motorcycles,Number,0,1,2,3,5,7,8,10,12,14,16,18,20,21,23,24,25,26,27,27,28,28,28,29,29,29,29,29,29,29
E01015989,EV motorcycles,Number,0,1,2,3,5,6,8,10,11,13,15,17,18,20,21,22,23,24,25,25,26,26,26,27,27,27,27,27,27,27
E01015990,EV motorcycles,Number,1,2,3,5,7,10,12,15,18,21,24,27,29,32,34,36,37,39,40,41,41,42,42,42,43,43,43,43,43,43
E01015991,EV motorcycles,Number,0,1,2,4,6,8,10,12,14,17,19,21,23,25,27,28,30,31,31,32,33,33,33,33,34,34,34,34,34,34
E01015992,EV motorcycles,Number,1,2,3,5,8,11,14,17,20,24,27,30,33,35,38,40,42,43,44,45,46,47,47,47,48,48,48,48,48,48
E01015993,EV motorcycles,Number,0,1,2,3,5,7,8,10,12,14,16,18,20,21,23,24,25,26,27,27,28,28,28,29,29,29,29,29,29,29
E01015994,EV motorcycles,Number,0,1,2,3,4,5,7,9,10,12,13,15,16,18,19,20,21,22,22,23,23,23,23,24,24,24,24,24,24,24
E01015995,EV motorcycles,Number,1,1,2,4,6,9,11,13,16,19,21,24,26,28,30,32,33,34,35,36,36,37,37,37,38,38,38,38,38,38
E01015996,EV motorcycles,Number,0,1,2,3,5,6,8,10,11,13,15,17,18,20,21,22,23,24,25,25,26,26,26,27,27,27,27,27,27,27
E01015997,EV motorcycles,Number,0,1,1,2,4,5,6,7,9,10,12,13,14,16,17,17,18,19,19,20,20,20,21,21,21,21,21,21,21,21
E01015998,EV motorcycles,Number,0,1,2,3,4,6,7,9,11,12,14,16,17,18,20,21,22,22,23,24,24,24,24,25,25,25,25,25,25,25
E01015999,EV motorcycles,Number,1,1,2,4,6,8,10,12,15,17,20,22,24,26,28,29,30,31,32,33,34,34,34,34,35,35,35,35,35,35
E01016000,EV motorcycles,Number,1,1,2,4,6,8,11,13,16,18,21,23,25,27,29,31,32,33,34,35,35,36,36,36,37,37,37,37,37,37
E01016001,EV motorcycles,Number,0,1,2,3,5,6,8,10,11,13,15,17,18,20,21,22,23,24,25,25,26,26,26,27,27,27,27,27,27,27
E01016002,EV motorcycles,Number,0,1,2,3,4,5,7,9,10,12,13,15,16,18,19,20,21,22,22,23,23,23,23,24,24,24,24,24,24,24
E01016003,EV motorcycles,Number,0,1,1,2,3,4,5,7,8,9,11,12,13,14,15,16,17,17,18,18,18,18,19,19,19,19,19,19,19,19
E01016004,EV motorcycles,Number,0,1,1,2,4,5,6,8,9,11,12,14,15,16,17,18,19,20,20,21,21,21,22,22,22,22,22,22,22,22
E01016005,EV motorcycles,Number,0,1,1,2,3,4,5,7,8,9,11,12,13,14,15,16,17,17,18,18,18,18,19,19,19,19,19,19,19,19
E01016006,EV motorcycles,Number,0,0,1,1,2,2,3,4,5,5,6,7,8,8,9,9,10,10,10,10,11,11,11,11,11,11,11,11,11,11
E01016007,EV motorcycles,Number,0,1,1,2,3,4,5,7,8,9,11,12,13,14,15,16,17,17,18,18,18,18,19,19,19,19,19,19,19,19
E01016008,EV motorcycles,Number,1,1,2,4,6,8,10,13,15,18,20,22,25,27,28,30,31,32,33,34,35,35,35,35,36,36,36,36,36,36
E01016009,EV motorcycles,Number,0,1,2,3,5,6,8,10,12,14,16,17,19,21,22,23,24,25,26,26,27,27,27,28,28,28,28,28,28,28
E01016010,EV motorcycles,Number,0,1,1,2,3,4,5,6,7,8,10,11,12,13,13,14,15,15,16,16,16,16,17,17,17,17,17,17,17,17
E01016011,EV motorcycles,Number,0,1,2,3,5,7,9,11,13,15,17,19,21,23,24,26,27,28,29,29,30,30,30,31,31,31,31,31,31,31
E01016012,EV motorcycles,Number,2,4,7,12,18,24,31,38,46,53,60,67,74,80,85,90,94,97,100,102,104,105,106,106,107,107,108,108,108,108
E01016013,EV motorcycles,Number,1,1,3,4,7,9,12,14,17,20,22,25,27,30,32,33,35,36,37,38,38,39,39,39,40,40,40,40,40,40
E01016014,EV motorcycles,Number,0,1,2,3,5,7,8,10,12,14,16,18,20,21,23,24,25,26,27,27,28,28,28,29,29,29,29,29,29,29
E01016015,EV motorcycles,Number,1,2,3,5,7,9,12,15,18,21,24,26,29,31,33,35,36,38,39,40,40,41,41,41,42,42,42,42,42,42
E01016016,EV motorcycles,Number,0,0,1,1,2,3,3,4,5,6,7,7,8,9,9,10,10,11,11,11,12,12,12,12,12,12,12,12,12,12
E01016017,EV motorcycles,Number,0,1,2,3,5,7,9,11,13,15,17,19,21,22,24,25,26,27,28,28,29,29,29,30,30,30,30,30,30,30
E01016018,EV motorcycles,Number,0,1,1,2,3,3,4,5,6,7,8,9,10,11,12,12,13,13,14,14,14,15,15,15,15,15,15,15,15,15
E01016019,EV motorcycles,Number,0,1,1,2,4,5,6,7,9,10,12,13,14,16,17,17,18,19,19,20,20,20,21,21,21,21,21,21,21,21
E01016020,EV motorcycles,Number,0,0,1,1,2,3,3,4,5,6,7,7,8,9,9,10,10,11,11,11,12,12,12,12,12,12,12,12,12,12
E01016021,EV motorcycles,Number,0,1,2,3,4,6,7,9,11,12,14,16,17,18,20,21,22,22,23,24,24,24,24,25,25,25,25,25,25,25
E01016022,EV motorcycles,Number,0,1,1,2,2,3,4,5,6,7,8,9,10,10,11,12,12,13,13,13,13,14,14,14,14,14,14,14,14,14
E01016023,EV motorcycles,Number,0,1,2,3,4,5,7,9,10,12,13,15,16,18,19,20,21,22,22,23,23,23,23,24,24,24,24,24,24,24
E01016024,EV motorcycles,Number,0,1,2,3,5,7,9,11,13,15,17,19,21,23,24,26,27,28,29,29,30,30,30,31,31,31,31,31,31,31
E01016025,EV motorcycles,Number,1,2,3,5,7,10,12,15,18,21,24,27,29,32,34,36,37,39,40,41,41,42,42,42,43,43,43,43,43,43
E01016026,EV motorcycles,Number,1,2,3,6,8,11,14,18,21,25,28,31,34,37,39,42,43,45,46,47,48,49,49,49,49,50,50,50,50,50
E01016027,EV motorcycles,Number,1,2,4,7,11,14,19,23,27,31,36,40,44,47,50,53,56,58,59,60,61,62,63,63,63,64,64,64,64,64
E01016028,EV motorcycles,Number,1,3,5,8,12,16,21,25,30,35,40,44,49,52,56,59,62,64,66,67,68,69,70,70,70,71,71,71,71,71
E01016029,EV motorcycles,Number,1,3,6,10,16,21,27,34,40,47,53,59,65,70,75,79,83,85,88,90,91,92,93,94,94,94,95,95,95,95
E01016030,EV motorcycles,Number,1,1,3,5,7,9,12,15,17,20,23,26,28,30,32,34,36,37,38,39,39,40,40,40,41,41,41,41,41,41
E01016031,EV motorcycles,Number,0,1,1,2,3,3,4,5,6,7,8,9,10,11,12,12,13,13,14,14,14,15,15,15,15,15,15,15,15,15
E01016032,EV motorcycles,Number,0,1,2,3,4,5,7,8,10,11,13,14,16,17,18,19,20,21,21,22,22,22,23,23,23,23,23,23,23,23
E01016033,EV motorcycles,Number,0,0,1,1,2,2,3,4,4,5,6,6,7,7,8,8,9,9,9,9,10,10,10,10,10,10,10,10,10,10
E01016034,EV motorcycles,Number,1,2,4,7,10,14,18,22,26,30,35,39,42,46,49,52,54,56,57,59,59,60,61,61,61,62,62,62,62,62
E01016035,EV motorcycles,Number,0,1,2,3,5,6,8,10,12,14,16,17,19,21,22,23,24,25,26,26,27,27,27,28,28,28,28,28,28,28
E01016036,EV motorcycles,Number,0,1,2,4,6,8,10,12,14,17,19,21,23,25,27,28,30,31,31,32,33,33,33,33,34,34,34,34,34,34
E01016037,EV motorcycles,Number,0,1,2,3,4,6,7,9,11,12,14,16,17,18,20,21,22,22,23,24,24,24,24,25,25,25,25,25,25,25
E01016038,EV motorcycles,Number,0,1,2,3,4,5,7,8,10,11,13,14,16,17,18,19,20,21,21,22,22,22,23,23,23,23,23,23,23,23
E01016039,EV motorcycles,Number,0,1,1,2,3,3,4,5,6,7,8,9,10,11,12,12,13,13,14,14,14,15,15,15,15,15,15,15,15,15
E01016040,EV motorcycles,Number,0,1,1,2,4,5,6,8,9,11,12,14,15,16,17,18,19,20,20,21,21,21,22,22,22,22,22,22,22,22
E01016041,EV motorcycles,Number,0,1,2,3,4,6,7,9,11,12,14,16,17,18,20,21,22,22,23,24,24,24,24,25,25,25,25,25,25,25
E01016042,EV motorcycles,Number,0,0,1,1,2,3,4,5,5,6,7,8,9,10,10,11,11,12,12,12,12,13,13,13,13,13,13,13,13,13
E01016043,EV motorcycles,Number,0,1,2,3,4,6,8,9,11,13,15,16,18,19,20,22,23,23,24,25,25,25,25,26,26,26,26,26,26,26
E01016044,EV motorcycles,Number,0,1,2,3,5,6,8,10,11,13,15,17,18,20,21,22,23,24,25,25,26,26,26,27,27,27,27,27,27,27
E01016045,EV motorcycles,Number,0,1,1,2,3,4,6,7,8,10,11,12,14,15,16,17,17,18,18,19,19,19,20,20,20,20,20,20,20,20
E01016046,EV motorcycles,Number,0,1,2,3,4,5,7,8,10,11,13,14,16,17,18,19,20,21,21,22,22,22,23,23,23,23,23,23,23,23
E01016047,EV motorcycles,Number,0,1,2,3,5,7,8,10,12,14,16,18,20,21,23,24,25,26,27,27,28,28,28,29,29,29,29,29,29,29
E01016048,EV motorcycles,Number,0,1,2,3,4,5,7,8,10,11,13,14,16,17,18,19,20,21,21,22,22,22,23,23,23,23,23,23,23,23
E01016049,EV motorcycles,Number,0,1,2,3,5,7,9,11,13,15,17,19,21,22,24,25,26,27,28,28,29,29,29,30,30,30,30,30,30,30
E01016050,EV motorcycles,Number,0,1,2,3,4,5,7,8,10,11,13,14,16,17,18,19,20,21,21,22,22,22,23,23,23,23,23,23,23,23
E01016051,EV motorcycles,Number,0,1,2,3,5,6,8,10,12,14,16,17,19,21,22,23,24,25,26,26,27,27,27,28,28,28,28,28,28,28
E01016052,EV motorcycles,Number,1,1,3,4,7,9,11,14,16,19,22,24,27,29,31,32,34,35,36,37,37,38,38,38,39,39,39,39,39,39
E01016053,EV motorcycles,Number,1,2,3,5,8,11,14,17,21,24,27,31,33,36,39,41,43,44,45,46,47,48,48,48,48,49,49,49,49,49
E01016054,EV motorcycles,Number,0,1,2,4,5,7,9,11,14,16,18,20,22,24,25,27,28,29,30,30,31,31,31,32,32,32,32,32,32,32
E01016055,EV motorcycles,Number,1,2,3,6,9,11,15,18,22,25,29,32,35,38,40,42,44,46,47,48,49,49,50,50,50,51,51,51,51,51
E01016056,EV motorcycles,Number,1,2,3,5,8,11,14,17,20,23,26,29,32,35,37,39,41,42,43,44,45,46,46,46,47,47,47,47,47,47
E01016057,EV motorcycles,Number,1,2,3,6,9,12,15,19,22,26,30,33,36,39,42,44,46,48,49,50,51,51,52,52,52,53,53,53,53,53
E01016058,EV motorcycles,Number,1,2,3,5,7,10,12,15,18,21,24,27,29,32,34,36,37,39,40,41,41,42,42,42,43,43,43,43,43,43
E01016059,EV motorcycles,Number,0,1,2,3,4,6,8,9,11,13,15,16,18,19,20,22,23,23,24,25,25,25,25,26,26,26,26,26,26,26
E01016060,EV motorcycles,Number,0,1,2,4,6,8,10,12,14,17,19,21,23,25,27,28,30,31,31,32,33,33,33,33,34,34,34,34,34,34
E01016061,EV motorcycles,Number,1,1,2,4,6,8,10,12,15,17,20,22,24,26,28,29,30,31,32,33,34,34,34,34,35,35,35,35,35,35
E01016062,EV motorcycles,Number,0,1,1,2,3,4,5,6,7,8,9,10,11,12,13,13,14,14,15,15,15,16,16,16,16,16,16,16,16,16
E01016063,EV motorcycles,Number,0,1,1,2,3,4,5,7,8,9,11,12,13,14,15,16,17,17,18,18,18,18,19,19,19,19,19,19,19,19
E01016064,EV motorcycles,Number,0,1,2,3,5,7,8,10,12,14,16,18,20,21,23,24,25,26,27,27,28,28,28,29,29,29,29,29,29,29
E01016065,EV motorcycles,Number,1,1,2,4,6,8,10,12,15,17,20,22,24,26,28,29,30,31,32,33,34,34,34,34,35,35,35,35,35,35
E01016066,EV motorcycles,Number,1,2,3,6,8,11,14,18,21,25,28,31,34,37,39,42,43,45,46,47,48,49,49,49,49,50,50,50,50,50
E01016067,EV motorcycles,Number,0,1,2,3,5,6,8,10,12,14,16,17,19,21,22,23,24,25,26,26,27,27,27,28,28,28,28,28,28,28
E01016068,EV motorcycles,Number,1,1,2,4,6,8,11,13,16,18,21,23,25,27,29,31,32,33,34,35,35,36,36,36,37,37,37,37,37,37
E01016069,EV motorcycles,Number,1,1,3,4,7,9,11,14,16,19,22,24,27,29,31,32,34,35,36,37,37,38,38,38,39,39,39,39,39,39
E01016070,EV motorcycles,Number,1,2,4,6,9,12,16,19,23,27,30,34,37,40,43,45,47,49,50,51,52,52,53,53,53,54,54,54,54,54
E01016071,EV motorcycles,Number,1,3,5,8,12,17,21,26,31,36,41,46,51,55,58,62,64,67,68,70,71,72,72,73,73,73,74,74,74,74
E01016072,EV motorcycles,Number,1,2,4,7,10,14,18,22,26,30,35,39,42,46,49,52,54,56,57,59,59,60,61,61,61,62,62,62,62,62
E01016073,EV motorcycles,Number,2,4,7,12,18,24,31,38,45,52,59,66,72,78,84,88,92,95,98,100,102,103,104,104,105,105,106,106,106,106
E01016074,EV motorcycles,Number,1,3,5,8,13,17,22,27,32,37,42,47,51,55,59,62,65,67,69,71,72,73,73,74,74,74,75,75,75,75
E01016075,EV motorcycles,Number,1,2,4,7,10,14,18,22,26,30,35,39,42,46,49,52,54,56,57,59,59,60,61,61,61,62,62,62,62,62
E01016076,EV motorcycles,Number,2,4,8,13,19,26,34,41,49,57,65,72,79,86,91,96,101,104,107,109,111,113,114,114,115,115,116,116,116,116
E01016077,EV motorcycles,Number,1,2,4,7,11,15,20,24,29,33,38,42,46,50,54,57,59,61,63,64,65,66,67,67,67,68,68,68,68,68
E01016078,EV motorcycles,Number,1,1,2,4,6,8,10,12,15,17,20,22,24,26,28,29,30,31,32,33,34,34,34,34,35,35,35,35,35,35
E01016079,EV motorcycles,Number,0,1,2,3,5,7,9,11,13,15,17,19,21,23,24,26,27,28,29,29,30,30,30,31,31,31,31,31,31,31
E01016080,EV motorcycles,Number,0,1,2,3,4,6,7,9,11,12,14,16,17,18,20,21,22,22,23,24,24,24,24,25,25,25,25,25,25,25
E01016081,EV motorcycles,Number,1,1,3,5,7,9,12,15,17,20,23,26,28,30,32,34,36,37,38,39,39,40,40,40,41,41,41,41,41,41
E01016082,EV motorcycles,Number,1,1,2,4,6,9,11,13,16,19,21,24,26,28,30,32,33,34,35,36,36,37,37,37,38,38,38,38,38,38
E01016083,EV motorcycles,Number,0,1,1,2,3,4,5,6,7,8,10,11,12,13,13,14,15,15,16,16,16,16,17,17,17,17,17,17,17,17
E01016084,EV motorcycles,Number,0,1,1,2,3,4,6,7,8,10,11,12,14,15,16,17,17,18,18,19,19,19,20,20,20,20,20,20,20,20
E01016085,EV motorcycles,Number,1,2,3,6,8,11,14,18,21,25,28,31,34,37,39,42,43,45,46,47,48,49,49,49,49,50,50,50,50,50
E01016086,EV motorcycles,Number,0,1,2,4,5,7,9,11,14,16,18,20,22,24,25,27,28,29,30,30,31,31,31,32,32,32,32,32,32,32
E01016087,EV motorcycles,Number,0,1,2,3,5,7,8,10,12,14,16,18,20,21,23,24,25,26,27,27,28,28,28,29,29,29,29,29,29,29
E01016088,EV motorcycles,Number,1,2,3,6,9,11,15,18,22,25,29,32,35,38,40,42,44,46,47,48,49,49,50,50,50,51,51,51,51,51
E01016089,EV motorcycles,Number,0,1,2,4,6,8,10,12,14,17,19,21,23,25,27,28,30,31,31,32,33,33,33,33,34,34,34,34,34,34
E01016090,EV motorcycles,Number,0,1,1,2,4,5,6,8,9,11,12,14,15,16,17,18,19,20,20,21,21,21,22,22,22,22,22,22,22,22
E01016091,EV motorcycles,Number,1,2,3,6,8,11,14,18,21,25,28,31,34,37,39,42,43,45,46,47,48,49,49,49,49,50,50,50,50,50
E01016092,EV motorcycles,Number,0,1,2,3,4,5,7,8,10,11,13,14,16,17,18,19,20,21,21,22,22,22,23,23,23,23,23,23,23,23
E01016093,EV motorcycles,Number,1,2,3,5,8,11,14,17,20,24,27,30,33,35,38,40,42,43,44,45,46,47,47,47,48,48,48,48,48,48
E01016094,EV motorcycles,Number,1,2,3,5,7,10,12,15,18,21,24,27,29,32,34,36,37,39,40,41,41,42,42,42,43,43,43,43,43,43
E01016095,EV motorcycles,Number,0,1,2,3,5,6,8,10,12,14,16,17,19,21,22,23,24,25,26,26,27,27,27,28,28,28,28,28,28,28
E01016096,EV motorcycles,Number,0,1,2,4,6,8,10,12,14,17,19,21,23,25,27,28,30,31,31,32,33,33,33,33,34,34,34,34,34,34
E01016097,EV motorcycles,Number,1,2,3,5,7,9,12,15,18,21,24,26,29,31,33,35,36,38,39,40,40,41,41,41,42,42,42,42,42,42
E01016098,EV motorcycles,Number,0,1,2,3,5,6,8,10,12,14,16,17,19,21,22,23,24,25,26,26,27,27,27,28,28,28,28,28,28,28
E01016099,EV motorcycles,Number,0,1,2,3,5,6,8,10,12,14,16,17,19,21,22,23,24,25,26,26,27,27,27,28,28,28,28,28,28,28
E01016100,EV motorcycles,Number,0,1,2,3,5,7,9,11,13,15,17,19,21,23,24,26,27,28,29,29,30,30,30,31,31,31,31,31,31,31
E01016101,EV motorcycles,Number,1,1,2,4,6,9,11,13,16,19,21,24,26,28,30,32,33,34,35,36,36,37,37,37,38,38,38,38,38,38
E01016102,EV motorcycles,Number,0,1,2,3,4,5,7,8,10,11,13,14,16,17,18,19,20,21,21,22,22,22,23,23,23,23,23,23,23,23
E01016103,EV motorcycles,Number,1,2,3,5,8,11,14,17,20,24,27,30,33,35,38,40,42,43,44,45,46,47,47,47,48,48,48,48,48,48
E01016104,EV motorcycles,Number,1,1,2,4,6,8,10,13,15,18,20,22,25,27,28,30,31,32,33,34,35,35,35,35,36,36,36,36,36,36
E01016105,EV motorcycles,Number,1,2,3,6,9,11,15,18,22,25,29,32,35,38,40,42,44,46,47,48,49,49,50,50,50,51,51,51,51,51
E01016106,EV motorcycles,Number,0,1,2,4,5,7,9,11,14,16,18,20,22,24,25,27,28,29,30,30,31,31,31,32,32,32,32,32,32,32
E01016107,EV motorcycles,Number,0,1,2,3,5,7,8,10,12,14,16,18,20,21,23,24,25,26,27,27,28,28,28,29,29,29,29,29,29,29
E01016110,EV motorcycles,Number,1,2,3,5,7,10,13,16,19,22,25,27,30,33,35,37,38,40,41,42,42,43,43,43,44,44,44,44,44,44
E01016111,EV motorcycles,Number,0,1,2,3,4,5,7,8,10,11,13,14,16,17,18,19,20,21,21,22,22,22,23,23,23,23,23,23,23,23
E01016112,EV motorcycles,Number,1,3,6,10,15,20,26,32,38,44,50,55,61,66,70,74,77,80,82,84,85,86,87,88,88,88,89,89,89,89
E01016113,EV motorcycles,Number,0,1,1,2,3,4,5,6,8,9,10,11,12,13,14,15,16,16,17,17,17,17,18,18,18,18,18,18,18,18
E01016114,EV motorcycles,Number,0,1,1,2,4,5,6,7,9,10,12,13,14,16,17,17,18,19,19,20,20,20,21,21,21,21,21,21,21,21
E01016115,EV motorcycles,Number,1,2,3,5,7,10,13,16,19,22,25,27,30,33,35,37,38,40,41,42,42,43,43,43,44,44,44,44,44,44
E01016116,EV motorcycles,Number,0,1,2,3,5,6,8,10,12,14,16,17,19,21,22,23,24,25,26,26,27,27,27,28,28,28,28,28,28,28
E01016117,EV motorcycles,Number,0,1,1,2,3,4,5,6,8,9,10,11,12,13,14,15,16,16,17,17,17,17,18,18,18,18,18,18,18,18
E01016118,EV motorcycles,Number,0,1,1,2,3,4,5,6,7,8,9,10,11,12,13,13,14,14,15,15,15,16,16,16,16,16,16,16,16,16
E01016119,EV motorcycles,Number,0,1,2,3,5,6,8,10,12,14,16,17,19,21,22,23,24,25,26,26,27,27,27,28,28,28,28,28,28,28
E01016120,EV motorcycles,Number,0,1,1,2,3,4,5,6,7,8,10,11,12,13,13,14,15,15,16,16,16,16,17,17,17,17,17,17,17,17
E01016121,EV motorcycles,Number,1,2,4,7,10,14,18,22,26,30,35,39,42,46,49,52,54,56,57,59,59,60,61,61,61,62,62,62,62,62
E01016122,EV motorcycles,Number,1,2,4,7,10,14,18,22,26,30,35,39,42,46,49,52,54,56,57,59,59,60,61,61,61,62,62,62,62,62
E01016123,EV motorcycles,Number,1,2,3,5,8,10,13,16,19,22,25,28,31,33,35,37,39,40,42,42,43,44,44,44,45,45,45,45,45,45
E01016124,EV motorcycles,Number,0,1,1,2,4,5,6,7,9,10,12,13,14,16,17,17,18,19,19,20,20,20,21,21,21,21,21,21,21,21
E01016125,EV motorcycles,Number,0,1,1,2,3,4,5,7,8,9,11,12,13,14,15,16,17,17,18,18,18,18,19,19,19,19,19,19,19,19
E01016126,EV motorcycles,Number,0,1,2,3,5,6,8,10,12,14,16,17,19,21,22,23,24,25,26,26,27,27,27,28,28,28,28,28,28,28
E01016127,EV motorcycles,Number,0,1,2,4,6,7,10,12,14,16,18,21,23,24,26,27,29,30,31,31,32,32,32,33,33,33,33,33,33,33
E01016128,EV motorcycles,Number,1,1,2,4,6,9,11,13,16,19,21,24,26,28,30,32,33,34,35,36,36,37,37,37,38,38,38,38,38,38
E01016129,EV motorcycles,Number,1,1,2,4,6,8,10,12,15,17,20,22,24,26,28,29,30,31,32,33,34,34,34,34,35,35,35,35,35,35
E01016130,EV motorcycles,Number,1,1,3,4,7,9,12,14,17,20,22,25,27,30,32,33,35,36,37,38,38,39,39,39,40,40,40,40,40,40
E01016131,EV motorcycles,Number,1,1,2,4,6,8,10,13,15,18,20,22,25,27,28,30,31,32,33,34,35,35,35,35,36,36,36,36,36,36
E01016132,EV motorcycles,Number,1,2,3,5,8,11,14,17,21,24,27,31,33,36,39,41,43,44,45,46,47,48,48,48,48,49,49,49,49,49
E01016133,EV motorcycles,Number,0,1,2,3,5,7,9,11,13,15,17,19,21,23,24,26,27,28,29,29,30,30,30,31,31,31,31,31,31,31
E01016134,EV motorcycles,Number,1,1,2,4,6,9,11,13,16,19,21,24,26,28,30,32,33,34,35,36,36,37,37,37,38,38,38,38,38,38
E01016135,EV motorcycles,Number,0,1,2,4,6,7,10,12,14,16,18,21,23,24,26,27,29,30,31,31,32,32,32,33,33,33,33,33,33,33
E01016136,EV motorcycles,Number,1,1,2,4,6,8,10,13,15,18,20,22,25,27,28,30,31,32,33,34,35,35,35,35,36,36,36,36,36,36
E01016137,EV motorcycles,Number,0,1,2,3,5,7,8,10,12,14,16,18,20,21,23,24,25,26,27,27,28,28,28,29,29,29,29,29,29,29
E01016138,EV motorcycles,Number,1,1,2,4,6,9,11,13,16,19,21,24,26,28,30,32,33,34,35,36,36,37,37,37,38,38,38,38,38,38
E01016139,EV motorcycles,Number,1,2,3,5,7,10,13,16,19,22,25,27,30,33,35,37,38,40,41,42,42,43,43,43,44,44,44,44,44,44
E01016140,EV motorcycles,Number,0,1,1,2,4,5,6,8,9,11,12,14,15,16,17,18,19,20,20,21,21,21,22,22,22,22,22,22,22,22
E01016141,EV motorcycles,Number,0,1,2,4,5,7,9,11,14,16,18,20,22,24,25,27,28,29,30,30,31,31,31,32,32,32,32,32,32,32
E01016142,EV motorcycles,Number,1,3,5,8,12,16,20,25,30,34,39,44,48,52,55,58,61,63,65,66,67,68,69,69,69,70,70,70,70,70
E01016143,EV motorcycles,Number,1,4,6,11,17,22,29,35,42,49,55,62,68,73,78,82,86,89,92,93,95,96,97,98,98,98,99,99,99,99
E01016144,EV motorcycles,Number,1,2,3,5,8,11,14,17,20,23,26,29,32,35,37,39,41,42,43,44,45,46,46,46,47,47,47,47,47,47
E01016145,EV motorcycles,Number,1,2,3,5,8,11,14,17,21,24,27,31,33,36,39,41,43,44,45,46,47,48,48,48,48,49,49,49,49,49
E01016146,EV motorcycles,Number,1,2,4,6,9,12,16,20,23,27,31,34,38,41,43,46,48,49,51,52,53,53,54,54,54,55,55,55,55,55
E01016147,EV motorcycles,Number,1,3,5,9,14,18,24,29,35,40,46,51,56,61,65,68,71,74,76,77,79,80,80,81,81,81,82,82,82,82
E01016148,EV motorcycles,Number,1,1,3,4,7,9,12,14,17,20,22,25,27,30,32,33,35,36,37,38,38,39,39,39,40,40,40,40,40,40
E01016149,EV motorcycles,Number,1,2,4,7,10,14,18,22,26,30,35,39,42,46,49,52,54,56,57,59,59,60,61,61,61,62,62,62,62,62
E01016150,EV motorcycles,Number,0,1,2,3,5,6,8,10,11,13,15,17,18,20,21,22,23,24,25,25,26,26,26,27,27,27,27,27,27,27
E01016151,EV motorcycles,Number,1,2,3,5,8,10,13,16,19,23,26,29,31,34,36,38,40,41,43,43,44,45,45,45,46,46,46,46,46,46
E01016152,EV motorcycles,Number,1,2,3,6,9,12,15,18,22,26,29,32,36,38,41,43,45,47,48,49,50,50,51,51,51,52,52,52,52,52
E01016153,EV motorcycles,Number,0,1,2,3,4,6,7,9,11,12,14,16,17,18,20,21,22,22,23,24,24,24,24,25,25,25,25,25,25,25
E01016154,EV motorcycles,Number,1,2,3,6,8,11,14,18,21,25,28,31,34,37,39,42,43,45,46,47,48,49,49,49,49,50,50,50,50,50
E01016155,EV motorcycles,Number,1,2,3,5,7,10,12,15,18,21,24,27,29,32,34,36,37,39,40,41,41,42,42,42,43,43,43,43,43,43
E01016156,EV motorcycles,Number,1,2,3,5,8,10,13,16,19,22,25,28,31,33,35,37,39,40,42,42,43,44,44,44,45,45,45,45,45,45
E01016157,EV motorcycles,Number,1,3,5,8,13,17,22,27,33,38,43,48,53,57,61,64,67,69,71,73,74,75,75,76,76,76,77,77,77,77
E01016158,EV motorcycles,Number,1,2,3,6,9,12,15,18,22,26,29,32,36,38,41,43,45,47,48,49,50,50,51,51,51,52,52,52,52,52
E01016159,EV motorcycles,Number,0,1,1,2,4,5,6,8,9,11,12,14,15,16,17,18,19,20,20,21,21,21,22,22,22,22,22,22,22,22
E01016160,EV motorcycles,Number,0,1,2,3,4,5,7,8,10,11,13,14,16,17,18,19,20,21,21,22,22,22,23,23,23,23,23,23,23,23
E01016161,EV motorcycles,Number,0,1,2,3,5,7,9,11,13,15,17,19,21,22,24,25,26,27,28,28,29,29,29,30,30,30,30,30,30,30
E01016162,EV motorcycles,Number,0,1,2,4,6,7,10,12,14,16,18,21,23,24,26,27,29,30,31,31,32,32,32,33,33,33,33,33,33,33
E01016163,EV motorcycles,Number,0,1,2,3,5,6,8,10,12,14,16,17,19,21,22,23,24,25,26,26,27,27,27,28,28,28,28,28,28,28
E01016164,EV motorcycles,Number,0,1,2,4,6,7,10,12,14,16,18,21,23,24,26,27,29,30,31,31,32,32,32,33,33,33,33,33,33,33
E01016165,EV motorcycles,Number,0,1,2,3,4,6,8,9,11,13,15,16,18,19,20,22,23,23,24,25,25,25,25,26,26,26,26,26,26,26
E01016166,EV motorcycles,Number,1,2,3,5,7,9,12,15,18,21,24,26,29,31,33,35,36,38,39,40,40,41,41,41,42,42,42,42,42,42
E01016167,EV motorcycles,Number,1,1,3,5,7,9,12,15,17,20,23,26,28,30,32,34,36,37,38,39,39,40,40,40,41,41,41,41,41,41
E01016168,EV motorcycles,Number,0,1,2,3,5,7,8,10,12,14,16,18,20,21,23,24,25,26,27,27,28,28,28,29,29,29,29,29,29,29
E01016169,EV motorcycles,Number,1,1,2,4,6,8,10,13,15,18,20,22,25,27,28,30,31,32,33,34,35,35,35,35,36,36,36,36,36,36
E01016170,EV motorcycles,Number,0,1,2,4,5,7,9,11,14,16,18,20,22,24,25,27,28,29,30,30,31,31,31,32,32,32,32,32,32,32
E01016171,EV motorcycles,Number,0,1,1,2,4,5,6,8,9,11,12,14,15,16,17,18,19,20,20,21,21,21,22,22,22,22,22,22,22,22
E01016172,EV motorcycles,Number,1,1,2,4,6,8,10,13,15,18,20,22,25,27,28,30,31,32,33,34,35,35,35,35,36,36,36,36,36,36
E01016173,EV motorcycles,Number,1,2,3,5,8,11,14,17,20,23,26,29,32,35,37,39,41,42,43,44,45,46,46,46,47,47,47,47,47,47
E01016174,EV motorcycles,Number,0,1,2,3,5,6,8,10,11,13,15,17,18,20,21,22,23,24,25,25,26,26,26,27,27,27,27,27,27,27
E01016175,EV motorcycles,Number,1,2,3,5,7,10,12,15,18,21,24,27,29,32,34,36,37,39,40,41,41,42,42,42,43,43,43,43,43,43
E01016176,EV motorcycles,Number,0,1,2,3,5,7,9,11,13,15,17,19,21,22,24,25,26,27,28,28,29,29,29,30,30,30,30,30,30,30
E01016177,EV motorcycles,Number,0,1,2,3,4,6,8,9,11,13,15,16,18,19,20,22,23,23,24,25,25,25,25,26,26,26,26,26,26,26
E01016178,EV motorcycles,Number,0,1,1,2,3,4,5,6,7,8,9,10,11,12,13,13,14,14,15,15,15,16,16,16,16,16,16,16,16,16
E01016179,EV motorcycles,Number,1,2,3,5,7,10,13,16,19,22,25,27,30,33,35,37,38,40,41,42,42,43,43,43,44,44,44,44,44,44
E01016734,EV motorcycles,Number,0,0,0,0,0,0,0,0,0,0,0,0,0,0,0,0,0,0,0,0,0,0,0,0,0,0,0,0,0,0
E01016735,EV motorcycles,Number,0,0,0,0,0,0,0,0,0,0,0,0,0,0,0,0,0,0,0,0,0,0,0,0,0,0,0,0,0,0
E01016736,EV motorcycles,Number,0,0,0,0,0,0,0,0,0,0,0,0,0,0,0,0,0,0,0,0,0,0,0,0,0,0,0,0,0,0
E01016800,EV motorcycles,Number,0,0,0,0,0,0,0,0,0,0,0,0,0,0,0,0,0,0,0,0,0,0,0,0,0,0,0,0,0,0
E01016849,EV motorcycles,Number,1,2,3,5,7,10,13,16,19,22,25,27,30,33,35,37,38,40,41,42,42,43,43,43,44,44,44,44,44,44
E01016850,EV motorcycles,Number,1,2,3,6,9,12,15,18,22,26,29,32,36,38,41,43,45,47,48,49,50,50,51,51,51,52,52,52,52,52
E01016851,EV motorcycles,Number,1,2,3,5,7,10,12,15,18,21,24,27,29,32,34,36,37,39,40,41,41,42,42,42,43,43,43,43,43,43
E01016852,EV motorcycles,Number,0,1,2,3,4,5,7,8,10,11,13,14,16,17,18,19,20,21,21,22,22,22,23,23,23,23,23,23,23,23
E01016853,EV motorcycles,Number,0,1,2,3,4,6,8,9,11,13,15,16,18,19,20,22,23,23,24,25,25,25,25,26,26,26,26,26,26,26
E01016854,EV motorcycles,Number,0,1,2,3,4,5,7,9,10,12,13,15,16,18,19,20,21,22,22,23,23,23,23,24,24,24,24,24,24,24
E01016855,EV motorcycles,Number,0,1,2,3,5,6,8,10,11,13,15,17,18,20,21,22,23,24,25,25,26,26,26,27,27,27,27,27,27,27
E01016856,EV motorcycles,Number,0,1,1,2,3,3,4,5,6,7,8,9,10,11,12,12,13,13,14,14,14,15,15,15,15,15,15,15,15,15
E01016857,EV motorcycles,Number,0,1,1,2,4,5,6,8,9,11,12,14,15,16,17,18,19,20,20,21,21,21,22,22,22,22,22,22,22,22
E01016858,EV motorcycles,Number,0,1,1,2,4,5,6,7,9,10,12,13,14,16,17,17,18,19,19,20,20,20,21,21,21,21,21,21,21,21
E01016859,EV motorcycles,Number,0,0,1,1,2,3,3,4,5,6,7,7,8,9,9,10,10,11,11,11,12,12,12,12,12,12,12,12,12,12
E01016860,EV motorcycles,Number,0,1,2,3,5,6,8,10,12,14,16,17,19,21,22,23,24,25,26,26,27,27,27,28,28,28,28,28,28,28
E01016861,EV motorcycles,Number,0,1,2,3,4,6,8,9,11,13,15,16,18,19,20,22,23,23,24,25,25,25,25,26,26,26,26,26,26,26
E01016862,EV motorcycles,Number,0,1,1,2,3,4,5,6,8,9,10,11,12,13,14,15,16,16,17,17,17,17,18,18,18,18,18,18,18,18
E01016863,EV motorcycles,Number,0,1,2,3,4,5,7,9,10,12,13,15,16,18,19,20,21,22,22,23,23,23,23,24,24,24,24,24,24,24
E01016864,EV motorcycles,Number,0,1,2,3,4,5,7,9,10,12,13,15,16,18,19,20,21,22,22,23,23,23,23,24,24,24,24,24,24,24
E01016865,EV motorcycles,Number,0,1,2,3,5,6,8,10,12,14,16,17,19,21,22,23,24,25,26,26,27,27,27,28,28,28,28,28,28,28
E01016866,EV motorcycles,Number,0,1,1,2,3,4,5,6,8,9,10,11,12,13,14,15,16,16,17,17,17,17,18,18,18,18,18,18,18,18
E01016867,EV motorcycles,Number,0,1,2,3,4,5,7,8,10,11,13,14,16,17,18,19,20,21,21,22,22,22,23,23,23,23,23,23,23,23
E01016868,EV motorcycles,Number,0,1,2,3,4,5,7,9,10,12,13,15,16,18,19,20,21,22,22,23,23,23,23,24,24,24,24,24,24,24
E01016869,EV motorcycles,Number,0,1,2,4,5,7,9,11,14,16,18,20,22,24,25,27,28,29,30,30,31,31,31,32,32,32,32,32,32,32
E01016870,EV motorcycles,Number,0,1,2,3,4,6,7,9,11,12,14,16,17,18,20,21,22,22,23,24,24,24,24,25,25,25,25,25,25,25
E01016871,EV motorcycles,Number,0,1,2,4,5,7,9,11,14,16,18,20,22,24,25,27,28,29,30,30,31,31,31,32,32,32,32,32,32,32
E01016872,EV motorcycles,Number,0,1,2,3,5,7,8,10,12,14,16,18,20,21,23,24,25,26,27,27,28,28,28,29,29,29,29,29,29,29
E01016873,EV motorcycles,Number,0,1,2,3,5,7,8,10,12,14,16,18,20,21,23,24,25,26,27,27,28,28,28,29,29,29,29,29,29,29
E01016874,EV motorcycles,Number,0,1,2,3,5,6,8,10,12,14,16,17,19,21,22,23,24,25,26,26,27,27,27,28,28,28,28,28,28,28
E01016875,EV motorcycles,Number,0,0,1,1,2,2,3,4,5,5,6,7,8,8,9,9,10,10,10,10,11,11,11,11,11,11,11,11,11,11
E01016876,EV motorcycles,Number,0,1,2,3,4,5,7,9,10,12,13,15,16,18,19,20,21,22,22,23,23,23,23,24,24,24,24,24,24,24
E01016877,EV motorcycles,Number,0,1,2,3,5,7,9,11,13,15,17,19,21,22,24,25,26,27,28,28,29,29,29,30,30,30,30,30,30,30
E01016878,EV motorcycles,Number,1,1,2,4,6,9,11,13,16,19,21,24,26,28,30,32,33,34,35,36,36,37,37,37,38,38,38,38,38,38
E01016879,EV motorcycles,Number,0,1,2,3,4,6,8,9,11,13,15,16,18,19,20,22,23,23,24,25,25,25,25,26,26,26,26,26,26,26
E01016880,EV motorcycles,Number,0,1,2,3,5,7,9,11,13,15,17,19,21,22,24,25,26,27,28,28,29,29,29,30,30,30,30,30,30,30
E01016881,EV motorcycles,Number,1,2,3,5,7,10,12,15,18,21,24,27,29,32,34,36,37,39,40,41,41,42,42,42,43,43,43,43,43,43
E01016882,EV motorcycles,Number,1,1,3,4,7,9,11,14,16,19,22,24,27,29,31,32,34,35,36,37,37,38,38,38,39,39,39,39,39,39
E01016883,EV motorcycles,Number,1,1,3,4,7,9,11,14,16,19,22,24,27,29,31,32,34,35,36,37,37,38,38,38,39,39,39,39,39,39
E01016884,EV motorcycles,Number,1,2,4,7,11,15,19,23,27,32,36,40,44,48,51,54,56,58,60,61,62,63,64,64,64,65,65,65,65,65
E01016885,EV motorcycles,Number,1,2,3,6,9,11,15,18,22,25,29,32,35,38,40,42,44,46,47,48,49,49,50,50,50,51,51,51,51,51
E01016886,EV motorcycles,Number,1,2,3,5,8,11,14,17,21,24,27,31,33,36,39,41,43,44,45,46,47,48,48,48,48,49,49,49,49,49
E01016887,EV motorcycles,Number,0,1,2,4,5,7,9,11,14,16,18,20,22,24,25,27,28,29,30,30,31,31,31,32,32,32,32,32,32,32
E01016888,EV motorcycles,Number,1,2,4,7,11,15,19,24,28,33,37,42,46,50,53,56,58,60,62,63,64,65,66,66,66,67,67,67,67,67
E01016889,EV motorcycles,Number,0,0,1,1,2,2,3,4,5,5,6,7,8,8,9,9,10,10,10,10,11,11,11,11,11,11,11,11,11,11
E01016890,EV motorcycles,Number,0,1,2,3,5,6,8,10,12,14,16,17,19,21,22,23,24,25,26,26,27,27,27,28,28,28,28,28,28,28
E01016891,EV motorcycles,Number,0,1,2,3,5,6,8,10,12,14,16,17,19,21,22,23,24,25,26,26,27,27,27,28,28,28,28,28,28,28
E01016892,EV motorcycles,Number,0,1,2,3,4,5,7,8,10,11,13,14,16,17,18,19,20,21,21,22,22,22,23,23,23,23,23,23,23,23
E01016893,EV motorcycles,Number,0,1,1,2,3,4,5,6,7,8,9,10,11,12,13,13,14,14,15,15,15,16,16,16,16,16,16,16,16,16
E01016894,EV motorcycles,Number,0,1,1,2,4,5,6,7,9,10,12,13,14,16,17,17,18,19,19,20,20,20,21,21,21,21,21,21,21,21
E01016895,EV motorcycles,Number,0,1,2,3,4,5,7,9,10,12,13,15,16,18,19,20,21,22,22,23,23,23,23,24,24,24,24,24,24,24
E01016896,EV motorcycles,Number,0,1,2,3,4,5,7,8,10,11,13,14,16,17,18,19,20,21,21,22,22,22,23,23,23,23,23,23,23,23
E01016897,EV motorcycles,Number,0,1,1,2,2,3,4,5,6,7,8,9,10,10,11,12,12,13,13,13,13,14,14,14,14,14,14,14,14,14
E01016898,EV motorcycles,Number,1,2,3,6,8,11,14,18,21,25,28,31,34,37,39,42,43,45,46,47,48,49,49,49,49,50,50,50,50,50
E01016899,EV motorcycles,Number,0,1,1,2,4,5,6,7,9,10,12,13,14,16,17,17,18,19,19,20,20,20,21,21,21,21,21,21,21,21
E01016900,EV motorcycles,Number,0,1,2,4,6,7,10,12,14,16,18,21,23,24,26,27,29,30,31,31,32,32,32,33,33,33,33,33,33,33
E01016901,EV motorcycles,Number,0,1,1,2,4,5,6,8,9,11,12,14,15,16,17,18,19,20,20,21,21,21,22,22,22,22,22,22,22,22
E01016902,EV motorcycles,Number,0,1,2,3,5,7,8,10,12,14,16,18,20,21,23,24,25,26,27,27,28,28,28,29,29,29,29,29,29,29
E01016903,EV motorcycles,Number,1,2,3,5,7,9,12,15,18,21,24,26,29,31,33,35,36,38,39,40,40,41,41,41,42,42,42,42,42,42
E01016904,EV motorcycles,Number,0,1,2,3,4,5,7,8,10,11,13,14,16,17,18,19,20,21,21,22,22,22,23,23,23,23,23,23,23,23
E01016905,EV motorcycles,Number,0,1,2,3,5,6,8,10,12,14,16,17,19,21,22,23,24,25,26,26,27,27,27,28,28,28,28,28,28,28
E01016906,EV motorcycles,Number,0,1,2,4,6,8,10,12,14,17,19,21,23,25,27,28,30,31,31,32,33,33,33,33,34,34,34,34,34,34
E01016907,EV motorcycles,Number,0,1,1,2,3,3,4,5,6,7,8,9,10,11,12,12,13,13,14,14,14,15,15,15,15,15,15,15,15,15
E01016908,EV motorcycles,Number,1,1,3,5,7,9,12,15,17,20,23,26,28,30,32,34,36,37,38,39,39,40,40,40,41,41,41,41,41,41
E01016909,EV motorcycles,Number,1,1,3,4,7,9,11,14,16,19,22,24,27,29,31,32,34,35,36,37,37,38,38,38,39,39,39,39,39,39
E01016910,EV motorcycles,Number,0,1,2,3,5,6,8,10,12,14,16,17,19,21,22,23,24,25,26,26,27,27,27,28,28,28,28,28,28,28
E01016911,EV motorcycles,Number,0,1,2,4,5,7,9,11,14,16,18,20,22,24,25,27,28,29,30,30,31,31,31,32,32,32,32,32,32,32
E01016912,EV motorcycles,Number,0,1,2,3,4,5,7,8,10,11,13,14,16,17,18,19,20,21,21,22,22,22,23,23,23,23,23,23,23,23
E01016913,EV motorcycles,Number,0,1,2,3,5,7,9,11,13,15,17,19,21,22,24,25,26,27,28,28,29,29,29,30,30,30,30,30,30,30
E01016914,EV motorcycles,Number,0,1,1,2,4,5,6,8,9,11,12,14,15,16,17,18,19,20,20,21,21,21,22,22,22,22,22,22,22,22
E01016915,EV motorcycles,Number,0,1,2,3,5,7,9,11,13,15,17,19,21,22,24,25,26,27,28,28,29,29,29,30,30,30,30,30,30,30
E01016916,EV motorcycles,Number,1,2,3,6,9,12,15,18,22,26,29,32,36,38,41,43,45,47,48,49,50,50,51,51,51,52,52,52,52,52
E01016917,EV motorcycles,Number,1,1,2,4,6,8,11,13,16,18,21,23,25,27,29,31,32,33,34,35,35,36,36,36,37,37,37,37,37,37
E01016918,EV motorcycles,Number,0,1,2,3,4,6,7,9,11,12,14,16,17,18,20,21,22,22,23,24,24,24,24,25,25,25,25,25,25,25
E01016919,EV motorcycles,Number,1,1,3,4,7,9,12,14,17,20,22,25,27,30,32,33,35,36,37,38,38,39,39,39,40,40,40,40,40,40
E01016920,EV motorcycles,Number,1,1,3,4,7,9,12,14,17,20,22,25,27,30,32,33,35,36,37,38,38,39,39,39,40,40,40,40,40,40
E01016921,EV motorcycles,Number,1,2,3,5,8,11,14,17,20,24,27,30,33,35,38,40,42,43,44,45,46,47,47,47,48,48,48,48,48,48
E01016922,EV motorcycles,Number,0,1,2,3,5,7,9,11,13,15,17,19,21,23,24,26,27,28,29,29,30,30,30,31,31,31,31,31,31,31
E01016923,EV motorcycles,Number,1,1,3,4,7,9,11,14,16,19,22,24,27,29,31,32,34,35,36,37,37,38,38,38,39,39,39,39,39,39
E01016924,EV motorcycles,Number,1,2,4,7,11,15,19,23,28,32,37,41,45,49,52,55,57,59,61,62,63,64,65,65,65,66,66,66,66,66
E01016925,EV motorcycles,Number,0,1,2,3,5,7,8,10,12,14,16,18,20,21,23,24,25,26,27,27,28,28,28,29,29,29,29,29,29,29
E01016926,EV motorcycles,Number,1,2,3,5,7,10,12,15,18,21,24,27,29,32,34,36,37,39,40,41,41,42,42,42,43,43,43,43,43,43
E01016927,EV motorcycles,Number,1,1,2,4,6,8,10,13,15,18,20,22,25,27,28,30,31,32,33,34,35,35,35,35,36,36,36,36,36,36
E01016928,EV motorcycles,Number,0,1,2,3,5,7,9,11,13,15,17,19,21,22,24,25,26,27,28,28,29,29,29,30,30,30,30,30,30,30
E01016929,EV motorcycles,Number,1,2,3,5,8,11,14,17,21,24,27,31,33,36,39,41,43,44,45,46,47,48,48,48,48,49,49,49,49,49
E01016930,EV motorcycles,Number,1,2,3,5,7,10,13,16,19,22,25,27,30,33,35,37,38,40,41,42,42,43,43,43,44,44,44,44,44,44
E01016931,EV motorcycles,Number,1,1,3,4,7,9,12,14,17,20,22,25,27,30,32,33,35,36,37,38,38,39,39,39,40,40,40,40,40,40
E01016932,EV motorcycles,Number,0,1,1,2,3,4,5,6,7,8,10,11,12,13,13,14,15,15,16,16,16,16,17,17,17,17,17,17,17,17
E01016933,EV motorcycles,Number,0,1,2,3,4,5,7,9,10,12,13,15,16,18,19,20,21,22,22,23,23,23,23,24,24,24,24,24,24,24
E01016934,EV motorcycles,Number,0,1,1,2,3,4,5,6,8,9,10,11,12,13,14,15,16,16,17,17,17,17,18,18,18,18,18,18,18,18
E01016935,EV motorcycles,Number,0,1,1,2,4,5,6,8,9,11,12,14,15,16,17,18,19,20,20,21,21,21,22,22,22,22,22,22,22,22
E01016936,EV motorcycles,Number,0,1,1,2,4,5,6,8,9,11,12,14,15,16,17,18,19,20,20,21,21,21,22,22,22,22,22,22,22,22
E01016937,EV motorcycles,Number,1,1,3,4,7,9,12,14,17,20,22,25,27,30,32,33,35,36,37,38,38,39,39,39,40,40,40,40,40,40
E01016938,EV motorcycles,Number,0,1,2,4,6,8,10,12,14,17,19,21,23,25,27,28,30,31,31,32,33,33,33,33,34,34,34,34,34,34
E01016939,EV motorcycles,Number,0,1,1,2,4,5,6,7,9,10,12,13,14,16,17,17,18,19,19,20,20,20,21,21,21,21,21,21,21,21
E01016940,EV motorcycles,Number,0,1,1,2,4,5,6,8,9,11,12,14,15,16,17,18,19,20,20,21,21,21,22,22,22,22,22,22,22,22
E01016941,EV motorcycles,Number,0,1,2,4,6,7,10,12,14,16,18,21,23,24,26,27,29,30,31,31,32,32,32,33,33,33,33,33,33,33
E01016942,EV motorcycles,Number,0,0,1,1,1,2,2,3,3,4,4,5,5,6,6,7,7,7,7,8,8,8,8,8,8,8,8,8,8,8
E01016943,EV motorcycles,Number,0,1,2,3,5,7,9,11,13,15,17,19,21,23,24,26,27,28,29,29,30,30,30,31,31,31,31,31,31,31
E01016944,EV motorcycles,Number,0,1,1,2,4,5,6,7,9,10,12,13,14,16,17,17,18,19,19,20,20,20,21,21,21,21,21,21,21,21
E01016945,EV motorcycles,Number,0,1,2,3,4,5,7,8,10,11,13,14,16,17,18,19,20,21,21,22,22,22,23,23,23,23,23,23,23,23
E01016946,EV motorcycles,Number,0,1,1,2,3,4,5,7,8,9,11,12,13,14,15,16,17,17,18,18,18,18,19,19,19,19,19,19,19,19
E01016947,EV motorcycles,Number,0,1,2,3,4,5,7,8,10,11,13,14,16,17,18,19,20,21,21,22,22,22,23,23,23,23,23,23,23,23
E01016948,EV motorcycles,Number,0,1,2,3,5,7,8,10,12,14,16,18,20,21,23,24,25,26,27,27,28,28,28,29,29,29,29,29,29,29
E01016949,EV motorcycles,Number,0,1,2,3,4,6,8,9,11,13,15,16,18,19,20,22,23,23,24,25,25,25,25,26,26,26,26,26,26,26
E01016950,EV motorcycles,Number,0,1,2,3,5,6,8,10,12,14,16,17,19,21,22,23,24,25,26,26,27,27,27,28,28,28,28,28,28,28
E01016951,EV motorcycles,Number,0,1,2,3,5,6,8,10,11,13,15,17,18,20,21,22,23,24,25,25,26,26,26,27,27,27,27,27,27,27
E01016952,EV motorcycles,Number,0,1,2,3,5,6,8,10,11,13,15,17,18,20,21,22,23,24,25,25,26,26,26,27,27,27,27,27,27,27
E01016953,EV motorcycles,Number,0,1,2,3,4,5,7,8,10,11,13,14,16,17,18,19,20,21,21,22,22,22,23,23,23,23,23,23,23,23
E01016954,EV motorcycles,Number,0,1,2,3,4,6,8,9,11,13,15,16,18,19,20,22,23,23,24,25,25,25,25,26,26,26,26,26,26,26
E01016955,EV motorcycles,Number,1,1,2,4,6,8,11,13,16,18,21,23,25,27,29,31,32,33,34,35,35,36,36,36,37,37,37,37,37,37
E01016956,EV motorcycles,Number,1,2,3,5,8,10,13,16,19,23,26,29,31,34,36,38,40,41,43,43,44,45,45,45,46,46,46,46,46,46
E01016957,EV motorcycles,Number,1,2,3,5,8,11,14,17,20,23,26,29,32,35,37,39,41,42,43,44,45,46,46,46,47,47,47,47,47,47
E01016958,EV motorcycles,Number,1,2,4,6,9,13,16,20,24,28,31,35,38,41,44,47,49,50,52,53,54,54,55,55,55,56,56,56,56,56
E01016959,EV motorcycles,Number,1,2,3,5,7,9,12,15,18,21,24,26,29,31,33,35,36,38,39,40,40,41,41,41,42,42,42,42,42,42
E01016960,EV motorcycles,Number,1,2,3,5,7,10,12,15,18,21,24,27,29,32,34,36,37,39,40,41,41,42,42,42,43,43,43,43,43,43
E01016961,EV motorcycles,Number,1,1,3,4,7,9,12,14,17,20,22,25,27,30,32,33,35,36,37,38,38,39,39,39,40,40,40,40,40,40
E01016962,EV motorcycles,Number,1,1,3,4,7,9,11,14,16,19,22,24,27,29,31,32,34,35,36,37,37,38,38,38,39,39,39,39,39,39
E01016963,EV motorcycles,Number,0,1,1,2,4,5,6,8,9,11,12,14,15,16,17,18,19,20,20,21,21,21,22,22,22,22,22,22,22,22
E01016964,EV motorcycles,Number,0,1,2,4,6,8,10,12,14,17,19,21,23,25,27,28,30,31,31,32,33,33,33,33,34,34,34,34,34,34
E01016966,EV motorcycles,Number,0,1,1,2,4,5,6,7,9,10,12,13,14,16,17,17,18,19,19,20,20,20,21,21,21,21,21,21,21,21
E01016967,EV motorcycles,Number,0,1,2,3,4,5,7,9,10,12,13,15,16,18,19,20,21,22,22,23,23,23,23,24,24,24,24,24,24,24
E01016968,EV motorcycles,Number,0,1,2,4,6,8,10,12,14,17,19,21,23,25,27,28,30,31,31,32,33,33,33,33,34,34,34,34,34,34
E01016969,EV motorcycles,Number,1,1,2,4,6,9,11,13,16,19,21,24,26,28,30,32,33,34,35,36,36,37,37,37,38,38,38,38,38,38
E01016970,EV motorcycles,Number,0,1,1,2,3,4,5,6,7,8,10,11,12,13,13,14,15,15,16,16,16,16,17,17,17,17,17,17,17,17
E01016971,EV motorcycles,Number,0,1,2,3,5,6,8,10,11,13,15,17,18,20,21,22,23,24,25,25,26,26,26,27,27,27,27,27,27,27
E01016972,EV motorcycles,Number,0,1,1,2,3,4,6,7,8,10,11,12,14,15,16,17,17,18,18,19,19,19,20,20,20,20,20,20,20,20
E01016973,EV motorcycles,Number,1,2,3,5,8,11,14,17,20,24,27,30,33,35,38,40,42,43,44,45,46,47,47,47,48,48,48,48,48,48
E01016974,EV motorcycles,Number,1,2,3,6,9,11,15,18,22,25,29,32,35,38,40,42,44,46,47,48,49,49,50,50,50,51,51,51,51,51
E01016975,EV motorcycles,Number,0,1,2,3,4,5,7,9,10,12,13,15,16,18,19,20,21,22,22,23,23,23,23,24,24,24,24,24,24,24
E01016976,EV motorcycles,Number,1,1,3,5,7,9,12,15,17,20,23,26,28,30,32,34,36,37,38,39,39,40,40,40,41,41,41,41,41,41
E01016977,EV motorcycles,Number,1,2,3,5,8,10,13,16,19,23,26,29,31,34,36,38,40,41,43,43,44,45,45,45,46,46,46,46,46,46
E01016978,EV motorcycles,Number,0,1,2,3,5,6,8,10,12,14,16,17,19,21,22,23,24,25,26,26,27,27,27,28,28,28,28,28,28,28
E01016979,EV motorcycles,Number,1,2,3,5,7,10,13,16,19,22,25,27,30,33,35,37,38,40,41,42,42,43,43,43,44,44,44,44,44,44
E01016980,EV motorcycles,Number,0,1,2,4,6,7,10,12,14,16,18,21,23,24,26,27,29,30,31,31,32,32,32,33,33,33,33,33,33,33
E01016981,EV motorcycles,Number,1,2,3,5,8,10,13,16,19,23,26,29,31,34,36,38,40,41,43,43,44,45,45,45,46,46,46,46,46,46
E01016982,EV motorcycles,Number,0,1,2,3,4,6,8,9,11,13,15,16,18,19,20,22,23,23,24,25,25,25,25,26,26,26,26,26,26,26
E01016983,EV motorcycles,Number,1,2,4,6,9,12,16,19,23,27,30,34,37,40,43,45,47,49,50,51,52,52,53,53,53,54,54,54,54,54
E01016984,EV motorcycles,Number,1,1,2,4,6,8,11,13,16,18,21,23,25,27,29,31,32,33,34,35,35,36,36,36,37,37,37,37,37,37
E01016985,EV motorcycles,Number,0,1,2,4,5,7,9,11,14,16,18,20,22,24,25,27,28,29,30,30,31,31,31,32,32,32,32,32,32,32
E01016986,EV motorcycles,Number,1,2,4,7,10,13,17,21,25,30,34,37,41,44,47,50,52,54,55,57,58,58,59,59,59,60,60,60,60,60
E01016987,EV motorcycles,Number,0,1,2,4,5,7,9,11,14,16,18,20,22,24,25,27,28,29,30,30,31,31,31,32,32,32,32,32,32,32
E01016988,EV motorcycles,Number,0,1,1,2,3,4,5,6,7,8,9,10,11,12,13,13,14,14,15,15,15,16,16,16,16,16,16,16,16,16
E01016989,EV motorcycles,Number,0,1,1,2,4,5,6,8,9,11,12,14,15,16,17,18,19,20,20,21,21,21,22,22,22,22,22,22,22,22
E01016990,EV motorcycles,Number,0,1,1,2,3,4,5,6,7,8,9,10,11,12,13,13,14,14,15,15,15,16,16,16,16,16,16,16,16,16
E01016991,EV motorcycles,Number,1,1,2,4,6,8,10,12,15,17,20,22,24,26,28,29,30,31,32,33,34,34,34,34,35,35,35,35,35,35
E01016992,EV motorcycles,Number,0,1,2,4,6,8,10,12,14,17,19,21,23,25,27,28,30,31,31,32,33,33,33,33,34,34,34,34,34,34
E01016993,EV motorcycles,Number,0,1,2,3,4,6,7,9,11,12,14,16,17,18,20,21,22,22,23,24,24,24,24,25,25,25,25,25,25,25
E01016994,EV motorcycles,Number,0,1,2,3,4,6,8,9,11,13,15,16,18,19,20,22,23,23,24,25,25,25,25,26,26,26,26,26,26,26
E01016995,EV motorcycles,Number,0,1,2,3,5,7,9,11,13,15,17,19,21,23,24,26,27,28,29,29,30,30,30,31,31,31,31,31,31,31
E01016996,EV motorcycles,Number,0,1,1,2,3,4,6,7,8,10,11,12,14,15,16,17,17,18,18,19,19,19,20,20,20,20,20,20,20,20
E01016997,EV motorcycles,Number,0,1,2,3,4,6,8,9,11,13,15,16,18,19,20,22,23,23,24,25,25,25,25,26,26,26,26,26,26,26
E01016998,EV motorcycles,Number,1,2,4,6,9,12,16,19,23,27,30,34,37,40,43,45,47,49,50,51,52,52,53,53,53,54,54,54,54,54
E01016999,EV motorcycles,Number,1,2,3,6,9,12,15,18,22,26,29,32,36,38,41,43,45,47,48,49,50,50,51,51,51,52,52,52,52,52
E01017000,EV motorcycles,Number,1,2,3,6,9,11,15,18,22,25,29,32,35,38,40,42,44,46,47,48,49,49,50,50,50,51,51,51,51,51
E01017001,EV motorcycles,Number,1,1,2,4,6,8,11,13,16,18,21,23,25,27,29,31,32,33,34,35,35,36,36,36,37,37,37,37,37,37
E01017002,EV motorcycles,Number,1,2,3,6,9,11,15,18,22,25,29,32,35,38,40,42,44,46,47,48,49,49,50,50,50,51,51,51,51,51
E01017003,EV motorcycles,Number,0,1,1,2,3,4,5,6,7,8,10,11,12,13,13,14,15,15,16,16,16,16,17,17,17,17,17,17,17,17
E01017004,EV motorcycles,Number,0,1,2,3,5,7,8,10,12,14,16,18,20,21,23,24,25,26,27,27,28,28,28,29,29,29,29,29,29,29
E01017005,EV motorcycles,Number,0,1,2,3,5,6,8,10,11,13,15,17,18,20,21,22,23,24,25,25,26,26,26,27,27,27,27,27,27,27
E01017006,EV motorcycles,Number,0,1,1,2,4,5,6,7,9,10,12,13,14,16,17,17,18,19,19,20,20,20,21,21,21,21,21,21,21,21
E01017007,EV motorcycles,Number,1,2,3,5,8,11,14,17,21,24,27,31,33,36,39,41,43,44,45,46,47,48,48,48,48,49,49,49,49,49
E01017008,EV motorcycles,Number,1,2,3,6,8,11,14,18,21,25,28,31,34,37,39,42,43,45,46,47,48,49,49,49,49,50,50,50,50,50
E01017009,EV motorcycles,Number,1,1,3,4,7,9,11,14,16,19,22,24,27,29,31,32,34,35,36,37,37,38,38,38,39,39,39,39,39,39
E01017010,EV motorcycles,Number,1,2,3,6,9,11,15,18,22,25,29,32,35,38,40,42,44,46,47,48,49,49,50,50,50,51,51,51,51,51
E01017011,EV motorcycles,Number,0,1,2,3,5,6,8,10,11,13,15,17,18,20,21,22,23,24,25,25,26,26,26,27,27,27,27,27,27,27
E01017012,EV motorcycles,Number,1,2,3,5,8,11,14,17,20,24,27,30,33,35,38,40,42,43,44,45,46,47,47,47,48,48,48,48,48,48
E01017371,EV motorcycles,Number,1,2,3,5,8,11,14,17,20,23,26,29,32,35,37,39,41,42,43,44,45,46,46,46,47,47,47,47,47,47
E01017372,EV motorcycles,Number,1,2,3,5,7,9,12,15,18,21,24,26,29,31,33,35,36,38,39,40,40,41,41,41,42,42,42,42,42,42
E01017373,EV motorcycles,Number,1,2,4,6,9,12,16,20,23,27,31,34,38,41,43,46,48,49,51,52,53,53,54,54,54,55,55,55,55,55
E01017374,EV motorcycles,Number,0,1,2,3,5,7,9,11,13,15,17,19,21,22,24,25,26,27,28,28,29,29,29,30,30,30,30,30,30,30
E01017375,EV motorcycles,Number,0,1,2,3,4,5,7,9,10,12,13,15,16,18,19,20,21,22,22,23,23,23,23,24,24,24,24,24,24,24
E01017376,EV motorcycles,Number,1,3,5,9,13,18,23,28,34,39,45,50,55,59,63,67,70,72,74,76,77,78,78,79,79,79,80,80,80,80
E01017377,EV motorcycles,Number,1,2,3,6,9,12,15,18,22,26,29,32,36,38,41,43,45,47,48,49,50,50,51,51,51,52,52,52,52,52
E01017378,EV motorcycles,Number,1,2,4,7,11,14,18,22,27,31,35,39,43,47,50,52,55,57,58,59,60,61,62,62,62,63,63,63,63,63
E01017379,EV motorcycles,Number,0,1,2,3,4,6,7,9,11,13,14,16,17,19,20,21,22,23,24,24,24,25,25,25,25,25,25,25,25,25
E01017380,EV motorcycles,Number,0,1,1,2,3,4,6,7,8,10,11,12,14,15,16,17,17,18,18,19,19,19,20,20,20,20,20,20,20,20
E01017381,EV motorcycles,Number,1,1,3,4,7,9,11,14,16,19,22,24,27,29,31,32,34,35,36,37,37,38,38,38,39,39,39,39,39,39
E01017382,EV motorcycles,Number,0,1,2,4,5,7,9,11,14,16,18,20,22,24,25,27,28,29,30,30,31,31,31,32,32,32,32,32,32,32
E01017383,EV motorcycles,Number,0,1,2,4,5,7,9,11,14,16,18,20,22,24,25,27,28,29,30,30,31,31,31,32,32,32,32,32,32,32
E01017384,EV motorcycles,Number,0,1,2,3,5,7,9,11,13,15,17,19,21,23,24,26,27,28,29,29,30,30,30,31,31,31,31,31,31,31
E01017385,EV motorcycles,Number,0,1,2,3,5,7,9,11,13,15,17,19,21,23,24,26,27,28,29,29,30,30,30,31,31,31,31,31,31,31
E01017386,EV motorcycles,Number,1,2,3,5,7,10,12,15,18,21,24,27,29,32,34,36,37,39,40,41,41,42,42,42,43,43,43,43,43,43
E01017387,EV motorcycles,Number,1,1,2,4,6,8,10,12,15,17,20,22,24,26,28,29,30,31,32,33,34,34,34,34,35,35,35,35,35,35
E01017388,EV motorcycles,Number,1,2,3,5,8,10,13,16,19,23,26,29,31,34,36,38,40,41,43,43,44,45,45,45,46,46,46,46,46,46
E01017389,EV motorcycles,Number,1,3,5,8,12,16,21,26,30,35,40,45,49,53,57,60,63,65,67,68,69,70,70,71,71,71,72,72,72,72
E01017390,EV motorcycles,Number,1,3,5,9,13,18,23,28,34,39,45,50,55,59,63,67,70,72,74,76,77,78,78,79,79,79,80,80,80,80
E01017391,EV motorcycles,Number,0,1,2,3,5,7,9,11,13,15,17,19,21,22,24,25,26,27,28,28,29,29,29,30,30,30,30,30,30,30
E01017392,EV motorcycles,Number,1,2,4,7,10,14,18,22,26,30,35,39,42,46,49,52,54,56,57,59,59,60,61,61,61,62,62,62,62,62
E01017393,EV motorcycles,Number,2,4,7,12,18,24,32,39,46,54,61,68,75,81,86,91,95,98,101,103,105,106,107,107,108,108,109,109,109,109
E01017394,EV motorcycles,Number,1,2,4,6,10,13,17,21,25,29,32,36,40,43,46,48,50,52,54,55,56,56,57,57,57,58,58,58,58,58
E01017397,EV motorcycles,Number,1,3,5,8,12,16,21,26,31,36,41,45,50,54,58,61,63,66,67,69,70,71,71,72,72,72,73,73,73,73
E01017398,EV motorcycles,Number,2,4,7,13,19,26,33,40,48,56,64,71,78,84,90,95,99,103,105,108,109,111,112,112,113,113,114,114,114,114
E01017399,EV motorcycles,Number,0,1,2,3,5,6,8,10,11,13,15,17,18,20,21,22,23,24,25,25,26,26,26,27,27,27,27,27,27,27
E01017400,EV motorcycles,Number,1,1,2,4,6,8,10,13,15,18,20,22,25,27,28,30,31,32,33,34,35,35,35,35,36,36,36,36,36,36
E01017401,EV motorcycles,Number,0,1,1,2,3,3,4,5,6,7,8,9,10,11,12,12,13,13,14,14,14,15,15,15,15,15,15,15,15,15
E01017402,EV motorcycles,Number,1,2,3,6,9,12,15,18,22,26,29,32,36,38,41,43,45,47,48,49,50,50,51,51,51,52,52,52,52,52
E01017403,EV motorcycles,Number,1,2,3,5,8,11,14,17,21,24,27,31,33,36,39,41,43,44,45,46,47,48,48,48,48,49,49,49,49,49
E01017404,EV motorcycles,Number,1,2,3,5,8,10,13,16,19,22,25,28,31,33,35,37,39,40,42,42,43,44,44,44,45,45,45,45,45,45
E01017405,EV motorcycles,Number,1,2,3,5,8,11,14,17,20,23,26,29,32,35,37,39,41,42,43,44,45,46,46,46,47,47,47,47,47,47
E01017406,EV motorcycles,Number,1,3,5,8,12,16,20,25,30,34,39,44,48,52,55,58,61,63,65,66,67,68,69,69,69,70,70,70,70,70
E01017407,EV motorcycles,Number,1,2,3,5,7,9,12,15,18,21,24,26,29,31,33,35,36,38,39,40,40,41,41,41,42,42,42,42,42,42
E01017408,EV motorcycles,Number,0,1,2,3,5,7,9,11,13,15,17,19,21,22,24,25,26,27,28,28,29,29,29,30,30,30,30,30,30,30
E01017409,EV motorcycles,Number,0,1,2,4,6,7,10,12,14,16,18,21,23,24,26,27,29,30,31,31,32,32,32,33,33,33,33,33,33,33
E01017410,EV motorcycles,Number,0,1,2,4,6,8,10,12,14,17,19,21,23,25,27,28,30,31,31,32,33,33,33,33,34,34,34,34,34,34
E01017411,EV motorcycles,Number,1,3,5,9,14,18,24,29,35,40,46,51,56,61,65,68,71,74,76,77,79,80,80,81,81,81,82,82,82,82
E01017412,EV motorcycles,Number,1,3,5,8,13,17,22,27,33,38,43,48,53,57,61,64,67,69,71,73,74,75,75,76,76,76,77,77,77,77
E01017413,EV motorcycles,Number,1,2,3,6,9,11,15,18,22,25,29,32,35,38,40,42,44,46,47,48,49,49,50,50,50,51,51,51,51,51
E01017414,EV motorcycles,Number,1,2,4,7,10,14,18,22,26,30,35,39,42,46,49,52,54,56,57,59,59,60,61,61,61,62,62,62,62,62
E01017415,EV motorcycles,Number,1,3,5,8,13,17,22,27,32,37,42,47,51,55,59,62,65,67,69,71,72,73,73,74,74,74,75,75,75,75
E01017416,EV motorcycles,Number,1,4,6,11,17,22,29,35,42,49,55,62,68,73,78,82,86,89,92,93,95,96,97,98,98,98,99,99,99,99
E01017417,EV motorcycles,Number,1,4,6,11,16,22,28,34,41,48,54,60,66,72,76,81,84,87,90,92,93,94,95,96,96,96,97,97,97,97
E01017418,EV motorcycles,Number,1,1,2,4,6,8,11,13,16,18,21,23,25,27,29,31,32,33,34,35,35,36,36,36,37,37,37,37,37,37
E01017419,EV motorcycles,Number,1,2,3,6,8,11,14,18,21,25,28,31,34,37,39,42,43,45,46,47,48,49,49,49,49,50,50,50,50,50
E01017420,EV motorcycles,Number,1,1,2,4,6,8,10,13,15,18,20,22,25,27,28,30,31,32,33,34,35,35,35,35,36,36,36,36,36,36
E01017421,EV motorcycles,Number,1,2,4,6,10,13,16,20,24,28,32,35,39,42,45,47,50,51,53,54,55,55,56,56,56,57,57,57,57,57
E01017422,EV motorcycles,Number,1,2,4,7,11,14,18,22,27,31,35,39,43,47,50,52,55,57,58,59,60,61,62,62,62,63,63,63,63,63
E01017423,EV motorcycles,Number,1,2,3,5,8,11,14,17,21,24,27,31,33,36,39,41,43,44,45,46,47,48,48,48,48,49,49,49,49,49
E01017424,EV motorcycles,Number,1,2,3,5,8,10,13,16,19,23,26,29,31,34,36,38,40,41,43,43,44,45,45,45,46,46,46,46,46,46
E01017425,EV motorcycles,Number,1,2,3,6,9,12,15,18,22,26,29,32,36,38,41,43,45,47,48,49,50,50,51,51,51,52,52,52,52,52
E01017426,EV motorcycles,Number,1,2,4,7,10,14,18,22,26,30,34,38,42,45,48,51,53,55,56,58,58,59,60,60,60,61,61,61,61,61
E01017427,EV motorcycles,Number,1,3,6,9,14,19,25,30,36,42,48,53,58,63,67,71,74,76,79,80,82,82,83,84,84,84,85,85,85,85
E01017428,EV motorcycles,Number,1,3,5,8,12,16,21,25,30,35,40,44,49,52,56,59,62,64,66,67,68,69,70,70,70,71,71,71,71,71
E01017429,EV motorcycles,Number,1,2,3,6,8,11,14,18,21,25,28,31,34,37,39,42,43,45,46,47,48,49,49,49,49,50,50,50,50,50
E01017430,EV motorcycles,Number,1,2,3,5,7,9,12,15,18,21,24,26,29,31,33,35,36,38,39,40,40,41,41,41,42,42,42,42,42,42
E01017431,EV motorcycles,Number,1,1,2,4,6,8,11,13,16,18,21,23,25,27,29,31,32,33,34,35,35,36,36,36,37,37,37,37,37,37
E01017432,EV motorcycles,Number,0,1,2,3,4,6,7,9,11,12,14,16,17,18,20,21,22,22,23,24,24,24,24,25,25,25,25,25,25,25
E01017433,EV motorcycles,Number,0,1,2,3,4,5,7,8,10,11,13,14,16,17,18,19,20,21,21,22,22,22,23,23,23,23,23,23,23,23
E01017434,EV motorcycles,Number,0,1,2,3,5,7,8,10,12,14,16,18,20,21,23,24,25,26,27,27,28,28,28,29,29,29,29,29,29,29
E01017435,EV motorcycles,Number,1,2,3,5,7,10,13,16,19,22,25,27,30,33,35,37,38,40,41,42,42,43,43,43,44,44,44,44,44,44
E01017436,EV motorcycles,Number,1,3,5,8,12,16,20,25,30,34,39,44,48,52,55,58,61,63,65,66,67,68,69,69,69,70,70,70,70,70
E01017437,EV motorcycles,Number,1,2,4,7,11,15,20,24,29,33,38,42,46,50,54,57,59,61,63,64,65,66,67,67,67,68,68,68,68,68
E01017438,EV motorcycles,Number,1,2,3,6,8,11,14,18,21,25,28,31,34,37,39,42,43,45,46,47,48,49,49,49,49,50,50,50,50,50
E01017439,EV motorcycles,Number,1,2,3,5,8,10,13,16,19,23,26,29,31,34,36,38,40,41,43,43,44,45,45,45,46,46,46,46,46,46
E01017440,EV motorcycles,Number,1,2,3,5,8,11,14,17,20,23,26,29,32,35,37,39,41,42,43,44,45,46,46,46,47,47,47,47,47,47
E01017441,EV motorcycles,Number,1,3,5,8,12,16,21,26,31,36,41,45,50,54,58,61,63,66,67,69,70,71,71,72,72,72,73,73,73,73
E01017442,EV motorcycles,Number,1,3,6,9,14,19,25,31,36,42,48,54,59,64,68,72,75,77,79,81,82,83,84,85,85,85,86,86,86,86
E01017443,EV motorcycles,Number,1,2,4,7,11,14,18,22,27,31,35,39,43,47,50,52,55,57,58,59,60,61,62,62,62,63,63,63,63,63
E01017444,EV motorcycles,Number,1,3,5,8,12,16,21,26,30,35,40,45,49,53,57,60,63,65,67,68,69,70,70,71,71,71,72,72,72,72
E01017445,EV motorcycles,Number,1,2,4,7,10,13,17,21,25,29,33,37,40,44,47,49,51,53,55,56,57,57,58,58,58,59,59,59,59,59
E01017446,EV motorcycles,Number,1,3,5,8,12,16,20,25,30,34,39,44,48,52,55,58,61,63,65,66,67,68,69,69,69,70,70,70,70,70
E01017447,EV motorcycles,Number,1,2,4,7,11,14,18,22,27,31,35,39,43,47,50,52,55,57,58,59,60,61,62,62,62,63,63,63,63,63
E01017449,EV motorcycles,Number,1,2,4,7,10,14,18,22,26,30,35,39,42,46,49,52,54,56,57,59,59,60,61,61,61,62,62,62,62,62
E01017450,EV motorcycles,Number,1,2,4,7,11,14,18,22,27,31,35,39,43,47,50,52,55,57,58,59,60,61,62,62,62,63,63,63,63,63
E01017451,EV motorcycles,Number,1,2,4,7,11,14,18,22,27,31,35,39,43,47,50,52,55,57,58,59,60,61,62,62,62,63,63,63,63,63
E01017452,EV motorcycles,Number,0,1,1,2,3,4,5,7,8,9,11,12,13,14,15,16,17,17,18,18,18,18,19,19,19,19,19,19,19,19
E01017453,EV motorcycles,Number,0,0,1,1,2,2,3,4,4,5,6,6,7,7,8,8,9,9,9,9,10,10,10,10,10,10,10,10,10,10
E01017454,EV motorcycles,Number,0,1,1,2,3,4,6,7,8,10,11,12,14,15,16,17,17,18,18,19,19,19,20,20,20,20,20,20,20,20
E01017455,EV motorcycles,Number,1,1,2,4,6,8,10,12,15,17,20,22,24,26,28,29,30,31,32,33,34,34,34,34,35,35,35,35,35,35
E01017456,EV motorcycles,Number,0,1,2,4,6,8,10,12,14,17,19,21,23,25,27,28,30,31,31,32,33,33,33,33,34,34,34,34,34,34
E01017457,EV motorcycles,Number,0,0,1,1,2,2,3,4,4,5,6,6,7,7,8,8,9,9,9,9,10,10,10,10,10,10,10,10,10,10
E01017458,EV motorcycles,Number,0,1,2,3,5,7,9,11,13,15,17,19,21,22,24,25,26,27,28,28,29,29,29,30,30,30,30,30,30,30
E01017459,EV motorcycles,Number,1,2,3,5,7,10,12,15,18,21,24,27,29,32,34,36,37,39,40,41,41,42,42,42,43,43,43,43,43,43
E01017460,EV motorcycles,Number,1,1,3,5,7,9,12,15,17,20,23,26,28,30,32,34,36,37,38,39,39,40,40,40,41,41,41,41,41,41
E01017461,EV motorcycles,Number,1,3,5,9,13,18,23,28,34,39,45,50,55,59,63,67,70,72,74,76,77,78,78,79,79,79,80,80,80,80
E01017462,EV motorcycles,Number,0,1,2,3,5,7,9,11,13,15,17,19,21,23,24,26,27,28,29,29,30,30,30,31,31,31,31,31,31,31
E01017463,EV motorcycles,Number,1,2,3,5,7,10,13,16,19,22,25,27,30,33,35,37,38,40,41,42,42,43,43,43,44,44,44,44,44,44
E01017464,EV motorcycles,Number,1,2,3,6,9,12,15,18,22,26,29,32,36,38,41,43,45,47,48,49,50,51,51,51,52,52,52,52,52,52
E01017465,EV motorcycles,Number,1,3,5,8,12,16,21,25,30,35,40,44,49,52,56,59,62,64,66,67,68,69,70,70,70,71,71,71,71,71
E01017466,EV motorcycles,Number,0,1,1,2,2,3,4,5,6,7,8,9,10,10,11,12,12,13,13,13,13,14,14,14,14,14,14,14,14,14
E01017467,EV motorcycles,Number,0,0,1,1,2,3,3,4,5,6,7,7,8,9,9,10,10,11,11,11,12,12,12,12,12,12,12,12,12,12
E01017468,EV motorcycles,Number,0,1,1,2,3,4,5,6,7,8,9,10,11,12,13,13,14,14,15,15,15,16,16,16,16,16,16,16,16,16
E01017469,EV motorcycles,Number,0,1,2,3,5,6,8,10,11,13,15,17,18,20,21,22,23,24,25,25,26,26,26,27,27,27,27,27,27,27
E01017470,EV motorcycles,Number,0,0,1,1,2,3,4,5,5,6,7,8,9,10,10,11,11,12,12,12,12,13,13,13,13,13,13,13,13,13
E01017471,EV motorcycles,Number,0,0,1,1,2,3,4,5,5,6,7,8,9,10,10,11,11,12,12,12,12,13,13,13,13,13,13,13,13,13
E01017472,EV motorcycles,Number,0,0,1,1,2,3,4,5,5,6,7,8,9,10,10,11,11,12,12,12,12,13,13,13,13,13,13,13,13,13
E01017473,EV motorcycles,Number,1,1,2,4,6,8,10,12,15,17,20,22,24,26,28,29,30,31,32,33,34,34,34,34,35,35,35,35,35,35
E01017474,EV motorcycles,Number,0,1,1,2,3,3,4,5,6,7,8,9,10,11,12,12,13,13,14,14,14,15,15,15,15,15,15,15,15,15
E01017475,EV motorcycles,Number,0,0,1,1,2,2,3,4,4,5,6,6,7,7,8,8,9,9,9,9,10,10,10,10,10,10,10,10,10,10
E01017476,EV motorcycles,Number,0,1,1,2,3,4,6,7,8,10,11,12,14,15,16,17,17,18,18,19,19,19,20,20,20,20,20,20,20,20
E01017477,EV motorcycles,Number,0,1,1,2,3,4,6,7,8,10,11,12,14,15,16,17,17,18,18,19,19,19,20,20,20,20,20,20,20,20
E01017478,EV motorcycles,Number,1,2,3,6,9,12,15,18,22,25,29,32,35,38,41,43,45,46,48,49,49,50,51,51,51,51,52,52,52,52
E01017479,EV motorcycles,Number,0,1,2,3,5,7,8,10,12,14,16,18,20,21,23,24,25,26,27,27,28,28,28,29,29,29,29,29,29,29
E01017480,EV motorcycles,Number,1,2,3,5,8,10,13,16,19,22,25,28,31,33,35,37,39,40,42,42,43,44,44,44,45,45,45,45,45,45
E01017481,EV motorcycles,Number,1,2,3,5,7,10,12,15,18,21,24,27,29,32,34,36,37,39,40,41,41,42,42,42,43,43,43,43,43,43
E01017482,EV motorcycles,Number,0,1,1,2,4,5,6,7,9,10,12,13,14,16,17,17,18,19,19,20,20,20,21,21,21,21,21,21,21,21
E01017483,EV motorcycles,Number,0,1,2,3,4,6,8,9,11,13,15,16,18,19,20,22,23,23,24,25,25,25,25,26,26,26,26,26,26,26
E01017484,EV motorcycles,Number,0,0,1,1,2,3,4,5,5,6,7,8,9,10,10,11,11,12,12,12,12,13,13,13,13,13,13,13,13,13
E01017485,EV motorcycles,Number,0,1,1,2,4,5,6,7,9,10,12,13,14,16,17,17,18,19,19,20,20,20,21,21,21,21,21,21,21,21
E01017486,EV motorcycles,Number,1,3,5,8,12,16,21,25,30,35,40,44,49,52,56,59,62,64,66,67,68,69,70,70,70,71,71,71,71,71
E01017487,EV motorcycles,Number,1,2,4,7,11,15,19,23,27,32,36,40,44,48,51,54,56,58,60,61,62,63,64,64,64,65,65,65,65,65
E01017488,EV motorcycles,Number,0,1,2,3,4,6,7,9,11,12,14,16,17,18,20,21,22,22,23,24,24,24,24,25,25,25,25,25,25,25
E01017489,EV motorcycles,Number,0,1,1,2,4,5,6,7,9,10,12,13,14,16,17,17,18,19,19,20,20,20,21,21,21,21,21,21,21,21
E01017490,EV motorcycles,Number,0,1,1,2,3,3,4,5,6,7,8,9,10,11,12,12,13,13,14,14,14,15,15,15,15,15,15,15,15,15
E01017491,EV motorcycles,Number,0,1,1,2,2,3,4,5,6,7,8,9,10,10,11,12,12,13,13,13,13,14,14,14,14,14,14,14,14,14
E01017492,EV motorcycles,Number,0,1,2,4,5,7,9,11,14,16,18,20,22,24,25,27,28,29,30,30,31,31,31,32,32,32,32,32,32,32
E01017493,EV motorcycles,Number,1,1,3,4,7,9,11,14,16,19,22,24,27,29,31,32,34,35,36,37,37,38,38,38,39,39,39,39,39,39
E01017495,EV motorcycles,Number,1,2,4,7,11,15,20,24,29,33,38,42,46,50,54,57,59,61,63,64,65,66,67,67,67,68,68,68,68,68
E01017496,EV motorcycles,Number,1,2,3,6,9,12,15,18,22,26,29,32,36,38,41,43,45,47,48,49,50,50,51,51,51,52,52,52,52,52
E01017497,EV motorcycles,Number,0,1,1,2,3,3,4,5,6,7,8,9,10,11,12,12,13,13,14,14,14,15,15,15,15,15,15,15,15,15
E01017498,EV motorcycles,Number,0,1,1,2,3,3,4,5,6,7,8,9,10,11,12,12,13,13,14,14,14,15,15,15,15,15,15,15,15,15
E01017499,EV motorcycles,Number,0,1,1,2,3,4,5,7,8,9,11,12,13,14,15,16,17,17,18,18,18,18,19,19,19,19,19,19,19,19
E01017500,EV motorcycles,Number,0,1,1,2,3,4,5,6,7,8,9,10,11,12,13,13,14,14,15,15,15,16,16,16,16,16,16,16,16,16
E01017501,EV motorcycles,Number,0,0,1,1,2,2,3,4,5,5,6,7,8,8,9,9,10,10,10,10,11,11,11,11,11,11,11,11,11,11
E01017502,EV motorcycles,Number,0,0,1,1,2,3,4,5,5,6,7,8,9,10,10,11,11,12,12,12,12,13,13,13,13,13,13,13,13,13
E01017504,EV motorcycles,Number,0,0,0,0,0,0,0,0,0,0,0,0,0,0,0,0,0,0,0,0,0,0,0,0,0,0,0,0,0,0
E01017505,EV motorcycles,Number,0,1,2,3,4,5,7,9,10,12,13,15,16,18,19,20,21,22,22,23,23,23,23,24,24,24,24,24,24,24
E01017506,EV motorcycles,Number,0,1,2,3,4,6,7,9,11,12,14,16,17,18,20,21,22,22,23,24,24,24,24,25,25,25,25,25,25,25
E01017507,EV motorcycles,Number,0,1,2,3,5,7,9,11,13,15,17,19,21,22,24,25,26,27,28,28,29,29,29,30,30,30,30,30,30,30
E01017508,EV motorcycles,Number,0,1,1,2,3,4,5,6,8,9,10,11,12,13,14,15,16,16,17,17,17,17,18,18,18,18,18,18,18,18
E01017509,EV motorcycles,Number,0,1,1,2,2,3,4,5,6,7,8,9,10,10,11,12,12,13,13,13,13,14,14,14,14,14,14,14,14,14
E01017510,EV motorcycles,Number,1,1,2,4,6,9,11,13,16,19,21,24,26,28,30,32,33,34,35,36,36,37,37,37,38,38,38,38,38,38
E01017511,EV motorcycles,Number,0,1,2,4,6,7,10,12,14,16,18,21,23,24,26,27,29,30,31,31,32,32,32,33,33,33,33,33,33,33
E01017512,EV motorcycles,Number,0,1,2,3,4,6,8,9,11,13,15,16,18,19,20,22,23,23,24,25,25,25,25,26,26,26,26,26,26,26
E01017513,EV motorcycles,Number,0,1,2,3,4,6,7,9,11,12,14,16,17,18,20,21,22,22,23,24,24,24,24,25,25,25,25,25,25,25
E01017514,EV motorcycles,Number,0,1,2,3,4,6,7,9,11,12,14,16,17,18,20,21,22,22,23,24,24,24,24,25,25,25,25,25,25,25
E01017515,EV motorcycles,Number,0,1,2,4,6,7,10,12,14,16,18,21,23,24,26,27,29,30,31,31,32,32,32,33,33,33,33,33,33,33
E01017516,EV motorcycles,Number,1,2,4,7,10,14,18,22,26,30,34,38,42,45,48,51,53,55,56,58,58,59,60,60,60,61,61,61,61,61
E01017517,EV motorcycles,Number,1,2,3,5,8,10,13,16,19,22,25,28,31,33,35,37,39,40,42,42,43,44,44,44,45,45,45,45,45,45
E01017518,EV motorcycles,Number,0,1,2,4,5,7,9,11,14,16,18,20,22,24,25,27,28,29,30,30,31,31,31,32,32,32,32,32,32,32
E01017519,EV motorcycles,Number,0,1,2,3,5,6,8,10,11,13,15,17,18,20,21,22,23,24,25,25,26,26,26,27,27,27,27,27,27,27
E01017520,EV motorcycles,Number,0,1,2,3,5,6,8,10,11,13,15,17,18,20,21,22,23,24,25,25,26,26,26,27,27,27,27,27,27,27
E01017521,EV motorcycles,Number,0,1,2,4,6,8,10,12,14,17,19,21,23,25,27,28,30,31,31,32,33,33,33,33,34,34,34,34,34,34
E01017522,EV motorcycles,Number,0,1,2,3,4,6,7,9,11,12,14,16,17,18,20,21,22,22,23,24,24,24,24,25,25,25,25,25,25,25
E01017523,EV motorcycles,Number,0,0,1,1,2,2,3,3,4,4,5,6,6,7,7,7,8,8,8,8,9,9,9,9,9,9,9,9,9,9
E01017524,EV motorcycles,Number,0,1,2,3,5,6,8,10,11,13,15,17,18,20,21,22,23,24,25,25,26,26,26,27,27,27,27,27,27,27
E01017525,EV motorcycles,Number,0,1,1,2,4,5,6,8,9,11,12,14,15,16,17,18,19,20,20,21,21,21,22,22,22,22,22,22,22,22
E01017526,EV motorcycles,Number,0,1,1,2,4,5,6,8,9,11,12,14,15,16,17,18,19,20,20,21,21,21,22,22,22,22,22,22,22,22
E01017527,EV motorcycles,Number,0,1,2,4,6,7,10,12,14,16,18,21,23,24,26,27,29,30,31,31,32,32,32,33,33,33,33,33,33,33
E01017528,EV motorcycles,Number,1,2,4,7,11,15,20,24,29,33,38,42,46,50,54,57,59,61,63,64,65,66,67,67,67,68,68,68,68,68
E01017529,EV motorcycles,Number,0,1,1,2,3,4,5,6,7,8,10,11,12,13,13,14,15,15,16,16,16,16,17,17,17,17,17,17,17,17
E01017530,EV motorcycles,Number,0,1,2,3,4,5,7,8,10,11,13,14,16,17,18,19,20,21,21,22,22,22,23,23,23,23,23,23,23,23
E01017531,EV motorcycles,Number,0,1,1,2,3,4,5,6,7,8,10,11,12,13,13,14,15,15,16,16,16,16,17,17,17,17,17,17,17,17
E01017532,EV motorcycles,Number,1,1,2,4,6,8,11,13,16,18,21,23,25,27,29,31,32,33,34,35,35,36,36,36,37,37,37,37,37,37
E01017533,EV motorcycles,Number,0,0,1,1,2,2,3,3,4,4,5,6,6,7,7,7,8,8,8,8,9,9,9,9,9,9,9,9,9,9
E01017534,EV motorcycles,Number,0,1,2,3,5,7,9,11,13,15,17,19,21,22,24,25,26,27,28,28,29,29,29,30,30,30,30,30,30,30
E01017535,EV motorcycles,Number,0,1,1,2,3,4,5,6,7,8,10,11,12,13,13,14,15,15,16,16,16,16,17,17,17,17,17,17,17,17
E01017536,EV motorcycles,Number,0,1,1,2,3,3,4,5,6,7,8,9,10,11,12,12,13,13,14,14,14,15,15,15,15,15,15,15,15,15
E01017537,EV motorcycles,Number,0,0,1,1,2,3,3,4,5,6,7,7,8,9,9,10,10,11,11,11,12,12,12,12,12,12,12,12,12,12
E01017538,EV motorcycles,Number,0,0,1,1,2,2,3,4,4,5,6,6,7,7,8,8,9,9,9,9,10,10,10,10,10,10,10,10,10,10
E01017539,EV motorcycles,Number,0,0,0,1,1,2,2,2,3,3,4,4,5,5,6,6,6,6,6,7,7,7,7,7,7,7,7,7,7,7
E01017540,EV motorcycles,Number,1,2,4,7,11,15,20,24,29,33,38,42,46,50,54,57,59,61,63,64,65,66,67,67,67,68,68,68,68,68
E01017541,EV motorcycles,Number,0,0,0,0,0,0,0,0,0,0,0,0,0,0,0,0,0,0,0,0,0,0,0,0,0,0,0,0,0,0
E01017542,EV motorcycles,Number,1,3,6,10,15,20,25,31,37,43,49,55,60,65,69,73,76,79,81,83,84,85,86,87,87,87,88,88,88,88
E01017543,EV motorcycles,Number,1,3,5,8,12,16,21,25,30,35,40,44,49,52,56,59,62,64,66,67,68,69,70,70,70,71,71,71,71,71
E01017544,EV motorcycles,Number,0,0,0,0,0,0,0,0,0,0,0,0,0,0,0,0,0,0,0,0,0,0,0,0,0,0,0,0,0,0
E01017545,EV motorcycles,Number,0,0,0,0,0,0,0,0,0,0,0,0,0,0,0,0,0,0,0,0,0,0,0,0,0,0,0,0,0,0
E01017546,EV motorcycles,Number,1,1,2,4,6,9,11,13,16,19,21,24,26,28,30,32,33,34,35,36,36,37,37,37,38,38,38,38,38,38
E01017547,EV motorcycles,Number,1,2,4,6,9,12,16,20,23,27,31,34,38,41,43,46,48,49,51,52,53,53,54,54,54,55,55,55,55,55
E01017548,EV motorcycles,Number,1,3,6,10,15,20,25,31,37,43,49,55,60,65,69,73,76,79,81,83,84,85,86,87,87,87,88,88,88,88
E01017549,EV motorcycles,Number,1,2,4,6,9,12,16,20,23,27,31,34,38,41,43,46,48,49,51,52,53,53,54,54,54,55,55,55,55,55
E01017550,EV motorcycles,Number,1,2,4,6,10,13,16,20,24,28,32,35,39,42,45,47,50,51,53,54,55,55,56,56,56,57,57,57,57,57
E01017551,EV motorcycles,Number,2,4,7,12,18,24,30,37,44,52,59,65,72,78,83,87,91,94,97,99,101,102,103,103,104,104,105,105,105,105
E01017552,EV motorcycles,Number,1,2,3,5,8,11,14,17,20,24,27,30,33,35,38,40,42,43,44,45,46,47,47,47,48,48,48,48,48,48
E01017553,EV motorcycles,Number,1,1,2,4,6,8,10,12,15,17,20,22,24,26,28,29,30,31,32,33,34,34,34,34,35,35,35,35,35,35
E01017554,EV motorcycles,Number,1,2,3,5,8,11,14,17,21,24,27,31,33,36,39,41,43,44,45,46,47,48,48,48,48,49,49,49,49,49
E01017555,EV motorcycles,Number,1,1,2,4,6,8,10,12,15,17,20,22,24,26,28,29,30,31,32,33,34,34,34,34,35,35,35,35,35,35
E01017556,EV motorcycles,Number,1,1,2,4,6,9,11,13,16,19,21,24,26,28,30,32,33,34,35,36,36,37,37,37,38,38,38,38,38,38
E01017557,EV motorcycles,Number,0,1,2,3,4,6,8,9,11,13,15,16,18,19,20,22,23,23,24,25,25,25,25,26,26,26,26,26,26,26
E01017558,EV motorcycles,Number,1,2,3,6,9,11,15,18,22,25,29,32,35,38,40,42,44,46,47,48,49,49,50,50,50,51,51,51,51,51
E01017559,EV motorcycles,Number,1,2,3,6,9,11,15,18,22,25,29,32,35,38,40,42,44,46,47,48,49,49,50,50,50,51,51,51,51,51
E01017560,EV motorcycles,Number,1,2,4,6,9,12,16,19,23,27,30,34,37,40,43,45,47,49,50,51,52,52,53,53,53,54,54,54,54,54
E01017561,EV motorcycles,Number,1,2,4,7,11,14,19,23,27,31,36,40,44,47,50,53,56,58,59,60,61,62,63,63,63,64,64,64,64,64
E01017562,EV motorcycles,Number,1,2,4,6,9,13,16,20,24,28,31,35,38,41,44,47,49,50,52,53,54,54,55,55,55,56,56,56,56,56
E01017563,EV motorcycles,Number,1,2,3,5,8,11,14,17,21,24,27,31,33,36,39,41,43,44,45,46,47,48,48,48,48,49,49,49,49,49
E01017564,EV motorcycles,Number,1,2,3,5,7,10,12,15,18,21,24,27,29,32,34,36,37,39,40,41,41,42,42,42,43,43,43,43,43,43
E01017565,EV motorcycles,Number,0,1,2,3,5,7,8,10,12,14,16,18,20,21,23,24,25,26,27,27,28,28,28,29,29,29,29,29,29,29
E01017566,EV motorcycles,Number,0,1,2,4,5,7,9,11,14,16,18,20,22,24,25,27,28,29,30,30,31,31,31,32,32,32,32,32,32,32
E01017567,EV motorcycles,Number,0,1,2,3,4,5,7,9,10,12,13,15,16,18,19,20,21,22,22,23,23,23,23,24,24,24,24,24,24,24
E01017568,EV motorcycles,Number,0,1,1,2,3,4,5,6,8,9,10,11,12,13,14,15,16,16,17,17,17,17,18,18,18,18,18,18,18,18
E01017569,EV motorcycles,Number,0,1,2,3,5,6,8,10,12,14,16,17,19,21,22,23,24,25,26,26,27,27,27,28,28,28,28,28,28,28
E01017570,EV motorcycles,Number,1,1,2,4,6,9,11,13,16,19,21,24,26,28,30,32,33,34,35,36,36,37,37,37,38,38,38,38,38,38
E01017571,EV motorcycles,Number,1,2,3,6,9,12,15,19,22,26,30,33,36,39,42,44,46,48,49,50,51,51,52,52,52,53,53,53,53,53
E01017572,EV motorcycles,Number,1,1,2,4,6,9,11,13,16,19,21,24,26,28,30,32,33,34,35,36,36,37,37,37,38,38,38,38,38,38
E01017573,EV motorcycles,Number,1,1,2,4,6,8,10,12,15,17,20,22,24,26,28,29,30,31,32,33,34,34,34,34,35,35,35,35,35,35
E01017575,EV motorcycles,Number,1,2,4,6,9,12,16,19,23,27,30,34,37,40,43,45,47,49,50,51,52,52,53,53,53,54,54,54,54,54
E01017576,EV motorcycles,Number,0,1,2,4,6,7,10,12,14,16,18,21,23,24,26,27,29,30,31,31,32,32,32,33,33,33,33,33,33,33
E01017577,EV motorcycles,Number,1,2,4,7,11,14,19,23,27,31,36,40,44,47,50,53,56,58,59,60,61,62,63,63,63,64,64,64,64,64
E01017578,EV motorcycles,Number,1,2,4,7,11,15,19,24,28,33,37,42,46,50,53,56,58,60,62,63,64,65,66,66,66,67,67,67,67,67
E01017579,EV motorcycles,Number,0,1,2,3,5,7,9,11,13,15,17,19,21,22,24,25,26,27,28,28,29,29,29,30,30,30,30,30,30,30
E01017580,EV motorcycles,Number,0,1,2,4,6,8,10,12,14,17,19,21,23,25,27,28,30,31,31,32,33,33,33,33,34,34,34,34,34,34
E01017581,EV motorcycles,Number,1,1,2,4,6,8,10,12,15,17,20,22,24,26,28,29,30,31,32,33,34,34,34,34,35,35,35,35,35,35
E01017582,EV motorcycles,Number,1,1,2,4,6,8,10,12,15,17,20,22,24,26,28,29,30,31,32,33,34,34,34,34,35,35,35,35,35,35
E01017583,EV motorcycles,Number,1,1,3,4,7,9,11,14,16,19,22,24,27,29,31,32,34,35,36,37,37,38,38,38,39,39,39,39,39,39
E01017584,EV motorcycles,Number,1,2,3,5,7,10,12,15,18,21,24,27,29,32,34,36,37,39,40,41,41,42,42,42,43,43,43,43,43,43
E01017585,EV motorcycles,Number,0,1,2,3,5,6,8,10,12,14,16,17,19,21,22,23,24,25,26,26,27,27,27,28,28,28,28,28,28,28
E01017586,EV motorcycles,Number,1,2,4,7,11,15,20,24,29,33,38,42,46,50,54,57,59,61,63,64,65,66,67,67,67,68,68,68,68,68
E01017587,EV motorcycles,Number,1,2,3,6,9,12,15,18,22,26,29,32,36,38,41,43,45,47,48,49,50,50,51,51,51,52,52,52,52,52
E01017588,EV motorcycles,Number,1,2,3,6,9,12,15,18,22,26,29,32,36,38,41,43,45,47,48,49,50,50,51,51,51,52,52,52,52,52
E01017589,EV motorcycles,Number,0,1,2,3,5,7,8,10,12,14,16,18,20,21,23,24,25,26,27,27,28,28,28,29,29,29,29,29,29,29
E01017590,EV motorcycles,Number,1,1,2,4,6,8,11,13,16,18,21,23,25,27,29,31,32,33,34,35,35,36,36,36,37,37,37,37,37,37
E01017591,EV motorcycles,Number,0,1,1,2,3,4,5,6,7,8,10,11,12,13,13,14,15,15,16,16,16,16,17,17,17,17,17,17,17,17
E01017592,EV motorcycles,Number,0,1,2,3,5,6,8,10,11,13,15,17,18,20,21,22,23,24,25,25,26,26,26,27,27,27,27,27,27,27
E01017593,EV motorcycles,Number,1,2,4,6,9,12,16,19,23,27,30,34,37,40,43,45,47,49,50,51,52,52,53,53,53,54,54,54,54,54
E01017594,EV motorcycles,Number,1,1,3,4,7,9,12,14,17,20,22,25,27,30,32,33,35,36,37,38,38,39,39,39,40,40,40,40,40,40
E01017595,EV motorcycles,Number,0,1,1,2,2,3,4,5,6,7,8,9,10,10,11,12,12,13,13,13,13,14,14,14,14,14,14,14,14,14
E01017596,EV motorcycles,Number,0,1,1,2,3,4,5,6,8,9,10,11,12,13,14,15,16,16,17,17,17,17,18,18,18,18,18,18,18,18
E01017597,EV motorcycles,Number,0,1,2,4,6,8,10,12,14,17,19,21,23,25,27,28,30,31,31,32,33,33,33,33,34,34,34,34,34,34
E01017598,EV motorcycles,Number,0,1,2,3,4,6,8,9,11,13,15,16,18,19,20,22,23,23,24,25,25,25,25,26,26,26,26,26,26,26
E01017599,EV motorcycles,Number,1,2,3,5,8,11,14,17,20,23,26,29,32,35,37,39,41,42,43,44,45,46,46,46,47,47,47,47,47,47
E01017600,EV motorcycles,Number,1,2,3,6,9,12,15,19,22,26,30,33,36,39,42,44,46,48,49,50,51,51,52,52,52,53,53,53,53,53
E01017601,EV motorcycles,Number,0,1,1,2,3,4,5,6,8,9,10,11,12,13,14,15,16,16,17,17,17,17,18,18,18,18,18,18,18,18
E01017602,EV motorcycles,Number,0,1,2,3,5,6,8,10,11,13,15,17,18,20,21,22,23,24,25,25,26,26,26,27,27,27,27,27,27,27
E01017603,EV motorcycles,Number,0,1,2,3,5,7,9,11,13,15,17,19,21,22,24,25,26,27,28,28,29,29,29,30,30,30,30,30,30,30
E01017604,EV motorcycles,Number,0,1,2,3,4,5,7,8,10,11,13,14,16,17,18,19,20,21,21,22,22,22,23,23,23,23,23,23,23,23
E01017605,EV motorcycles,Number,0,1,1,2,2,3,4,5,6,7,8,9,10,10,11,12,12,13,13,13,13,14,14,14,14,14,14,14,14,14
E01017606,EV motorcycles,Number,1,1,3,4,7,9,11,14,16,19,22,24,27,29,31,32,34,35,36,37,37,38,38,38,39,39,39,39,39,39
E01017607,EV motorcycles,Number,0,1,2,4,5,7,9,11,14,16,18,20,22,24,25,27,28,29,30,30,31,31,31,32,32,32,32,32,32,32
E01017608,EV motorcycles,Number,1,2,3,5,8,10,13,16,19,22,25,28,31,33,35,37,39,40,42,42,43,44,44,44,45,45,45,45,45,45
E01017609,EV motorcycles,Number,0,1,2,3,4,6,7,9,11,12,14,16,17,18,20,21,22,22,23,24,24,24,24,25,25,25,25,25,25,25
E01017610,EV motorcycles,Number,0,1,2,3,4,5,7,8,10,11,13,14,16,17,18,19,20,21,21,22,22,22,23,23,23,23,23,23,23,23
E01017611,EV motorcycles,Number,0,1,1,2,4,5,6,8,9,11,12,14,15,16,17,18,19,20,20,21,21,21,22,22,22,22,22,22,22,22
E01017612,EV motorcycles,Number,0,1,2,3,4,5,7,8,10,11,13,14,16,17,18,19,20,21,21,22,22,22,23,23,23,23,23,23,23,23
E01017613,EV motorcycles,Number,0,1,1,2,3,4,5,6,8,9,10,11,12,13,14,15,16,16,17,17,17,17,18,18,18,18,18,18,18,18
E01017614,EV motorcycles,Number,0,1,1,2,3,4,5,7,8,9,11,12,13,14,15,16,17,17,18,18,18,18,19,19,19,19,19,19,19,19
E01017615,EV motorcycles,Number,1,4,7,11,17,23,29,36,43,50,57,63,70,75,80,85,89,92,94,96,98,99,100,100,101,101,102,102,102,102
E01017616,EV motorcycles,Number,1,2,3,6,9,12,15,19,22,26,30,33,36,39,42,44,46,48,49,50,51,51,52,52,52,53,53,53,53,53
E01017617,EV motorcycles,Number,0,1,2,3,5,7,8,10,12,14,16,18,20,21,23,24,25,26,27,27,28,28,28,29,29,29,29,29,29,29
E01017618,EV motorcycles,Number,1,1,2,4,6,8,11,13,16,18,21,23,25,27,29,31,32,33,34,35,35,36,36,36,37,37,37,37,37,37
E01017619,EV motorcycles,Number,1,1,2,4,6,8,11,13,16,18,21,23,25,27,29,31,32,33,34,35,35,36,36,36,37,37,37,37,37,37
E01017620,EV motorcycles,Number,1,2,4,6,9,12,16,19,23,27,30,34,37,40,43,45,47,49,50,51,52,52,53,53,53,54,54,54,54,54
E01017621,EV motorcycles,Number,1,1,3,5,7,9,12,15,17,20,23,26,28,30,32,34,36,37,38,39,39,40,40,40,41,41,41,41,41,41
E01017622,EV motorcycles,Number,1,2,3,5,8,11,14,17,21,24,27,31,33,36,39,41,43,44,45,46,47,48,48,48,48,49,49,49,49,49
E01017623,EV motorcycles,Number,0,1,1,2,3,4,5,6,7,8,9,10,11,12,13,13,14,14,15,15,15,16,16,16,16,16,16,16,16,16
E01017624,EV motorcycles,Number,1,2,3,5,7,10,12,15,18,21,24,27,29,32,34,36,37,39,40,41,41,42,42,42,43,43,43,43,43,43
E01017625,EV motorcycles,Number,1,1,3,5,7,9,12,15,17,20,23,26,28,30,32,34,36,37,38,39,39,40,40,40,41,41,41,41,41,41
E01017626,EV motorcycles,Number,0,1,2,4,6,7,10,12,14,16,18,21,23,24,26,27,29,30,31,31,32,32,32,33,33,33,33,33,33,33
E01017627,EV motorcycles,Number,1,2,4,7,10,14,18,22,26,30,34,38,42,45,48,51,53,55,56,58,58,59,60,60,60,61,61,61,61,61
E01017628,EV motorcycles,Number,1,1,3,5,7,9,12,15,17,20,23,26,28,30,32,34,36,37,38,39,39,40,40,40,41,41,41,41,41,41
E01017629,EV motorcycles,Number,1,3,6,11,16,22,28,34,41,47,54,60,66,71,76,80,83,86,89,91,92,93,94,95,95,95,96,96,96,96
E01017630,EV motorcycles,Number,1,2,3,6,8,11,14,18,21,25,28,31,34,37,39,42,43,45,46,47,48,49,49,49,49,50,50,50,50,50
E01017631,EV motorcycles,Number,1,2,4,7,10,13,17,21,25,30,34,37,41,44,47,50,52,54,55,57,58,58,59,59,59,60,60,60,60,60
E01017632,EV motorcycles,Number,1,3,6,10,15,20,25,31,37,43,49,55,60,65,69,73,76,79,81,83,84,85,86,87,87,87,88,88,88,88
E01017634,EV motorcycles,Number,0,1,1,2,4,5,6,7,9,10,12,13,14,16,17,17,18,19,19,20,20,20,21,21,21,21,21,21,21,21
E01017635,EV motorcycles,Number,0,1,2,3,4,5,7,9,10,12,13,15,16,18,19,20,21,22,22,23,23,23,23,24,24,24,24,24,24,24
E01017636,EV motorcycles,Number,0,1,2,4,6,8,10,12,14,17,19,21,23,25,27,28,30,31,31,32,33,33,33,33,34,34,34,34,34,34
E01017637,EV motorcycles,Number,0,1,2,3,4,5,7,9,10,12,13,15,16,18,19,20,21,22,22,23,23,23,23,24,24,24,24,24,24,24
E01017638,EV motorcycles,Number,0,1,2,3,5,6,8,10,12,14,16,17,19,21,22,23,24,25,26,26,27,27,27,28,28,28,28,28,28,28
E01017639,EV motorcycles,Number,0,1,2,3,5,7,8,10,12,14,16,18,20,21,23,24,25,26,27,27,28,28,28,29,29,29,29,29,29,29
E01017640,EV motorcycles,Number,0,1,2,3,5,6,8,10,12,14,16,17,19,21,22,23,24,25,26,26,27,27,27,28,28,28,28,28,28,28
E01017641,EV motorcycles,Number,1,3,6,10,16,21,27,34,40,47,53,59,65,70,75,79,83,85,88,90,91,92,93,94,94,94,95,95,95,95
E01017642,EV motorcycles,Number,1,2,4,6,9,13,16,20,24,28,31,35,38,41,44,47,49,50,52,53,54,54,55,55,55,56,56,56,56,56
E01017643,EV motorcycles,Number,0,1,2,4,6,8,10,12,14,17,19,21,23,25,27,28,30,31,31,32,33,33,33,33,34,34,34,34,34,34
E01017651,EV motorcycles,Number,1,2,3,6,9,12,15,18,22,26,29,32,36,38,41,43,45,47,48,49,50,50,51,51,51,52,52,52,52,52
E01017652,EV motorcycles,Number,0,1,2,4,5,7,9,11,14,16,18,20,22,24,25,27,28,29,30,30,31,31,31,32,32,32,32,32,32,32
E01017653,EV motorcycles,Number,0,1,2,3,5,6,8,10,11,13,15,17,18,20,21,22,23,24,25,25,26,26,26,27,27,27,27,27,27,27
E01017654,EV motorcycles,Number,0,1,1,2,4,5,6,8,9,11,12,14,15,16,17,18,19,20,20,21,21,21,22,22,22,22,22,22,22,22
E01017655,EV motorcycles,Number,0,1,2,3,4,6,8,9,11,13,15,16,18,19,20,22,23,23,24,25,25,25,25,26,26,26,26,26,26,26
E01017657,EV motorcycles,Number,1,2,3,6,9,12,15,18,22,26,29,32,36,38,41,43,45,47,48,49,50,50,51,51,51,52,52,52,52,52
E01017658,EV motorcycles,Number,1,1,2,4,6,8,11,13,16,18,21,23,25,27,29,31,32,33,34,35,35,36,36,36,37,37,37,37,37,37
E01017659,EV motorcycles,Number,0,1,1,2,3,4,5,6,7,8,9,10,11,12,13,13,14,14,15,15,15,16,16,16,16,16,16,16,16,16
E01017660,EV motorcycles,Number,1,1,2,4,6,8,10,13,15,18,20,22,25,27,28,30,31,32,33,34,35,35,35,35,36,36,36,36,36,36
E01017661,EV motorcycles,Number,1,1,2,4,6,8,10,13,15,18,20,22,25,27,28,30,31,32,33,34,35,35,35,35,36,36,36,36,36,36
E01017662,EV motorcycles,Number,0,1,1,2,2,3,4,5,6,7,8,9,10,10,11,12,12,13,13,13,13,14,14,14,14,14,14,14,14,14
E01017663,EV motorcycles,Number,0,1,2,3,4,6,8,9,11,13,15,16,18,19,20,22,23,23,24,25,25,25,25,26,26,26,26,26,26,26
E01017664,EV motorcycles,Number,0,1,1,2,4,5,6,8,9,11,12,14,15,16,17,18,19,20,20,21,21,21,22,22,22,22,22,22,22,22
E01017665,EV motorcycles,Number,1,1,2,4,6,8,11,13,16,18,21,23,25,27,29,31,32,33,34,35,35,36,36,36,37,37,37,37,37,37
E01017666,EV motorcycles,Number,1,1,2,4,6,8,10,12,15,17,20,22,24,26,28,29,30,31,32,33,34,34,34,34,35,35,35,35,35,35
E01017667,EV motorcycles,Number,0,1,1,2,3,4,5,6,8,9,10,11,12,13,14,15,16,16,17,17,17,17,18,18,18,18,18,18,18,18
E01017668,EV motorcycles,Number,1,2,3,5,7,10,12,15,18,21,24,27,29,32,34,36,37,39,40,41,41,42,42,42,43,43,43,43,43,43
E01017669,EV motorcycles,Number,0,0,1,1,2,3,4,5,6,7,7,8,9,10,11,11,12,12,12,13,13,13,13,13,13,13,13,13,13,13
E01017670,EV motorcycles,Number,1,2,3,5,7,10,13,16,19,22,25,27,30,32,35,37,38,39,41,41,42,43,43,43,43,44,44,44,44,44
E01017673,EV motorcycles,Number,1,2,3,5,7,10,13,16,18,21,24,27,30,32,34,36,38,39,40,41,42,42,43,43,43,43,44,44,44,44
E01017674,EV motorcycles,Number,1,3,5,8,13,17,22,27,33,38,43,48,53,57,61,64,67,69,71,73,74,75,75,76,76,76,77,77,77,77
E01017675,EV motorcycles,Number,1,2,3,5,8,10,13,16,19,22,25,28,31,33,35,37,39,40,42,42,43,44,44,44,45,45,45,45,45,45
E01017676,EV motorcycles,Number,0,1,2,4,5,7,9,11,14,16,18,20,22,24,25,27,28,29,30,30,31,31,31,32,32,32,32,32,32,32
E01017677,EV motorcycles,Number,1,1,3,4,7,9,12,14,17,20,22,25,27,30,32,33,35,36,37,38,38,39,39,39,40,40,40,40,40,40
E01017678,EV motorcycles,Number,1,2,4,6,9,12,16,20,23,27,31,34,38,41,43,46,48,49,51,52,53,53,54,54,54,55,55,55,55,55
E01017679,EV motorcycles,Number,0,1,2,3,5,7,9,11,13,15,17,19,21,23,24,26,27,28,29,29,30,30,30,31,31,31,31,31,31,31
E01017680,EV motorcycles,Number,0,1,2,4,5,7,9,11,14,16,18,20,22,24,25,27,28,29,30,30,31,31,31,32,32,32,32,32,32,32
E01017681,EV motorcycles,Number,0,1,2,3,5,7,9,11,13,15,17,19,21,22,24,25,26,27,28,28,29,29,29,30,30,30,30,30,30,30
E01017682,EV motorcycles,Number,0,1,2,3,4,5,7,8,10,11,13,14,16,17,18,19,20,21,21,22,22,22,23,23,23,23,23,23,23,23
E01017683,EV motorcycles,Number,1,2,4,6,9,12,16,20,23,27,31,34,38,41,43,46,48,49,51,52,53,53,54,54,54,55,55,55,55,55
E01017684,EV motorcycles,Number,1,1,2,4,6,8,11,13,16,18,21,23,25,27,29,31,32,33,34,35,35,36,36,36,37,37,37,37,37,37
E01017687,EV motorcycles,Number,1,1,2,4,6,8,10,12,15,17,20,22,24,26,28,29,30,31,32,33,34,34,34,34,35,35,35,35,35,35
E01017688,EV motorcycles,Number,0,1,2,3,4,5,7,9,10,12,13,15,16,18,19,20,21,22,22,23,23,23,23,24,24,24,24,24,24,24
E01017689,EV motorcycles,Number,0,1,2,3,4,6,7,9,11,12,14,16,17,18,20,21,22,22,23,24,24,24,24,25,25,25,25,25,25,25
E01017690,EV motorcycles,Number,0,1,1,2,3,4,5,7,8,9,11,12,13,14,15,16,17,17,18,18,18,18,19,19,19,19,19,19,19,19
E01017691,EV motorcycles,Number,0,1,1,2,3,4,5,6,8,9,10,11,12,13,14,15,16,16,17,17,17,17,18,18,18,18,18,18,18,18
E01017692,EV motorcycles,Number,0,1,2,3,5,6,8,10,11,13,15,17,18,20,21,22,23,24,25,25,26,26,26,27,27,27,27,27,27,27
E01017697,EV motorcycles,Number,0,1,2,3,4,5,7,8,10,11,13,14,16,17,18,19,20,21,21,22,22,22,23,23,23,23,23,23,23,23
E01017698,EV motorcycles,Number,0,1,2,3,4,5,7,9,10,12,13,15,16,18,19,20,21,22,22,23,23,23,23,24,24,24,24,24,24,24
E01017699,EV motorcycles,Number,0,1,2,3,5,6,8,10,11,13,15,17,18,20,21,22,23,24,25,25,26,26,26,27,27,27,27,27,27,27
E01017700,EV motorcycles,Number,1,1,2,4,6,8,10,13,15,18,20,22,25,27,28,30,31,32,33,34,35,35,35,35,36,36,36,36,36,36
E01017701,EV motorcycles,Number,1,3,6,10,15,20,26,32,38,44,50,56,62,67,71,75,78,81,83,85,86,87,88,89,89,89,90,90,90,90
E01017702,EV motorcycles,Number,0,1,2,4,5,7,9,11,14,16,18,20,22,24,25,27,28,29,30,30,31,31,31,32,32,32,32,32,32,32
E01017703,EV motorcycles,Number,1,1,3,5,7,9,12,15,17,20,23,26,28,30,32,34,36,37,38,39,39,40,40,40,41,41,41,41,41,41
E01017704,EV motorcycles,Number,0,1,2,3,4,6,7,9,11,13,14,16,18,19,20,21,22,23,24,24,25,25,25,25,25,25,26,26,26,26
E01017705,EV motorcycles,Number,2,5,9,15,23,31,40,49,58,67,77,85,94,101,108,114,119,123,127,129,131,133,134,135,136,136,137,137,137,137
E01017706,EV motorcycles,Number,1,1,2,4,6,8,10,13,15,18,20,22,25,27,28,30,31,32,33,34,35,35,35,35,36,36,36,36,36,36
E01017707,EV motorcycles,Number,0,1,1,2,4,5,6,8,9,11,12,14,15,16,17,18,19,20,20,21,21,21,22,22,22,22,22,22,22,22
E01017708,EV motorcycles,Number,0,1,2,3,5,7,9,11,13,15,17,19,21,22,24,25,26,27,28,28,29,29,29,30,30,30,30,30,30,30
E01017709,EV motorcycles,Number,0,1,1,2,4,5,6,7,9,10,12,13,14,16,17,17,18,19,19,20,20,20,21,21,21,21,21,21,21,21
E01017710,EV motorcycles,Number,0,1,2,4,6,7,10,12,14,16,18,21,23,24,26,27,29,30,31,31,32,32,32,33,33,33,33,33,33,33
E01017711,EV motorcycles,Number,1,1,2,4,6,8,11,13,16,18,21,23,25,27,29,31,32,33,34,35,35,36,36,36,37,37,37,37,37,37
E01017712,EV motorcycles,Number,0,1,2,3,4,6,8,9,11,13,15,16,18,19,20,22,23,23,24,25,25,25,25,26,26,26,26,26,26,26
E01017714,EV motorcycles,Number,0,0,0,0,0,0,0,0,0,0,0,0,0,0,0,0,0,0,0,0,0,0,0,0,0,0,0,0,0,0
E01017716,EV motorcycles,Number,0,0,0,0,0,0,0,0,0,0,0,0,0,0,0,0,0,0,0,0,0,0,0,0,0,0,0,0,0,0
E01017719,EV motorcycles,Number,0,1,2,3,5,6,8,10,12,14,16,17,19,21,22,23,24,25,26,26,27,27,27,28,28,28,28,28,28,28
E01017720,EV motorcycles,Number,1,2,4,7,11,14,18,22,27,31,35,39,43,47,50,52,55,57,58,59,60,61,62,62,62,63,63,63,63,63
E01017721,EV motorcycles,Number,1,1,3,4,7,9,12,14,17,20,22,25,27,30,32,33,35,36,37,38,38,39,39,39,40,40,40,40,40,40
E01017722,EV motorcycles,Number,1,2,3,5,7,10,13,16,19,22,25,27,30,33,35,37,38,40,41,42,42,43,43,43,44,44,44,44,44,44
E01017723,EV motorcycles,Number,0,0,0,1,1,1,2,2,3,3,3,4,4,4,5,5,5,5,6,6,6,6,6,6,6,6,6,6,6,6
E01017724,EV motorcycles,Number,0,1,1,2,3,4,5,6,7,8,9,10,11,12,13,13,14,14,15,15,15,16,16,16,16,16,16,16,16,16
E01017726,EV motorcycles,Number,0,1,2,3,4,5,7,9,10,12,13,15,16,18,19,20,21,22,22,23,23,23,23,24,24,24,24,24,24,24
E01017727,EV motorcycles,Number,0,1,2,4,5,7,9,11,14,16,18,20,22,24,25,27,28,29,30,30,31,31,31,32,32,32,32,32,32,32
E01017728,EV motorcycles,Number,1,2,3,5,8,11,14,17,20,23,26,29,32,35,37,39,41,42,43,44,45,46,46,46,47,47,47,47,47,47
E01017729,EV motorcycles,Number,1,1,2,4,6,8,11,13,16,18,21,23,25,27,29,31,32,33,34,35,35,36,36,36,37,37,37,37,37,37
E01017730,EV motorcycles,Number,0,1,2,3,5,6,8,10,11,13,15,17,18,20,21,22,23,24,25,25,26,26,26,27,27,27,27,27,27,27
E01017731,EV motorcycles,Number,1,1,2,4,6,9,11,13,16,19,21,24,26,28,30,32,33,34,35,36,36,37,37,37,38,38,38,38,38,38
E01017732,EV motorcycles,Number,0,1,2,3,4,5,7,9,10,12,14,15,17,18,19,20,21,22,23,23,23,24,24,24,24,24,24,24,24,24
E01017733,EV motorcycles,Number,0,1,2,3,5,7,9,11,13,15,17,19,21,23,24,26,27,28,29,29,30,30,30,31,31,31,31,31,31,31
E01017734,EV motorcycles,Number,0,1,2,3,5,7,9,11,13,15,17,19,21,22,24,25,26,27,28,28,29,29,29,30,30,30,30,30,30,30
E01017739,EV motorcycles,Number,0,1,1,2,3,4,5,6,7,8,10,11,12,13,13,14,15,15,16,16,16,16,17,17,17,17,17,17,17,17
E01017740,EV motorcycles,Number,0,1,1,2,4,5,6,7,9,10,12,13,14,16,17,17,18,19,19,20,20,20,21,21,21,21,21,21,21,21
E01017741,EV motorcycles,Number,0,1,2,4,6,8,10,12,14,17,19,21,23,25,27,28,30,31,31,32,33,33,33,33,34,34,34,34,34,34
E01017742,EV motorcycles,Number,0,1,1,2,3,4,5,6,7,8,10,11,12,13,13,14,15,15,16,16,16,16,17,17,17,17,17,17,17,17
E01017743,EV motorcycles,Number,0,1,1,2,4,5,6,8,9,11,12,14,15,16,17,18,19,20,20,21,21,21,22,22,22,22,22,22,22,22
E01017744,EV motorcycles,Number,1,1,2,4,6,9,11,13,16,19,21,24,26,28,30,32,33,34,35,36,36,37,37,37,38,38,38,38,38,38
E01017745,EV motorcycles,Number,0,1,2,3,5,7,9,11,13,15,17,19,21,23,24,26,27,28,29,29,30,30,30,31,31,31,31,31,31,31
E01017746,EV motorcycles,Number,0,1,1,2,3,4,6,7,8,10,11,12,14,15,16,17,17,18,18,19,19,19,20,20,20,20,20,20,20,20
E01017747,EV motorcycles,Number,0,1,2,4,5,7,9,11,14,16,18,20,22,24,25,27,28,29,30,30,31,31,31,32,32,32,32,32,32,32
E01017748,EV motorcycles,Number,0,1,1,2,4,5,6,7,9,10,12,13,14,16,17,17,18,19,19,20,20,20,21,21,21,21,21,21,21,21
E01017749,EV motorcycles,Number,0,1,2,4,6,8,10,12,14,17,19,21,23,25,27,28,30,31,31,32,33,33,33,33,34,34,34,34,34,34
E01017750,EV motorcycles,Number,1,3,5,9,13,18,23,28,34,39,45,50,55,59,63,67,70,72,74,76,77,78,78,79,79,79,80,80,80,80
E01017752,EV motorcycles,Number,1,3,5,8,12,16,21,25,30,35,40,44,49,52,56,59,62,64,66,67,68,69,70,70,70,71,71,71,71,71
E01017763,EV motorcycles,Number,0,1,1,2,2,3,4,5,6,7,8,9,10,10,11,12,12,13,13,13,13,14,14,14,14,14,14,14,14,14
E01017764,EV motorcycles,Number,0,1,1,2,3,3,4,5,6,7,8,9,10,11,12,12,13,13,14,14,14,15,15,15,15,15,15,15,15,15
E01017765,EV motorcycles,Number,0,1,2,3,5,7,8,10,12,14,16,18,20,21,23,24,25,26,27,27,28,28,28,29,29,29,29,29,29,29
E01017766,EV motorcycles,Number,1,2,4,7,11,14,19,23,27,31,36,40,44,47,50,53,56,58,59,60,61,62,63,63,63,64,64,64,64,64
E01017768,EV motorcycles,Number,1,2,3,5,7,10,13,16,19,22,25,27,30,33,35,37,38,40,41,42,42,43,43,43,44,44,44,44,44,44
E01017769,EV motorcycles,Number,0,1,1,2,3,4,5,7,8,9,11,12,13,14,15,16,17,17,18,18,18,18,19,19,19,19,19,19,19,19
E01017770,EV motorcycles,Number,0,1,1,2,4,5,6,8,9,11,12,14,15,16,17,18,19,20,20,21,21,21,22,22,22,22,22,22,22,22
E01017771,EV motorcycles,Number,1,2,4,6,9,12,16,20,23,27,31,34,38,41,43,46,48,49,51,52,53,53,54,54,54,55,55,55,55,55
E01017773,EV motorcycles,Number,0,1,2,4,6,7,10,12,14,16,18,21,23,24,26,27,29,30,31,31,32,32,32,33,33,33,33,33,33,33
E01017774,EV motorcycles,Number,0,1,2,3,5,6,8,10,12,14,16,17,19,21,22,23,24,25,26,26,27,27,27,28,28,28,28,28,28,28
E01017775,EV motorcycles,Number,0,1,2,3,5,7,9,11,13,15,17,19,21,23,24,26,27,28,28,29,29,30,30,30,30,30,31,31,31,31
E01017776,EV motorcycles,Number,0,0,1,1,2,3,4,5,5,6,7,8,9,9,10,11,11,11,12,12,12,12,12,13,13,13,13,13,13,13
E01017777,EV motorcycles,Number,0,1,2,3,4,6,8,9,11,13,15,16,18,19,20,22,23,23,24,25,25,25,25,26,26,26,26,26,26,26
E01017778,EV motorcycles,Number,0,1,2,3,5,6,8,10,11,13,15,17,18,20,21,22,23,24,25,25,26,26,26,27,27,27,27,27,27,27
E01017779,EV motorcycles,Number,1,3,5,8,12,17,21,26,31,36,41,46,51,55,58,62,64,67,68,70,71,72,72,73,73,73,74,74,74,74
E01017780,EV motorcycles,Number,1,1,3,4,7,9,12,14,17,20,22,25,27,30,32,33,35,36,37,38,38,39,39,39,40,40,40,40,40,40
E01017781,EV motorcycles,Number,0,1,1,2,3,4,5,7,8,9,11,12,13,14,15,16,17,17,18,18,18,18,19,19,19,19,19,19,19,19
E01017783,EV motorcycles,Number,1,2,3,5,8,11,14,18,21,24,28,31,34,37,39,41,43,44,46,47,47,48,48,49,49,49,49,49,49,49
E01017785,EV motorcycles,Number,0,1,2,3,5,7,9,11,13,15,17,19,20,22,24,25,26,27,28,28,29,29,29,29,30,30,30,30,30,30
E01017786,EV motorcycles,Number,1,2,3,6,9,11,15,18,22,25,29,32,35,38,40,42,44,46,47,48,49,49,50,50,50,51,51,51,51,51
E01017787,EV motorcycles,Number,1,2,3,5,8,10,13,16,19,22,25,28,31,33,35,37,39,40,42,42,43,44,44,44,45,45,45,45,45,45
E01017788,EV motorcycles,Number,0,1,2,4,5,7,9,11,14,16,18,20,22,24,25,27,28,29,30,30,31,31,31,32,32,32,32,32,32,32
E01017789,EV motorcycles,Number,0,1,1,2,3,4,5,7,8,9,11,12,13,14,15,16,17,17,18,18,18,18,19,19,19,19,19,19,19,19
E01017790,EV motorcycles,Number,0,1,2,3,4,5,7,9,10,12,13,15,16,18,19,20,21,22,22,23,23,23,23,24,24,24,24,24,24,24
E01017791,EV motorcycles,Number,0,1,2,3,4,5,7,8,10,11,13,14,16,17,18,19,20,21,21,22,22,22,23,23,23,23,23,23,23,23
E01017792,EV motorcycles,Number,1,2,3,5,8,11,14,17,21,24,27,31,33,36,39,41,43,44,45,46,47,48,48,48,48,49,49,49,49,49
E01017793,EV motorcycles,Number,1,1,3,4,7,9,12,14,17,20,22,25,27,30,32,33,35,36,37,38,38,39,39,39,40,40,40,40,40,40
E01017795,EV motorcycles,Number,1,2,3,5,8,10,13,16,19,22,25,28,31,33,35,37,39,40,42,42,43,44,44,44,45,45,45,45,45,45
E01017798,EV motorcycles,Number,0,0,0,0,0,0,0,0,0,0,0,0,0,0,0,0,0,0,0,0,0,0,0,0,0,0,0,0,0,0
E01017842,EV motorcycles,Number,2,5,9,15,22,30,38,47,56,65,74,82,90,98,104,110,115,119,122,125,127,128,129,130,131,131,132,132,132,132
E01017871,EV motorcycles,Number,0,0,0,0,0,0,0,0,0,0,0,0,0,0,0,0,0,0,0,0,0,0,0,0,0,0,0,0,0,0
E01017872,EV motorcycles,Number,0,0,0,0,0,0,0,0,0,0,0,0,0,0,0,0,0,0,0,0,0,0,0,0,0,0,0,0,0,0
E01017874,EV motorcycles,Number,0,0,0,0,0,0,0,0,0,0,0,0,0,0,0,0,0,0,0,0,0,0,0,0,0,0,0,0,0,0
E01017885,EV motorcycles,Number,1,3,6,10,15,20,26,32,38,44,50,56,62,67,71,75,78,81,83,85,86,87,88,89,89,89,90,90,90,90
E01017886,EV motorcycles,Number,1,2,3,5,7,9,12,15,18,21,24,26,29,31,33,35,36,38,39,40,40,41,41,41,42,42,42,42,42,42
E01017887,EV motorcycles,Number,1,1,2,4,6,9,11,13,16,19,21,24,26,28,30,32,33,34,35,36,36,37,37,37,38,38,38,38,38,38
E01017888,EV motorcycles,Number,1,2,4,6,9,12,16,19,23,27,30,34,37,40,43,45,47,49,50,51,52,52,53,53,53,54,54,54,54,54
E01017916,EV motorcycles,Number,0,0,0,0,0,0,0,0,0,0,0,0,0,0,0,0,0,0,0,0,0,0,0,0,0,0,0,0,0,0
E01017929,EV motorcycles,Number,0,1,2,3,5,7,9,11,13,15,17,19,21,23,24,26,27,28,29,29,30,30,30,31,31,31,31,31,31,31
E01017930,EV motorcycles,Number,1,2,4,7,11,15,19,23,27,32,36,40,44,48,51,54,56,58,60,61,62,63,64,64,64,65,65,65,65,65
E01017931,EV motorcycles,Number,1,1,2,4,6,8,10,13,15,18,20,22,25,27,28,30,31,32,33,34,35,35,35,35,36,36,36,36,36,36
E01017932,EV motorcycles,Number,1,1,2,4,6,8,11,13,16,18,21,23,25,27,29,31,32,33,34,35,35,36,36,36,37,37,37,37,37,37
E01017933,EV motorcycles,Number,1,2,3,5,7,9,12,15,18,21,24,26,29,31,33,35,36,38,39,40,40,41,41,41,42,42,42,42,42,42
E01017943,EV motorcycles,Number,1,2,3,5,7,9,12,15,18,21,24,26,29,31,33,35,36,38,39,40,40,41,41,41,42,42,42,42,42,42
E01017944,EV motorcycles,Number,0,1,2,3,5,7,9,11,13,15,17,19,21,23,24,26,27,28,29,29,30,30,30,31,31,31,31,31,31,31
E01017945,EV motorcycles,Number,1,1,2,4,6,8,10,13,15,18,20,22,25,27,28,30,31,32,33,34,35,35,35,35,36,36,36,36,36,36
E01017946,EV motorcycles,Number,1,1,3,4,7,9,11,14,16,19,22,24,27,29,31,32,34,35,36,37,37,38,38,38,39,39,39,39,39,39
E01017947,EV motorcycles,Number,1,2,4,6,10,13,16,20,24,28,32,35,39,42,45,47,50,51,53,54,55,55,56,56,56,57,57,57,57,57
E01017948,EV motorcycles,Number,1,1,2,4,6,8,11,13,16,18,21,23,25,27,29,31,32,33,34,35,35,36,36,36,37,37,37,37,37,37
E01017949,EV motorcycles,Number,0,1,2,3,4,6,7,9,11,12,14,16,17,18,20,21,22,22,23,24,24,24,24,25,25,25,25,25,25,25
E01017950,EV motorcycles,Number,0,0,1,1,2,2,3,3,4,4,5,6,6,7,7,7,8,8,8,8,9,9,9,9,9,9,9,9,9,9
E01017951,EV motorcycles,Number,0,1,2,3,4,6,8,9,11,13,15,16,18,19,20,22,23,23,24,25,25,25,25,26,26,26,26,26,26,26
E01017952,EV motorcycles,Number,0,1,2,3,4,5,7,8,10,11,13,14,16,17,18,19,20,21,21,22,22,22,23,23,23,23,23,23,23,23
E01017953,EV motorcycles,Number,1,1,2,4,6,9,11,13,16,19,21,24,26,28,30,32,33,34,35,36,36,37,37,37,38,38,38,38,38,38
E01017954,EV motorcycles,Number,0,1,2,3,5,7,8,10,12,14,16,18,20,21,23,24,25,26,27,27,28,28,28,29,29,29,29,29,29,29
E01017955,EV motorcycles,Number,0,1,1,2,4,5,6,8,9,11,12,14,15,16,17,18,19,20,20,21,21,21,22,22,22,22,22,22,22,22
E01017956,EV motorcycles,Number,0,1,2,4,5,7,9,11,14,16,18,20,22,24,25,27,28,29,30,30,31,31,31,32,32,32,32,32,32,32
E01017957,EV motorcycles,Number,0,1,2,3,5,6,8,10,12,14,16,17,19,21,22,23,24,25,26,26,27,27,27,28,28,28,28,28,28,28
E01017958,EV motorcycles,Number,0,0,1,1,2,2,3,3,4,4,5,6,6,7,7,7,8,8,8,8,9,9,9,9,9,9,9,9,9,9
E01017959,EV motorcycles,Number,1,1,2,4,6,9,11,13,16,19,21,24,26,28,30,32,33,34,35,36,36,37,37,37,38,38,38,38,38,38
E01017960,EV motorcycles,Number,0,1,2,3,4,6,7,9,11,12,14,16,17,18,20,21,22,22,23,24,24,24,24,25,25,25,25,25,25,25
E01017961,EV motorcycles,Number,0,1,2,3,4,6,8,9,11,13,15,16,18,19,20,22,23,23,24,25,25,25,25,26,26,26,26,26,26,26
E01017962,EV motorcycles,Number,1,2,3,5,7,10,12,15,18,21,24,27,29,32,34,36,37,39,40,41,41,42,42,42,43,43,43,43,43,43
E01017963,EV motorcycles,Number,0,1,2,3,5,7,8,10,12,14,16,18,20,21,23,24,25,26,27,27,28,28,28,29,29,29,29,29,29,29
E01017964,EV motorcycles,Number,1,1,3,4,7,9,12,14,17,20,22,25,27,30,32,33,35,36,37,38,38,39,39,39,40,40,40,40,40,40
E01017965,EV motorcycles,Number,0,1,2,3,4,6,7,9,11,12,14,16,17,18,20,21,22,22,23,24,24,24,24,25,25,25,25,25,25,25
E01017966,EV motorcycles,Number,0,1,2,3,5,6,8,10,11,13,15,17,18,20,21,22,23,24,25,25,26,26,26,27,27,27,27,27,27,27
E01017967,EV motorcycles,Number,0,1,2,3,4,6,8,9,11,13,15,16,18,19,20,22,23,23,24,25,25,25,25,26,26,26,26,26,26,26
E01017968,EV motorcycles,Number,0,1,2,3,5,7,9,11,13,15,17,19,21,23,24,26,27,28,29,29,30,30,30,31,31,31,31,31,31,31
E01017969,EV motorcycles,Number,0,1,1,2,4,5,6,7,9,10,12,13,14,16,17,17,18,19,19,20,20,20,21,21,21,21,21,21,21,21
E01017971,EV motorcycles,Number,0,1,2,4,6,7,10,12,14,16,18,21,23,24,26,27,29,30,31,31,32,32,32,33,33,33,33,33,33,33
E01017972,EV motorcycles,Number,0,1,2,3,5,6,8,10,12,14,16,17,19,21,22,23,24,25,26,26,27,27,27,28,28,28,28,28,28,28
E01017973,EV motorcycles,Number,0,1,2,4,6,8,10,12,14,17,19,21,23,25,27,28,30,31,31,32,33,33,33,33,34,34,34,34,34,34
E01017974,EV motorcycles,Number,0,1,2,4,6,8,10,12,14,17,19,21,23,25,27,28,30,31,31,32,33,33,33,33,34,34,34,34,34,34
E01017975,EV motorcycles,Number,1,2,3,5,8,11,14,17,20,23,26,29,32,35,37,39,41,42,43,44,45,46,46,46,47,47,47,47,47,47
E01017976,EV motorcycles,Number,0,1,2,4,6,8,10,12,14,17,19,21,23,25,27,28,30,31,31,32,33,33,33,33,34,34,34,34,34,34
E01017977,EV motorcycles,Number,0,1,2,3,5,7,9,11,13,15,17,19,21,22,24,25,26,27,28,28,29,29,29,30,30,30,30,30,30,30
E01017978,EV motorcycles,Number,1,2,3,5,7,9,12,15,18,21,24,26,29,31,33,35,36,38,39,40,40,41,41,41,42,42,42,42,42,42
E01017979,EV motorcycles,Number,1,2,3,5,7,9,12,15,18,21,24,26,29,31,33,35,36,38,39,40,40,41,41,41,42,42,42,42,42,42
E01017980,EV motorcycles,Number,0,1,2,4,5,7,9,11,14,16,18,20,22,24,25,27,28,29,30,30,31,31,31,32,32,32,32,32,32,32
E01017983,EV motorcycles,Number,0,1,1,2,3,4,5,6,7,8,10,11,12,13,13,14,15,15,16,16,16,16,17,17,17,17,17,17,17,17
E01017984,EV motorcycles,Number,0,1,2,3,5,7,8,10,12,14,16,18,20,21,23,24,25,26,27,27,28,28,28,29,29,29,29,29,29,29
E01017985,EV motorcycles,Number,0,1,2,3,4,5,7,9,10,12,13,15,16,18,19,20,21,22,22,23,23,23,23,24,24,24,24,24,24,24
E01017986,EV motorcycles,Number,0,0,0,0,0,0,0,0,0,0,0,0,0,0,0,0,0,0,0,0,0,0,0,0,0,0,0,0,0,0
E01017987,EV motorcycles,Number,0,1,1,2,3,3,4,5,6,7,8,9,10,11,12,12,13,13,14,14,14,15,15,15,15,15,15,15,15,15
E01017988,EV motorcycles,Number,0,1,1,2,2,3,4,5,6,7,8,9,10,10,11,12,12,13,13,13,13,14,14,14,14,14,14,14,14,14
E01017989,EV motorcycles,Number,0,1,1,2,4,5,6,7,9,10,12,13,14,16,17,17,18,19,19,20,20,20,21,21,21,21,21,21,21,21
E01017990,EV motorcycles,Number,0,0,0,1,1,1,2,2,3,3,3,4,4,4,5,5,5,5,6,6,6,6,6,6,6,6,6,6,6,6
E01017991,EV motorcycles,Number,0,0,1,1,1,2,2,3,3,4,4,5,5,6,6,7,7,7,7,8,8,8,8,8,8,8,8,8,8,8
E01017992,EV motorcycles,Number,0,1,2,4,5,7,9,11,14,16,18,20,22,24,25,27,28,29,30,30,31,31,31,32,32,32,32,32,32,32
E01017993,EV motorcycles,Number,0,1,1,2,3,4,5,6,8,9,10,11,12,13,14,15,16,16,17,17,17,17,18,18,18,18,18,18,18,18
E01017994,EV motorcycles,Number,0,1,1,2,4,5,6,8,9,11,12,14,15,16,17,18,19,20,20,21,21,21,22,22,22,22,22,22,22,22
E01017995,EV motorcycles,Number,0,1,2,3,5,6,8,10,11,13,15,17,18,20,21,22,23,24,25,25,26,26,26,27,27,27,27,27,27,27
E01017996,EV motorcycles,Number,0,1,1,2,4,5,6,7,9,10,12,13,14,16,17,17,18,19,19,20,20,20,21,21,21,21,21,21,21,21
E01017997,EV motorcycles,Number,1,2,3,5,8,10,13,16,19,22,25,28,31,33,35,37,39,40,42,42,43,44,44,44,45,45,45,45,45,45
E01017998,EV motorcycles,Number,0,1,2,3,5,7,8,10,12,14,16,18,20,21,23,24,25,26,27,27,28,28,28,29,29,29,29,29,29,29
E01017999,EV motorcycles,Number,0,1,1,2,3,4,6,7,8,10,11,12,14,15,16,17,17,18,18,19,19,19,20,20,20,20,20,20,20,20
E01018000,EV motorcycles,Number,0,0,1,1,2,3,4,5,5,6,7,8,9,10,10,11,11,12,12,12,12,13,13,13,13,13,13,13,13,13
E01018001,EV motorcycles,Number,0,1,1,2,3,4,5,6,8,9,10,11,12,13,14,15,16,16,17,17,17,17,18,18,18,18,18,18,18,18
E01018002,EV motorcycles,Number,1,2,4,6,10,13,17,21,25,29,32,36,40,43,46,48,50,52,54,55,56,56,57,57,57,58,58,58,58,58
E01018003,EV motorcycles,Number,1,3,6,10,15,20,25,31,37,43,49,54,59,64,69,72,76,78,80,82,83,84,85,86,86,86,87,87,87,87
E01018005,EV motorcycles,Number,0,1,1,2,3,4,5,7,8,9,11,12,13,14,15,16,17,17,18,18,18,18,19,19,19,19,19,19,19,19
E01018006,EV motorcycles,Number,1,1,2,4,6,8,11,13,16,18,21,23,25,27,29,31,32,33,34,35,35,36,36,36,37,37,37,37,37,37
E01018007,EV motorcycles,Number,1,1,2,4,6,8,10,13,15,18,20,22,25,27,28,30,31,32,33,34,35,35,35,35,36,36,36,36,36,36
E01018008,EV motorcycles,Number,1,1,2,4,6,9,11,13,16,19,21,24,26,28,30,32,33,34,35,36,36,37,37,37,38,38,38,38,38,38
E01018009,EV motorcycles,Number,0,1,2,3,5,6,8,10,11,13,15,17,18,20,21,22,23,24,25,25,26,26,26,27,27,27,27,27,27,27
E01018010,EV motorcycles,Number,0,0,1,1,2,2,3,3,4,4,5,6,6,7,7,7,8,8,8,8,9,9,9,9,9,9,9,9,9,9
E01018011,EV motorcycles,Number,1,3,5,9,13,18,23,28,34,39,45,50,55,59,63,67,70,72,74,76,77,78,78,79,79,79,80,80,80,80
E01018012,EV motorcycles,Number,0,1,2,4,6,8,10,12,14,17,19,21,23,25,27,28,30,31,31,32,33,33,33,33,34,34,34,34,34,34
E01018013,EV motorcycles,Number,1,3,5,8,12,16,20,25,30,34,39,44,48,52,55,58,61,63,65,66,67,68,69,69,69,70,70,70,70,70
E01018014,EV motorcycles,Number,1,2,3,5,8,11,14,17,20,23,26,29,32,35,37,39,41,42,43,44,45,46,46,46,47,47,47,47,47,47
E01018015,EV motorcycles,Number,1,2,4,7,11,15,19,24,28,33,37,42,46,50,53,56,58,60,62,63,64,65,66,66,66,67,67,67,67,67
E01018016,EV motorcycles,Number,0,1,2,3,5,7,9,11,13,15,17,19,21,23,24,26,27,28,29,29,30,30,30,31,31,31,31,31,31,31
E01018017,EV motorcycles,Number,0,1,2,3,5,6,8,10,12,14,16,17,19,21,22,23,24,25,26,26,27,27,27,28,28,28,28,28,28,28
E01018019,EV motorcycles,Number,0,1,2,3,4,6,7,9,11,12,14,16,17,18,20,21,22,22,23,24,24,24,24,25,25,25,25,25,25,25
E01018020,EV motorcycles,Number,1,2,4,7,11,14,19,23,27,31,36,40,44,47,50,53,56,58,59,60,61,62,63,63,63,64,64,64,64,64
E01018021,EV motorcycles,Number,1,2,3,5,8,10,13,16,19,22,25,28,31,33,35,37,39,40,42,42,43,44,44,44,45,45,45,45,45,45
E01018022,EV motorcycles,Number,1,2,4,7,11,15,20,24,29,33,38,42,46,50,54,57,59,61,63,64,65,66,67,67,67,68,68,68,68,68
E01018023,EV motorcycles,Number,1,4,6,11,17,22,29,35,42,49,55,62,68,73,78,82,86,89,92,93,95,96,97,98,98,98,99,99,99,99
E01018024,EV motorcycles,Number,1,2,4,6,9,12,16,19,23,27,30,34,37,40,43,45,47,49,50,51,52,52,53,53,53,54,54,54,54,54
E01018025,EV motorcycles,Number,0,1,2,3,5,6,8,10,12,14,16,17,19,21,22,23,24,25,26,26,27,27,27,28,28,28,28,28,28,28
E01018026,EV motorcycles,Number,0,1,2,3,5,7,9,11,13,15,17,19,21,22,24,25,26,27,28,28,29,29,29,30,30,30,30,30,30,30
E01018027,EV motorcycles,Number,0,1,2,3,5,6,8,10,12,14,16,17,19,21,22,23,24,25,26,26,27,27,27,28,28,28,28,28,28,28
E01018029,EV motorcycles,Number,1,2,3,6,9,12,15,18,22,26,29,32,36,38,41,43,45,47,48,49,50,50,51,51,51,52,52,52,52,52
E01018030,EV motorcycles,Number,0,1,1,2,4,5,6,7,9,10,12,13,14,16,17,17,18,19,19,20,20,20,21,21,21,21,21,21,21,21
E01018032,EV motorcycles,Number,1,2,4,7,11,15,19,23,27,32,36,40,44,48,51,54,56,58,60,61,62,63,64,64,64,65,65,65,65,65
E01018033,EV motorcycles,Number,1,1,2,4,6,8,10,12,15,17,20,22,24,26,28,29,30,31,32,33,34,34,34,34,35,35,35,35,35,35
E01018034,EV motorcycles,Number,1,2,4,7,11,15,20,24,29,33,38,42,46,50,54,57,59,61,63,64,65,66,67,67,67,68,68,68,68,68
E01018035,EV motorcycles,Number,1,2,4,7,10,14,18,22,26,30,35,39,42,46,49,52,54,56,57,59,59,60,61,61,61,62,62,62,62,62
E01018036,EV motorcycles,Number,1,3,5,9,13,18,23,28,34,39,45,50,55,59,63,67,70,72,74,76,77,78,78,79,79,79,80,80,80,80
E01018037,EV motorcycles,Number,1,2,4,7,11,14,19,23,27,31,36,40,44,47,50,53,56,58,59,60,61,62,63,63,63,64,64,64,64,64
E01018038,EV motorcycles,Number,1,2,4,7,10,14,18,22,26,30,34,38,42,45,48,51,53,55,56,58,58,59,60,60,60,61,61,61,61,61
E01018039,EV motorcycles,Number,1,2,3,5,8,11,14,17,20,23,26,29,32,35,37,39,41,42,43,44,45,46,46,46,47,47,47,47,47,47
E01018040,EV motorcycles,Number,0,1,2,3,4,6,7,9,11,12,14,16,17,18,20,21,22,22,23,24,24,24,24,25,25,25,25,25,25,25
E01018041,EV motorcycles,Number,1,1,2,4,6,8,11,13,16,18,21,23,25,27,29,31,32,33,34,35,35,36,36,36,37,37,37,37,37,37
E01018042,EV motorcycles,Number,1,1,3,4,7,9,11,14,16,19,22,24,27,29,31,32,34,35,36,37,37,38,38,38,39,39,39,39,39,39
E01018043,EV motorcycles,Number,1,3,5,8,12,16,21,26,31,36,41,45,50,54,58,61,63,66,67,69,70,71,71,72,72,72,73,73,73,73
E01018044,EV motorcycles,Number,1,2,4,6,10,13,16,20,24,28,32,35,39,42,45,47,50,51,53,54,55,55,56,56,56,57,57,57,57,57
E01018045,EV motorcycles,Number,1,2,3,6,9,12,15,19,22,26,30,33,36,39,42,44,46,48,49,50,51,51,52,52,52,53,53,53,53,53
E01018046,EV motorcycles,Number,1,3,6,9,14,19,25,30,36,42,48,53,58,63,67,71,74,76,79,80,82,82,83,84,84,84,85,85,85,85
E01018047,EV motorcycles,Number,1,3,5,8,12,16,20,25,30,34,39,44,48,52,55,58,61,63,65,66,67,68,69,69,69,70,70,70,70,70
E01018049,EV motorcycles,Number,1,2,4,7,11,14,19,23,27,31,36,40,44,47,50,53,56,58,59,60,61,62,63,63,63,64,64,64,64,64
E01018050,EV motorcycles,Number,1,2,3,5,7,9,12,15,18,21,24,26,29,31,33,35,36,38,39,40,40,41,41,41,42,42,42,42,42,42
E01018051,EV motorcycles,Number,1,2,4,6,9,13,16,20,24,28,31,35,38,41,44,47,49,50,52,53,54,54,55,55,55,56,56,56,56,56
E01018052,EV motorcycles,Number,1,1,2,4,6,8,10,12,15,17,20,22,24,26,28,29,30,31,32,33,34,34,34,34,35,35,35,35,35,35
E01018053,EV motorcycles,Number,1,2,4,7,11,14,19,23,27,31,36,40,44,47,50,53,56,58,59,60,61,62,63,63,63,64,64,64,64,64
E01018054,EV motorcycles,Number,2,4,7,12,19,25,33,40,48,56,63,70,77,83,89,94,98,102,104,107,108,110,111,111,112,112,113,113,113,113
E01018055,EV motorcycles,Number,1,2,4,6,10,13,17,21,25,29,32,36,40,43,46,48,50,52,54,55,56,56,57,57,57,58,58,58,58,58
E01018056,EV motorcycles,Number,1,2,4,7,11,14,18,22,27,31,35,39,43,47,50,52,55,57,58,59,60,61,62,62,62,63,63,63,63,63
E01018057,EV motorcycles,Number,1,3,6,10,15,20,26,32,38,45,51,57,62,67,72,76,79,82,84,86,87,88,89,90,90,90,91,91,91,91
E01018058,EV motorcycles,Number,1,2,3,5,8,11,14,17,20,23,26,29,32,35,37,39,41,42,43,44,45,46,46,46,47,47,47,47,47,47
E01018059,EV motorcycles,Number,1,3,5,9,14,19,24,30,36,41,47,52,57,62,66,70,73,76,78,79,81,82,82,83,83,83,84,84,84,84
E01018060,EV motorcycles,Number,1,3,5,8,13,17,22,27,32,37,43,47,52,56,60,63,66,68,70,72,73,74,74,75,75,75,76,76,76,76
E01018061,EV motorcycles,Number,1,2,3,5,8,10,13,16,19,23,26,29,31,34,36,38,40,41,43,43,44,45,45,45,46,46,46,46,46,46
E01018062,EV motorcycles,Number,1,2,4,6,9,13,16,20,24,28,31,35,38,41,44,47,49,50,52,53,54,54,55,55,55,56,56,56,56,56
E01018063,EV motorcycles,Number,1,1,2,4,6,8,11,13,16,18,21,23,25,27,29,31,32,33,34,35,35,36,36,36,37,37,37,37,37,37
E01018064,EV motorcycles,Number,1,2,4,7,11,14,18,22,27,31,35,39,43,47,50,52,55,57,58,59,60,61,62,62,62,63,63,63,63,63
E01018065,EV motorcycles,Number,1,3,6,10,15,21,27,33,39,45,51,57,63,68,73,77,80,83,85,87,88,89,90,91,91,91,92,92,92,92
E01018066,EV motorcycles,Number,1,2,4,7,10,14,18,22,26,30,35,39,42,46,49,52,54,56,57,59,59,60,61,61,61,62,62,62,62,62
E01018067,EV motorcycles,Number,1,2,4,7,10,13,17,21,25,30,34,37,41,44,47,50,52,54,55,57,58,58,59,59,59,60,60,60,60,60
E01018068,EV motorcycles,Number,1,2,4,7,11,15,19,23,28,32,37,41,45,49,52,55,57,59,61,62,63,64,65,65,65,66,66,66,66,66
E01018069,EV motorcycles,Number,1,2,3,6,8,11,14,18,21,25,28,31,34,37,39,42,43,45,46,47,48,49,49,49,49,50,50,50,50,50
E01018070,EV motorcycles,Number,0,1,1,2,3,4,5,7,8,9,11,12,13,14,15,16,17,17,18,18,18,18,19,19,19,19,19,19,19,19
E01018071,EV motorcycles,Number,0,1,2,3,5,6,8,10,11,13,15,17,18,20,21,22,23,24,25,25,26,26,26,27,27,27,27,27,27,27
E01018072,EV motorcycles,Number,1,2,3,6,9,12,15,19,22,26,30,33,36,39,42,44,46,48,49,50,51,51,52,52,52,53,53,53,53,53
E01018073,EV motorcycles,Number,1,4,6,11,16,22,28,35,41,48,55,61,67,72,77,82,85,88,91,93,94,95,96,97,97,97,98,98,98,98
E01018074,EV motorcycles,Number,1,2,3,5,8,11,14,17,21,24,27,31,33,36,39,41,43,44,45,46,47,48,48,48,48,49,49,49,49,49
E01018075,EV motorcycles,Number,0,1,2,3,5,7,8,10,12,14,16,18,20,21,23,24,25,26,27,27,28,28,28,29,29,29,29,29,29,29
E01018076,EV motorcycles,Number,2,4,7,12,18,24,32,39,46,54,61,68,75,81,86,91,95,98,101,103,105,106,107,107,108,108,109,109,109,109
E01018077,EV motorcycles,Number,1,2,4,6,9,13,16,20,24,28,31,35,38,41,44,47,49,50,52,53,54,54,55,55,55,56,56,56,56,56
E01018078,EV motorcycles,Number,0,1,2,3,5,7,9,11,13,15,17,19,21,23,24,26,27,28,29,29,30,30,30,31,31,31,31,31,31,31
E01018079,EV motorcycles,Number,1,2,4,7,10,14,18,22,26,30,35,39,42,46,49,52,54,56,57,59,59,60,61,61,61,62,62,62,62,62
E01018080,EV motorcycles,Number,1,2,4,6,10,13,17,21,25,29,32,36,40,43,46,48,50,52,54,55,56,56,57,57,57,58,58,58,58,58
E01018081,EV motorcycles,Number,1,2,4,7,10,14,18,22,26,30,34,38,42,45,48,51,53,55,56,58,58,59,60,60,60,61,61,61,61,61
E01018082,EV motorcycles,Number,1,2,3,5,8,11,14,17,21,24,27,31,33,36,39,41,43,44,45,46,47,48,48,48,48,49,49,49,49,49
E01018083,EV motorcycles,Number,1,1,2,4,6,8,11,13,16,18,21,23,25,27,29,31,32,33,34,35,35,36,36,36,37,37,37,37,37,37
E01018084,EV motorcycles,Number,1,2,3,6,9,11,15,18,22,25,29,32,35,38,40,42,44,46,47,48,49,49,50,50,50,51,51,51,51,51
E01018085,EV motorcycles,Number,1,2,3,6,9,12,15,18,22,26,29,32,36,38,41,43,45,47,48,49,50,50,51,51,51,52,52,52,52,52
E01018086,EV motorcycles,Number,0,1,2,4,6,8,10,12,14,17,19,21,23,25,27,28,30,31,31,32,33,33,33,33,34,34,34,34,34,34
E01018087,EV motorcycles,Number,1,2,3,5,8,11,14,17,20,24,27,30,33,35,38,40,42,43,44,45,46,47,47,47,48,48,48,48,48,48
E01018088,EV motorcycles,Number,0,1,2,3,5,6,8,10,11,13,15,17,18,20,21,22,23,24,25,25,26,26,26,27,27,27,27,27,27,27
E01018090,EV motorcycles,Number,1,3,5,8,13,17,22,27,32,37,42,47,51,55,59,62,65,67,69,71,72,73,73,74,74,74,75,75,75,75
E01018091,EV motorcycles,Number,1,3,5,9,14,18,23,29,34,40,45,50,55,60,64,67,70,73,75,76,78,79,79,80,80,80,81,81,81,81
E01018092,EV motorcycles,Number,1,4,6,11,16,22,28,35,41,48,55,61,67,72,77,82,85,88,91,93,94,95,96,97,97,97,98,98,98,98
E01018093,EV motorcycles,Number,1,3,5,9,13,18,23,28,33,38,44,49,53,58,61,65,68,70,72,74,75,76,76,77,77,77,78,78,78,78
E01018094,EV motorcycles,Number,1,2,3,5,8,11,14,17,20,23,26,29,32,35,37,39,41,42,43,44,45,46,46,46,47,47,47,47,47,47
E01018095,EV motorcycles,Number,1,3,6,10,16,21,27,33,39,46,52,58,64,69,73,77,81,84,86,88,89,90,91,92,92,92,93,93,93,93
E01018096,EV motorcycles,Number,1,2,3,5,8,10,13,16,19,22,25,28,31,33,35,37,39,40,42,42,43,44,44,44,45,45,45,45,45,45
E01018097,EV motorcycles,Number,1,2,4,7,10,13,17,21,25,30,34,37,41,44,47,50,52,54,55,57,58,58,59,59,59,60,60,60,60,60
E01018098,EV motorcycles,Number,1,1,3,4,7,9,12,14,17,20,22,25,27,30,32,33,35,36,37,38,38,39,39,39,40,40,40,40,40,40
E01018099,EV motorcycles,Number,1,2,4,6,9,12,16,19,23,27,30,34,37,40,43,45,47,49,50,51,52,52,53,53,53,54,54,54,54,54
E01018100,EV motorcycles,Number,0,1,2,4,6,8,10,12,14,17,19,21,23,25,27,28,30,31,31,32,33,33,33,33,34,34,34,34,34,34
E01018101,EV motorcycles,Number,1,2,4,6,9,12,16,20,23,27,31,34,38,41,43,46,48,49,51,52,53,53,54,54,54,55,55,55,55,55
E01018102,EV motorcycles,Number,1,2,4,7,10,14,18,22,26,30,34,38,42,45,48,51,53,55,56,58,58,59,60,60,60,61,61,61,61,61
E01018103,EV motorcycles,Number,0,1,1,2,3,4,6,7,8,10,11,12,14,15,16,17,17,18,18,19,19,19,20,20,20,20,20,20,20,20
E01018104,EV motorcycles,Number,0,1,1,2,3,4,6,7,8,10,11,12,14,15,16,17,17,18,18,19,19,19,20,20,20,20,20,20,20,20
E01018105,EV motorcycles,Number,1,2,4,7,11,15,19,23,27,32,36,40,44,48,51,54,56,58,60,61,62,63,64,64,64,65,65,65,65,65
E01018106,EV motorcycles,Number,1,3,6,10,15,21,27,33,39,45,51,57,63,68,73,77,80,83,85,87,88,89,90,91,91,91,92,92,92,92
E01018107,EV motorcycles,Number,1,1,2,4,6,8,11,13,16,18,21,23,25,27,29,31,32,33,34,35,35,36,36,36,37,37,37,37,37,37
E01018108,EV motorcycles,Number,0,1,1,2,4,5,6,8,9,11,12,14,15,16,17,18,19,20,20,21,21,21,22,22,22,22,22,22,22,22
E01018109,EV motorcycles,Number,1,1,2,4,6,8,10,13,15,18,20,22,25,27,28,30,31,32,33,34,35,35,35,35,36,36,36,36,36,36
E01018110,EV motorcycles,Number,1,4,7,11,17,23,29,36,43,50,57,63,70,75,80,85,89,92,94,96,98,99,100,100,101,101,102,102,102,102
E01018111,EV motorcycles,Number,1,2,4,7,11,15,19,23,28,32,37,41,45,49,52,55,57,59,61,62,63,64,65,65,65,66,66,66,66,66
E01018113,EV motorcycles,Number,1,2,3,6,9,12,15,18,22,26,29,32,36,38,41,43,45,47,48,49,50,50,51,51,51,52,52,52,52,52
E01018115,EV motorcycles,Number,1,2,3,5,7,10,12,15,18,21,24,27,29,32,34,36,37,39,40,41,41,42,42,42,43,43,43,43,43,43
E01018116,EV motorcycles,Number,0,1,2,4,6,7,10,12,14,16,18,21,23,24,26,27,29,30,31,31,32,32,32,33,33,33,33,33,33,33
E01018117,EV motorcycles,Number,1,2,3,5,8,11,14,17,20,23,26,29,32,35,37,39,41,42,43,44,45,46,46,46,47,47,47,47,47,47
E01018118,EV motorcycles,Number,1,1,3,4,7,9,11,14,16,19,22,24,27,29,31,32,34,35,36,37,37,38,38,38,39,39,39,39,39,39
E01018119,EV motorcycles,Number,1,3,5,8,12,16,20,25,30,34,39,44,48,52,55,58,61,63,65,66,67,68,69,69,69,70,70,70,70,70
E01018120,EV motorcycles,Number,1,2,3,5,8,10,13,16,19,22,25,28,31,33,35,37,39,40,42,42,43,44,44,44,45,45,45,45,45,45
E01018121,EV motorcycles,Number,1,2,3,5,7,10,13,16,19,22,25,27,30,33,35,37,38,40,41,42,42,43,43,43,44,44,44,44,44,44
E01018122,EV motorcycles,Number,1,1,3,4,7,9,12,14,17,20,22,25,27,30,32,33,35,36,37,38,38,39,39,39,40,40,40,40,40,40
E01018123,EV motorcycles,Number,1,2,5,8,12,15,20,25,29,34,39,43,47,51,54,57,60,62,64,65,66,67,68,68,68,69,69,69,69,69
E01018124,EV motorcycles,Number,1,2,4,7,11,15,19,23,28,32,37,41,45,49,52,55,57,59,61,62,63,64,65,65,65,66,66,66,66,66
E01018125,EV motorcycles,Number,1,2,4,7,11,15,20,24,29,33,38,42,46,50,54,57,59,61,63,64,65,66,67,67,67,68,68,68,68,68
E01018126,EV motorcycles,Number,1,2,4,7,10,13,17,21,25,30,34,37,41,44,47,50,52,54,55,57,58,58,59,59,59,60,60,60,60,60
E01018127,EV motorcycles,Number,1,2,3,6,8,11,15,18,21,25,28,32,35,37,40,42,44,46,47,48,49,49,50,50,50,50,51,51,51,51
E01018128,EV motorcycles,Number,1,2,3,5,8,11,14,17,21,24,27,31,33,36,39,41,43,44,45,46,47,48,48,48,48,49,49,49,49,49
E01018129,EV motorcycles,Number,1,2,4,7,11,14,19,23,27,31,36,40,44,47,50,53,56,58,59,60,61,62,63,63,63,64,64,64,64,64
E01018130,EV motorcycles,Number,1,2,3,6,9,12,15,19,22,26,30,33,36,39,42,44,46,48,49,50,51,51,52,52,52,53,53,53,53,53
E01018131,EV motorcycles,Number,0,1,1,2,3,4,6,7,8,10,11,12,14,15,16,17,17,18,18,19,19,19,20,20,20,20,20,20,20,20
E01018132,EV motorcycles,Number,1,2,3,6,8,11,14,18,21,25,28,31,34,37,39,42,43,45,46,47,48,49,49,49,49,50,50,50,50,50
E01018133,EV motorcycles,Number,0,1,2,3,5,7,9,11,13,15,17,19,21,23,24,26,27,28,29,29,30,30,30,31,31,31,31,31,31,31
E01018134,EV motorcycles,Number,1,2,3,6,9,12,15,18,22,26,29,32,36,38,41,43,45,47,48,49,50,50,51,51,51,52,52,52,52,52
E01018135,EV motorcycles,Number,1,3,6,10,15,20,26,32,38,44,50,55,61,66,70,74,77,80,82,84,85,86,87,88,88,88,89,89,89,89
E01018136,EV motorcycles,Number,1,3,5,8,12,17,21,26,31,36,41,46,51,55,58,62,64,67,68,70,71,72,72,73,73,73,74,74,74,74
E01018137,EV motorcycles,Number,1,2,4,7,10,13,17,21,25,30,34,37,41,44,47,50,52,54,55,57,58,58,59,59,59,60,60,60,60,60
E01018138,EV motorcycles,Number,1,1,3,4,7,9,11,14,16,19,22,24,27,29,31,32,34,35,36,37,37,38,38,38,39,39,39,39,39,39
E01018139,EV motorcycles,Number,1,2,3,6,8,11,14,18,21,25,28,31,34,37,39,42,43,45,46,47,48,49,49,49,49,50,50,50,50,50
E01018140,EV motorcycles,Number,1,1,2,4,6,8,10,13,15,18,20,22,25,27,28,30,31,32,33,34,35,35,35,35,36,36,36,36,36,36
E01018141,EV motorcycles,Number,1,2,3,5,8,11,14,17,21,24,27,31,33,36,39,41,43,44,45,46,47,48,48,48,48,49,49,49,49,49
E01018142,EV motorcycles,Number,0,1,2,4,6,7,10,12,14,16,18,21,23,24,26,27,29,30,31,31,32,32,32,33,33,33,33,33,33,33
E01018143,EV motorcycles,Number,1,1,2,4,6,8,10,13,15,18,20,22,25,27,28,30,31,32,33,34,35,35,35,35,36,36,36,36,36,36
E01018144,EV motorcycles,Number,0,1,1,2,3,4,5,7,8,9,11,12,13,14,15,16,17,17,18,18,18,18,19,19,19,19,19,19,19,19
E01018145,EV motorcycles,Number,0,1,2,3,4,5,7,9,10,12,13,15,16,18,19,20,21,22,22,23,23,23,23,24,24,24,24,24,24,24
E01018146,EV motorcycles,Number,0,1,2,3,5,7,9,11,13,15,17,19,21,23,24,26,27,28,29,29,30,30,30,31,31,31,31,31,31,31
E01018147,EV motorcycles,Number,0,1,2,4,6,7,10,12,14,16,18,21,23,24,26,27,29,30,31,31,32,32,32,33,33,33,33,33,33,33
E01018148,EV motorcycles,Number,1,2,3,5,7,9,12,15,18,21,24,26,29,31,33,35,36,38,39,40,40,41,41,41,42,42,42,42,42,42
E01018149,EV motorcycles,Number,0,1,2,3,5,7,8,10,12,14,16,18,20,21,23,24,25,26,27,27,28,28,28,29,29,29,29,29,29,29
E01018150,EV motorcycles,Number,2,5,8,14,22,29,37,46,55,63,72,80,88,95,102,107,112,116,119,122,124,125,126,127,128,128,129,129,129,129
E01018151,EV motorcycles,Number,1,2,4,7,10,14,18,22,26,30,34,38,42,45,48,51,53,55,56,58,58,59,60,60,60,61,61,61,61,61
E01018152,EV motorcycles,Number,0,1,2,4,6,7,10,12,14,16,18,21,23,24,26,27,29,30,31,31,32,32,32,33,33,33,33,33,33,33
E01018153,EV motorcycles,Number,1,2,3,6,9,11,15,18,22,25,29,32,35,38,40,42,44,46,47,48,49,49,50,50,50,51,51,51,51,51
E01018154,EV motorcycles,Number,1,2,4,7,11,14,18,22,27,31,35,39,43,47,50,52,55,57,58,59,60,61,62,62,62,63,63,63,63,63
E01018155,EV motorcycles,Number,1,2,3,6,8,11,14,18,21,25,28,31,34,37,39,42,43,45,46,47,48,49,49,49,49,50,50,50,50,50
E01018156,EV motorcycles,Number,1,2,3,6,9,11,15,18,22,25,29,32,35,38,40,42,44,46,47,48,49,49,50,50,50,51,51,51,51,51
E01018157,EV motorcycles,Number,1,3,5,8,12,16,20,25,30,34,39,44,48,52,55,58,61,63,65,66,67,68,69,69,69,70,70,70,70,70
E01018158,EV motorcycles,Number,1,2,4,7,11,15,19,23,28,32,37,41,45,49,52,55,57,59,61,62,63,64,65,65,65,66,66,66,66,66
E01018159,EV motorcycles,Number,1,2,4,7,10,13,17,21,25,30,34,37,41,44,47,50,52,54,55,57,58,58,59,59,59,60,60,60,60,60
E01018160,EV motorcycles,Number,0,1,2,3,5,7,8,10,12,14,16,18,20,21,23,24,25,26,27,27,28,28,28,29,29,29,29,29,29,29
E01018161,EV motorcycles,Number,1,1,2,4,6,8,10,12,15,17,20,22,24,26,28,29,30,31,32,33,34,34,34,34,35,35,35,35,35,35
E01018162,EV motorcycles,Number,1,1,2,4,6,8,10,12,15,17,20,22,24,26,28,29,30,31,32,33,34,34,34,34,35,35,35,35,35,35
E01018163,EV motorcycles,Number,1,1,2,4,6,8,10,12,15,17,20,22,24,26,28,29,30,31,32,33,34,34,34,34,35,35,35,35,35,35
E01018164,EV motorcycles,Number,0,1,2,3,5,7,9,11,13,15,17,19,21,22,24,25,26,27,28,28,29,29,29,30,30,30,30,30,30,30
E01018165,EV motorcycles,Number,0,1,1,2,3,4,5,6,7,8,10,11,12,13,13,14,15,15,16,16,16,16,17,17,17,17,17,17,17,17
E01018166,EV motorcycles,Number,1,1,3,4,7,9,11,14,16,19,22,24,27,29,31,32,34,35,36,37,37,38,38,38,39,39,39,39,39,39
E01018167,EV motorcycles,Number,1,2,3,5,7,10,13,16,19,22,25,27,30,33,35,37,38,40,41,42,42,43,43,43,44,44,44,44,44,44
E01018168,EV motorcycles,Number,0,1,2,3,5,7,9,11,13,15,17,19,21,23,24,26,27,28,29,29,30,30,30,31,31,31,31,31,31,31
E01018169,EV motorcycles,Number,1,2,3,6,9,11,15,18,22,25,29,32,35,38,40,42,44,46,47,48,49,49,50,50,50,51,51,51,51,51
E01018170,EV motorcycles,Number,0,1,2,4,6,8,10,12,14,17,19,21,23,25,27,28,30,31,31,32,33,33,33,33,34,34,34,34,34,34
E01018171,EV motorcycles,Number,1,1,3,4,7,9,11,14,16,19,22,24,27,29,31,32,34,35,36,37,37,38,38,38,39,39,39,39,39,39
E01018172,EV motorcycles,Number,1,2,3,5,8,11,14,17,20,24,27,30,33,35,38,40,42,43,44,45,46,47,47,47,48,48,48,48,48,48
E01018173,EV motorcycles,Number,0,1,2,4,6,7,10,12,14,16,18,21,23,24,26,27,29,30,31,31,32,32,32,33,33,33,33,33,33,33
E01018174,EV motorcycles,Number,1,2,3,5,7,9,12,15,18,21,24,26,29,31,33,35,36,38,39,40,40,41,41,41,42,42,42,42,42,42
E01018175,EV motorcycles,Number,1,1,2,4,6,8,10,13,15,18,20,22,25,27,28,30,31,32,33,34,35,35,35,35,36,36,36,36,36,36
E01018176,EV motorcycles,Number,0,1,2,3,5,7,9,11,13,15,17,19,21,22,24,25,26,27,28,28,29,29,29,30,30,30,30,30,30,30
E01018177,EV motorcycles,Number,0,1,2,3,5,7,9,11,13,15,17,19,21,22,24,25,26,27,28,28,29,29,29,30,30,30,30,30,30,30
E01018178,EV motorcycles,Number,1,2,3,5,8,11,14,17,21,24,27,31,33,36,39,41,43,44,45,46,47,48,48,48,48,49,49,49,49,49
E01018179,EV motorcycles,Number,1,2,3,5,8,10,13,16,19,23,26,29,31,34,36,38,40,41,43,43,44,45,45,45,46,46,46,46,46,46
E01018180,EV motorcycles,Number,0,1,2,3,4,5,7,8,10,11,13,14,16,17,18,19,20,21,21,22,22,22,23,23,23,23,23,23,23,23
E01018181,EV motorcycles,Number,1,2,3,5,8,11,14,17,21,24,27,31,33,36,39,41,43,44,45,46,47,48,48,48,48,49,49,49,49,49
E01018182,EV motorcycles,Number,0,1,2,3,5,7,8,10,12,14,16,18,20,21,23,24,25,26,27,27,28,28,28,29,29,29,29,29,29,29
E01018183,EV motorcycles,Number,1,2,3,6,8,11,14,18,21,25,28,31,34,37,39,42,43,45,46,47,48,49,49,49,49,50,50,50,50,50
E01018184,EV motorcycles,Number,0,1,1,2,3,4,5,6,7,8,10,11,12,13,13,14,15,15,16,16,16,16,17,17,17,17,17,17,17,17
E01018185,EV motorcycles,Number,1,2,3,5,7,10,12,15,18,21,24,27,29,32,34,36,37,39,40,41,41,42,42,42,43,43,43,43,43,43
E01018186,EV motorcycles,Number,1,2,3,5,8,11,14,17,21,24,27,31,33,36,39,41,43,44,45,46,47,48,48,48,48,49,49,49,49,49
E01018187,EV motorcycles,Number,0,1,2,3,5,6,8,10,11,13,15,17,18,20,21,22,23,24,25,25,26,26,26,27,27,27,27,27,27,27
E01018188,EV motorcycles,Number,0,1,2,4,5,7,9,11,14,16,18,20,22,24,25,27,28,29,30,30,31,31,31,32,32,32,32,32,32,32
E01018189,EV motorcycles,Number,0,1,2,4,6,7,10,12,14,16,18,21,23,24,26,27,29,30,31,31,32,32,32,33,33,33,33,33,33,33
E01018190,EV motorcycles,Number,0,1,1,2,4,5,6,7,9,10,12,13,14,16,17,17,18,19,19,20,20,20,21,21,21,21,21,21,21,21
E01018191,EV motorcycles,Number,1,2,3,5,8,10,13,16,19,23,26,29,31,34,36,38,40,41,43,43,44,45,45,45,46,46,46,46,46,46
E01018192,EV motorcycles,Number,1,3,5,8,13,17,22,27,33,38,43,48,53,57,61,64,67,69,71,73,74,75,75,76,76,76,77,77,77,77
E01018193,EV motorcycles,Number,1,2,3,5,7,9,12,15,18,21,24,26,29,31,33,35,36,38,39,40,40,41,41,41,42,42,42,42,42,42
E01018194,EV motorcycles,Number,1,1,3,5,7,9,12,15,17,20,23,26,28,30,32,34,36,37,38,39,39,40,40,40,41,41,41,41,41,41
E01018195,EV motorcycles,Number,1,1,2,4,6,8,10,13,15,18,20,22,25,27,28,30,31,32,33,34,35,35,35,35,36,36,36,36,36,36
E01018196,EV motorcycles,Number,1,2,3,5,8,10,13,16,19,23,26,29,31,34,36,38,40,41,43,43,44,45,45,45,46,46,46,46,46,46
E01018197,EV motorcycles,Number,1,2,3,5,7,10,12,15,18,21,24,27,29,32,34,36,37,39,40,41,41,42,42,42,43,43,43,43,43,43
E01018198,EV motorcycles,Number,1,3,5,8,13,17,22,27,32,37,43,47,52,56,60,63,66,68,70,72,73,74,74,75,75,75,76,76,76,76
E01018199,EV motorcycles,Number,1,3,5,8,13,17,22,27,32,37,43,47,52,56,60,63,66,68,70,72,73,74,74,75,75,75,76,76,76,76
E01018200,EV motorcycles,Number,1,2,4,6,10,13,17,21,25,29,32,36,40,43,46,48,50,52,54,55,56,56,57,57,57,58,58,58,58,58
E01018201,EV motorcycles,Number,1,2,3,6,9,11,15,18,22,25,29,32,35,38,40,42,44,46,47,48,49,49,50,50,50,51,51,51,51,51
E01018202,EV motorcycles,Number,1,1,3,4,7,9,12,14,17,20,22,25,27,30,32,33,35,36,37,38,38,39,39,39,40,40,40,40,40,40
E01018203,EV motorcycles,Number,1,2,3,6,8,11,14,18,21,25,28,31,34,37,39,42,43,45,46,47,48,49,49,49,49,50,50,50,50,50
E01018204,EV motorcycles,Number,0,1,2,4,5,7,9,11,14,16,18,20,22,24,25,27,28,29,30,30,31,31,31,32,32,32,32,32,32,32
E01018205,EV motorcycles,Number,1,2,3,5,8,11,14,17,20,23,26,29,32,35,37,39,41,42,43,44,45,46,46,46,47,47,47,47,47,47
E01018206,EV motorcycles,Number,1,2,4,6,10,13,17,21,25,29,32,36,40,43,46,48,50,52,54,55,56,56,57,57,57,58,58,58,58,58
E01018207,EV motorcycles,Number,1,2,3,6,8,11,14,18,21,25,28,31,34,37,39,42,43,45,46,47,48,49,49,49,49,50,50,50,50,50
E01018208,EV motorcycles,Number,1,3,5,8,13,17,22,27,33,38,43,48,53,57,61,64,67,69,71,73,74,75,75,76,76,76,77,77,77,77
E01018209,EV motorcycles,Number,1,2,3,6,8,11,14,18,21,25,28,31,34,37,39,42,43,45,46,47,48,49,49,49,49,50,50,50,50,50
E01018210,EV motorcycles,Number,0,1,1,2,4,5,6,8,9,11,12,14,15,16,17,18,19,20,20,21,21,21,22,22,22,22,22,22,22,22
E01018211,EV motorcycles,Number,1,2,3,5,8,11,14,17,20,24,27,30,33,35,38,40,42,43,44,45,46,47,47,47,48,48,48,48,48,48
E01018212,EV motorcycles,Number,1,2,4,6,9,12,16,19,23,27,30,34,37,40,43,45,47,49,50,51,52,52,53,53,53,54,54,54,54,54
E01018213,EV motorcycles,Number,1,2,4,7,10,14,18,22,26,30,34,38,42,45,48,51,53,55,56,58,58,59,60,60,60,61,61,61,61,61
E01018214,EV motorcycles,Number,1,2,4,6,9,13,16,20,24,28,31,35,38,41,44,47,49,50,52,53,54,54,55,55,55,56,56,56,56,56
E01018215,EV motorcycles,Number,0,1,2,3,4,6,8,9,11,13,15,16,18,19,20,22,23,23,24,25,25,25,25,26,26,26,26,26,26,26
E01018216,EV motorcycles,Number,1,2,4,6,9,12,16,19,23,27,30,34,37,40,43,45,47,49,50,51,52,52,53,53,53,54,54,54,54,54
E01018217,EV motorcycles,Number,1,2,3,5,8,11,14,17,20,23,26,29,32,35,37,39,41,42,43,44,45,46,46,46,47,47,47,47,47,47
E01018218,EV motorcycles,Number,1,2,4,6,9,12,16,19,23,27,30,34,37,40,43,45,47,49,50,51,52,52,53,53,53,54,54,54,54,54
E01018219,EV motorcycles,Number,1,2,3,5,8,11,14,17,21,24,27,31,33,36,39,41,43,44,45,46,47,48,48,48,48,49,49,49,49,49
E01018220,EV motorcycles,Number,2,4,8,13,20,26,34,42,49,58,65,73,80,86,92,97,102,105,108,110,112,114,115,115,116,116,117,117,117,117
E01018221,EV motorcycles,Number,1,2,3,5,8,10,13,16,19,22,25,28,31,33,35,37,39,40,42,42,43,44,44,44,45,45,45,45,45,45
E01018222,EV motorcycles,Number,0,1,2,3,4,6,8,9,11,13,15,16,18,19,20,22,23,23,24,25,25,25,25,26,26,26,26,26,26,26
E01018223,EV motorcycles,Number,1,2,4,6,10,13,16,20,24,28,32,35,39,42,45,47,50,51,53,54,55,55,56,56,56,57,57,57,57,57
E01018224,EV motorcycles,Number,1,2,4,7,11,15,19,23,28,32,37,41,45,49,52,55,57,59,61,62,63,64,65,65,65,66,66,66,66,66
E01018225,EV motorcycles,Number,1,1,2,4,6,8,10,13,15,18,20,22,25,27,28,30,31,32,33,34,35,35,35,35,36,36,36,36,36,36
E01018226,EV motorcycles,Number,1,2,4,7,10,14,18,22,26,30,34,38,42,45,48,51,53,55,56,58,58,59,60,60,60,61,61,61,61,61
E01018227,EV motorcycles,Number,1,3,6,9,14,19,25,31,36,42,48,54,59,64,68,72,75,77,79,81,82,83,84,85,85,85,86,86,86,86
E01018228,EV motorcycles,Number,1,2,3,6,9,12,15,18,22,26,29,32,36,38,41,43,45,47,48,49,50,50,51,51,51,52,52,52,52,52
E01018231,EV motorcycles,Number,1,2,4,6,9,13,16,20,24,28,31,35,38,41,44,47,49,50,52,53,54,54,55,55,55,56,56,56,56,56
E01018232,EV motorcycles,Number,1,2,4,7,10,14,18,22,26,30,34,38,42,45,48,51,53,55,56,58,58,59,60,60,60,61,61,61,61,61
E01018233,EV motorcycles,Number,1,3,6,10,15,20,25,31,37,43,49,54,59,64,69,72,76,78,80,82,83,84,85,86,86,86,87,87,87,87
E01018234,EV motorcycles,Number,0,1,2,3,4,6,8,9,11,13,15,16,18,19,20,22,23,23,24,25,25,25,25,26,26,26,26,26,26,26
E01018235,EV motorcycles,Number,1,2,3,6,9,12,15,19,22,26,30,33,36,39,42,44,46,48,49,50,51,51,52,52,52,53,53,53,53,53
E01018236,EV motorcycles,Number,1,3,5,9,14,18,23,29,34,40,45,50,55,60,64,67,70,73,75,76,78,79,79,80,80,80,81,81,81,81
E01018237,EV motorcycles,Number,1,2,3,5,7,10,13,16,19,22,25,27,30,33,35,37,38,40,41,42,42,43,43,43,44,44,44,44,44,44
E01018238,EV motorcycles,Number,1,1,2,4,6,9,11,13,16,19,21,24,26,28,30,32,33,34,35,36,36,37,37,37,38,38,38,38,38,38
E01018239,EV motorcycles,Number,0,1,2,4,6,8,10,12,14,17,19,21,23,25,27,28,30,31,31,32,33,33,33,33,34,34,34,34,34,34
E01018240,EV motorcycles,Number,1,2,3,5,8,11,14,17,20,24,27,30,33,35,38,40,42,43,44,45,46,47,47,47,48,48,48,48,48,48
E01018241,EV motorcycles,Number,1,2,4,6,9,13,16,20,24,28,31,35,38,41,44,47,49,50,52,53,54,54,55,55,55,56,56,56,56,56
E01018242,EV motorcycles,Number,1,2,4,7,11,15,19,23,28,32,37,41,45,49,52,55,57,59,61,62,63,64,65,65,65,66,66,66,66,66
E01018243,EV motorcycles,Number,1,1,2,4,6,8,10,12,15,17,20,22,24,26,28,29,30,31,32,33,34,34,34,34,35,35,35,35,35,35
E01018244,EV motorcycles,Number,1,2,3,5,8,10,13,16,19,23,26,29,31,34,36,38,40,41,43,43,44,45,45,45,46,46,46,46,46,46
E01018245,EV motorcycles,Number,1,1,3,4,7,9,12,14,17,20,22,25,27,30,32,33,35,36,37,38,38,39,39,39,40,40,40,40,40,40
E01018246,EV motorcycles,Number,1,2,4,7,10,14,18,22,26,30,34,38,42,45,48,51,53,55,56,58,58,59,60,60,60,61,61,61,61,61
E01018247,EV motorcycles,Number,1,4,6,11,16,22,28,34,41,48,54,60,66,72,76,81,84,87,90,92,93,94,95,96,96,96,97,97,97,97
E01018248,EV motorcycles,Number,1,1,2,4,6,9,11,13,16,19,21,24,26,28,30,32,33,34,35,36,36,37,37,37,38,38,38,38,38,38
E01018249,EV motorcycles,Number,0,1,2,3,5,6,8,10,11,13,15,17,18,20,21,22,23,24,25,25,26,26,26,27,27,27,27,27,27,27
E01018250,EV motorcycles,Number,0,1,2,3,5,7,9,11,13,15,17,19,21,22,24,25,26,27,28,28,29,29,29,30,30,30,30,30,30,30
E01018251,EV motorcycles,Number,1,2,3,6,9,11,15,18,22,25,29,32,35,38,40,42,44,46,47,48,49,49,50,50,50,51,51,51,51,51
E01018252,EV motorcycles,Number,1,2,3,5,8,11,14,17,20,24,27,30,33,35,38,40,42,43,44,45,46,47,47,47,48,48,48,48,48,48
E01018253,EV motorcycles,Number,0,1,2,3,4,6,7,9,11,12,14,16,17,18,20,21,22,22,23,24,24,24,24,25,25,25,25,25,25,25
E01018254,EV motorcycles,Number,1,2,3,6,8,11,14,18,21,25,28,31,34,37,39,42,43,45,46,47,48,49,49,49,49,50,50,50,50,50
E01018255,EV motorcycles,Number,1,1,3,4,7,9,11,14,16,19,22,24,27,29,31,32,34,35,36,37,37,38,38,38,39,39,39,39,39,39
E01018256,EV motorcycles,Number,1,2,3,5,8,11,14,17,21,24,27,31,33,36,39,41,43,44,45,46,47,48,48,48,48,49,49,49,49,49
E01018257,EV motorcycles,Number,0,1,2,4,5,7,9,11,14,16,18,20,22,24,25,27,28,29,30,30,31,31,31,32,32,32,32,32,32,32
E01018258,EV motorcycles,Number,1,2,3,6,9,12,15,19,22,26,30,33,36,39,42,44,46,48,49,50,51,51,52,52,52,53,53,53,53,53
E01018259,EV motorcycles,Number,1,1,2,4,6,8,10,12,15,17,20,22,24,26,28,29,30,31,32,33,34,34,34,34,35,35,35,35,35,35
E01018260,EV motorcycles,Number,1,1,2,4,6,8,11,13,16,18,21,23,25,27,29,31,32,33,34,35,35,36,36,36,37,37,37,37,37,37
E01018262,EV motorcycles,Number,0,1,2,3,5,7,9,11,13,15,17,19,21,22,24,25,26,27,28,28,29,29,29,30,30,30,30,30,30,30
E01018263,EV motorcycles,Number,1,1,3,4,7,9,11,14,16,19,22,24,27,29,31,32,34,35,36,37,37,38,38,38,39,39,39,39,39,39
E01018264,EV motorcycles,Number,1,1,2,4,6,8,11,13,16,18,21,23,25,27,29,31,32,33,34,35,35,36,36,36,37,37,37,37,37,37
E01018265,EV motorcycles,Number,1,1,3,4,7,9,12,14,17,20,22,25,27,30,32,33,35,36,37,38,38,39,39,39,40,40,40,40,40,40
E01018266,EV motorcycles,Number,2,5,9,14,22,29,38,47,55,64,73,82,90,97,103,109,114,118,121,124,126,127,128,129,130,130,131,131,131,131
E01018267,EV motorcycles,Number,1,2,4,7,11,15,20,24,29,33,38,42,46,50,54,57,59,61,63,64,65,66,67,67,67,68,68,68,68,68
E01018268,EV motorcycles,Number,1,3,5,8,12,16,21,26,30,35,40,45,49,53,57,60,63,65,67,68,69,70,70,71,71,71,72,72,72,72
E01018269,EV motorcycles,Number,0,1,2,3,5,6,8,10,11,13,15,17,18,20,21,22,23,24,25,25,26,26,26,27,27,27,27,27,27,27
E01018270,EV motorcycles,Number,1,2,3,6,8,11,14,18,21,25,28,31,34,37,39,42,43,45,46,47,48,49,49,49,49,50,50,50,50,50
E01018271,EV motorcycles,Number,1,1,2,4,6,9,11,13,16,19,21,24,26,28,30,32,33,34,35,36,36,37,37,37,38,38,38,38,38,38
E01018272,EV motorcycles,Number,0,1,2,3,4,5,7,8,10,11,13,14,16,17,18,19,20,21,21,22,22,22,23,23,23,23,23,23,23,23
E01018273,EV motorcycles,Number,1,2,3,6,9,12,15,19,22,26,30,33,36,39,42,44,46,48,49,50,51,51,52,52,52,53,53,53,53,53
E01018274,EV motorcycles,Number,0,1,2,3,5,7,9,11,13,15,17,19,21,23,24,26,27,28,29,29,30,30,30,31,31,31,31,31,31,31
E01018275,EV motorcycles,Number,1,3,5,9,14,19,24,29,35,41,46,52,57,61,65,69,72,75,77,78,80,81,81,82,82,82,83,83,83,83
E01018276,EV motorcycles,Number,1,2,3,5,8,10,13,16,19,23,26,29,31,34,36,38,40,41,43,43,44,45,45,45,46,46,46,46,46,46
E01018277,EV motorcycles,Number,1,3,5,8,12,17,21,26,31,36,41,46,51,55,58,62,64,67,68,70,71,72,72,73,73,73,74,74,74,74
E01018278,EV motorcycles,Number,1,2,4,7,11,15,20,24,29,33,38,42,46,50,54,57,59,61,63,64,65,66,67,67,67,68,68,68,68,68
E01018279,EV motorcycles,Number,0,1,2,3,4,5,7,8,10,11,13,14,16,17,18,19,20,21,21,22,22,22,23,23,23,23,23,23,23,23
E01018280,EV motorcycles,Number,0,1,2,4,5,7,9,11,14,16,18,20,22,24,25,27,28,29,30,30,31,31,31,32,32,32,32,32,32,32
E01018281,EV motorcycles,Number,0,1,2,3,5,7,9,11,13,15,17,19,21,23,24,26,27,28,29,29,30,30,30,31,31,31,31,31,31,31
E01018282,EV motorcycles,Number,1,1,3,4,7,9,12,14,17,20,22,25,27,30,32,33,35,36,37,38,38,39,39,39,40,40,40,40,40,40
E01018283,EV motorcycles,Number,0,1,2,3,5,6,8,10,11,13,15,17,18,20,21,22,23,24,25,25,26,26,26,27,27,27,27,27,27,27
E01018284,EV motorcycles,Number,1,2,3,5,8,10,13,16,19,23,26,29,31,34,36,38,40,41,43,43,44,45,45,45,46,46,46,46,46,46
E01018285,EV motorcycles,Number,1,2,3,6,8,11,14,18,21,25,28,31,34,37,39,42,43,45,46,47,48,49,49,49,49,50,50,50,50,50
E01018286,EV motorcycles,Number,1,1,3,4,7,9,11,14,16,19,22,24,27,29,31,32,34,35,36,37,37,38,38,38,39,39,39,39,39,39
E01018287,EV motorcycles,Number,0,1,1,2,3,3,4,5,6,7,8,9,10,11,12,12,13,13,14,14,14,15,15,15,15,15,15,15,15,15
E01018288,EV motorcycles,Number,1,1,3,4,7,9,11,14,16,19,22,24,27,29,31,32,34,35,36,37,37,38,38,38,39,39,39,39,39,39
E01018289,EV motorcycles,Number,1,2,4,7,11,15,19,24,28,33,37,42,46,50,53,56,58,60,62,63,64,65,66,66,66,67,67,67,67,67
E01018290,EV motorcycles,Number,1,3,5,8,12,17,21,26,31,36,41,46,51,55,58,62,64,67,68,70,71,72,72,73,73,73,74,74,74,74
E01018291,EV motorcycles,Number,0,1,1,2,3,4,5,6,7,8,10,11,12,13,13,14,15,15,16,16,16,16,17,17,17,17,17,17,17,17
E01018292,EV motorcycles,Number,0,1,2,3,4,5,7,9,10,12,13,15,16,18,19,20,21,22,22,23,23,23,23,24,24,24,24,24,24,24
E01018293,EV motorcycles,Number,0,1,1,2,3,4,5,6,8,9,10,11,12,13,14,15,16,16,17,17,17,17,18,18,18,18,18,18,18,18
E01018294,EV motorcycles,Number,1,1,2,4,6,8,10,12,15,17,20,22,24,26,28,29,30,31,32,33,34,34,34,34,35,35,35,35,35,35
E01018295,EV motorcycles,Number,0,1,2,3,5,7,9,11,13,15,17,19,21,23,24,26,27,28,29,29,30,30,30,31,31,31,31,31,31,31
E01018296,EV motorcycles,Number,1,2,4,6,9,12,16,19,23,27,30,34,37,40,43,45,47,49,50,51,52,52,53,53,53,54,54,54,54,54
E01018297,EV motorcycles,Number,1,3,5,9,14,19,24,29,35,41,46,52,57,61,65,69,72,75,77,78,80,81,81,82,82,82,83,83,83,83
E01018298,EV motorcycles,Number,1,2,3,5,7,10,13,16,19,22,25,27,30,33,35,37,38,40,41,42,42,43,43,43,44,44,44,44,44,44
E01018299,EV motorcycles,Number,1,2,4,7,11,15,19,23,27,32,36,40,44,48,51,54,56,58,60,61,62,63,64,64,64,65,65,65,65,65
E01018300,EV motorcycles,Number,1,1,3,5,7,9,12,15,17,20,23,26,28,30,32,34,36,37,38,39,39,40,40,40,41,41,41,41,41,41
E01018301,EV motorcycles,Number,0,1,2,4,6,7,10,12,14,16,18,21,23,24,26,27,29,30,31,31,32,32,32,33,33,33,33,33,33,33
E01018302,EV motorcycles,Number,1,1,2,4,6,9,11,13,16,19,21,24,26,28,30,32,33,34,35,36,36,37,37,37,38,38,38,38,38,38
E01018303,EV motorcycles,Number,1,1,2,4,6,8,10,13,15,18,20,22,25,27,28,30,31,32,33,34,35,35,35,35,36,36,36,36,36,36
E01018304,EV motorcycles,Number,1,2,3,6,9,11,15,18,22,25,29,32,35,38,40,42,44,46,47,48,49,49,50,50,50,51,51,51,51,51
E01018305,EV motorcycles,Number,1,2,4,6,10,13,16,20,24,28,32,35,39,42,45,47,50,51,53,54,55,55,56,56,56,57,57,57,57,57
E01018306,EV motorcycles,Number,1,2,3,6,9,12,15,18,22,26,29,32,36,38,41,43,45,47,48,49,50,50,51,51,51,52,52,52,52,52
E01018307,EV motorcycles,Number,1,2,4,7,10,14,18,22,26,30,34,38,42,45,48,51,53,55,56,58,58,59,60,60,60,61,61,61,61,61
E01020910,EV motorcycles,Number,0,1,2,3,5,7,8,10,12,14,16,18,20,21,23,24,25,26,27,27,28,28,28,29,29,29,29,29,29,29
E01020911,EV motorcycles,Number,0,1,2,3,5,7,8,10,12,14,16,18,20,21,23,24,25,26,27,27,28,28,28,29,29,29,29,29,29,29
E01020912,EV motorcycles,Number,1,1,2,4,6,8,10,12,15,17,20,22,24,26,28,29,30,31,32,33,34,34,34,34,35,35,35,35,35,35
E01020913,EV motorcycles,Number,1,1,2,4,6,9,11,13,16,19,21,24,26,28,30,32,33,34,35,36,36,37,37,37,38,38,38,38,38,38
E01020914,EV motorcycles,Number,1,1,3,4,7,9,11,14,16,19,22,24,27,29,31,32,34,35,36,37,37,38,38,38,39,39,39,39,39,39
E01020915,EV motorcycles,Number,0,1,1,2,3,4,5,6,7,8,9,10,11,12,13,13,14,14,15,15,15,16,16,16,16,16,16,16,16,16
E01020916,EV motorcycles,Number,0,1,2,3,4,6,7,9,11,12,14,16,17,18,20,21,22,22,23,24,24,24,24,25,25,25,25,25,25,25
E01020917,EV motorcycles,Number,1,1,2,4,6,9,11,13,16,19,21,24,26,28,30,32,33,34,35,36,36,37,37,37,38,38,38,38,38,38
E01020918,EV motorcycles,Number,1,2,3,5,7,10,13,16,19,22,25,27,30,33,35,37,38,40,41,42,42,43,43,43,44,44,44,44,44,44
E01020919,EV motorcycles,Number,1,1,3,4,7,9,12,14,17,20,22,25,27,30,32,33,35,36,37,38,38,39,39,39,40,40,40,40,40,40
E01020920,EV motorcycles,Number,0,1,2,3,5,7,9,11,13,15,17,19,21,23,24,26,27,28,29,29,30,30,30,31,31,31,31,31,31,31
E01020921,EV motorcycles,Number,0,1,2,3,4,6,8,9,11,13,15,16,18,19,20,22,23,23,24,25,25,25,25,26,26,26,26,26,26,26
E01020922,EV motorcycles,Number,1,2,3,5,7,9,12,15,18,21,24,26,29,31,33,35,36,38,39,40,40,41,41,41,42,42,42,42,42,42
E01020923,EV motorcycles,Number,0,1,2,3,4,6,7,9,11,12,14,16,17,18,20,21,22,22,23,24,24,24,24,25,25,25,25,25,25,25
E01020924,EV motorcycles,Number,1,1,2,4,6,9,11,13,16,19,21,24,26,28,30,32,33,34,35,36,36,37,37,37,38,38,38,38,38,38
E01020925,EV motorcycles,Number,0,1,2,4,5,7,9,11,14,16,18,20,22,24,25,27,28,29,30,30,31,31,31,32,32,32,32,32,32,32
E01020926,EV motorcycles,Number,1,2,4,6,10,13,16,20,24,28,32,35,39,42,45,47,50,51,53,54,55,55,56,56,56,57,57,57,57,57
E01020927,EV motorcycles,Number,1,2,3,5,8,10,13,16,19,22,25,28,31,33,35,37,39,40,42,42,43,44,44,44,45,45,45,45,45,45
E01020928,EV motorcycles,Number,1,2,3,5,7,9,12,15,18,21,24,26,29,31,33,35,36,38,39,40,40,41,41,41,42,42,42,42,42,42
E01020929,EV motorcycles,Number,0,1,2,4,5,7,9,11,14,16,18,20,22,24,25,27,28,29,30,30,31,31,31,32,32,32,32,32,32,32
E01020930,EV motorcycles,Number,1,2,3,5,7,9,12,15,18,21,24,26,29,31,33,35,36,38,39,40,40,41,41,41,42,42,42,42,42,42
E01020931,EV motorcycles,Number,0,1,1,2,3,4,5,6,8,9,10,11,12,13,14,15,16,16,17,17,17,17,18,18,18,18,18,18,18,18
E01020932,EV motorcycles,Number,0,1,1,2,3,4,5,7,8,9,11,12,13,14,15,16,17,17,18,18,18,18,19,19,19,19,19,19,19,19
E01020933,EV motorcycles,Number,0,1,1,2,4,5,6,8,9,11,12,14,15,16,17,18,19,20,20,21,21,21,22,22,22,22,22,22,22,22
E01020934,EV motorcycles,Number,0,0,1,1,2,2,3,4,4,5,6,6,7,7,8,8,9,9,9,9,10,10,10,10,10,10,10,10,10,10
E01020935,EV motorcycles,Number,0,1,1,2,4,5,6,7,9,10,12,13,14,16,17,17,18,19,19,20,20,20,21,21,21,21,21,21,21,21
E01020936,EV motorcycles,Number,0,1,1,2,2,3,4,5,6,7,8,9,10,10,11,12,12,13,13,13,13,14,14,14,14,14,14,14,14,14
E01020937,EV motorcycles,Number,0,0,1,1,2,3,3,4,5,6,7,7,8,9,9,10,10,11,11,11,12,12,12,12,12,12,12,12,12,12
E01020938,EV motorcycles,Number,0,1,2,3,4,6,8,9,11,13,15,16,18,19,20,22,23,23,24,25,25,25,25,26,26,26,26,26,26,26
E01020939,EV motorcycles,Number,0,1,1,2,3,4,5,6,7,8,10,11,12,13,13,14,15,15,16,16,16,16,17,17,17,17,17,17,17,17
E01020940,EV motorcycles,Number,0,1,2,3,5,7,8,10,12,14,16,18,20,21,23,24,25,26,27,27,28,28,28,29,29,29,29,29,29,29
E01020941,EV motorcycles,Number,0,1,2,3,5,7,9,11,13,15,17,19,21,22,24,25,26,27,28,28,29,29,29,30,30,30,30,30,30,30
E01020942,EV motorcycles,Number,1,1,3,4,7,9,11,14,16,19,22,24,27,29,31,32,34,35,36,37,37,38,38,38,39,39,39,39,39,39
E01020943,EV motorcycles,Number,0,1,2,3,4,6,8,9,11,13,15,16,18,19,20,22,23,23,24,25,25,25,25,26,26,26,26,26,26,26
E01020944,EV motorcycles,Number,0,0,1,1,2,3,4,5,5,6,7,8,9,10,10,11,11,12,12,12,12,13,13,13,13,13,13,13,13,13
E01020945,EV motorcycles,Number,0,1,2,4,6,8,10,12,14,17,19,21,23,25,27,28,30,31,31,32,33,33,33,33,34,34,34,34,34,34
E01020946,EV motorcycles,Number,0,1,2,3,5,7,9,11,13,15,17,19,21,23,24,26,27,28,29,29,30,30,30,31,31,31,31,31,31,31
E01020947,EV motorcycles,Number,0,1,2,3,5,6,8,10,12,14,16,17,19,21,22,23,24,25,26,26,27,27,27,28,28,28,28,28,28,28
E01020948,EV motorcycles,Number,0,1,2,3,5,6,8,10,11,13,15,17,18,20,21,22,23,24,25,25,26,26,26,27,27,27,27,27,27,27
E01020949,EV motorcycles,Number,1,2,3,5,8,10,13,16,19,22,25,28,31,33,35,37,39,40,42,42,43,44,44,44,45,45,45,45,45,45
E01020950,EV motorcycles,Number,1,1,2,4,6,9,11,13,16,19,21,24,26,28,30,32,33,34,35,36,36,37,37,37,38,38,38,38,38,38
E01020951,EV motorcycles,Number,1,2,3,6,9,11,15,18,22,25,29,32,35,38,40,42,44,46,47,48,49,49,50,50,50,51,51,51,51,51
E01020952,EV motorcycles,Number,1,1,3,4,7,9,11,14,16,19,22,24,27,29,31,32,34,35,36,37,37,38,38,38,39,39,39,39,39,39
E01020953,EV motorcycles,Number,0,1,2,3,5,7,9,11,13,15,17,19,21,23,24,26,27,28,29,29,30,30,30,31,31,31,31,31,31,31
E01020954,EV motorcycles,Number,0,1,2,3,5,6,8,10,12,14,16,17,19,21,22,23,24,25,26,26,27,27,27,28,28,28,28,28,28,28
E01020955,EV motorcycles,Number,0,1,2,3,5,7,9,11,13,15,17,19,21,22,24,25,26,27,28,28,29,29,29,30,30,30,30,30,30,30
E01020956,EV motorcycles,Number,1,2,4,6,9,12,16,19,23,27,30,34,37,40,43,45,47,49,50,51,52,52,53,53,53,54,54,54,54,54
E01020957,EV motorcycles,Number,0,1,2,3,5,7,9,11,13,15,17,19,21,22,24,25,26,27,28,28,29,29,29,30,30,30,30,30,30,30
E01020959,EV motorcycles,Number,0,1,2,3,5,7,8,10,12,14,16,18,20,21,23,24,25,26,27,27,28,28,28,29,29,29,29,29,29,29
E01020960,EV motorcycles,Number,1,2,3,5,8,10,13,16,19,22,25,28,31,33,35,37,39,40,42,42,43,44,44,44,45,45,45,45,45,45
E01020961,EV motorcycles,Number,1,1,2,4,6,8,10,13,15,18,20,22,25,27,28,30,31,32,33,34,35,35,35,35,36,36,36,36,36,36
E01020962,EV motorcycles,Number,1,2,3,5,8,10,13,16,19,22,25,28,31,33,35,37,39,40,42,42,43,44,44,44,45,45,45,45,45,45
E01020963,EV motorcycles,Number,1,1,3,5,7,9,12,15,17,20,23,26,28,30,32,34,36,37,38,39,39,40,40,40,41,41,41,41,41,41
E01020964,EV motorcycles,Number,0,1,1,2,4,5,6,7,9,10,12,13,14,16,17,17,18,19,19,20,20,20,21,21,21,21,21,21,21,21
E01020965,EV motorcycles,Number,0,1,2,3,5,7,9,11,13,15,17,19,21,23,24,26,27,28,29,29,30,30,30,31,31,31,31,31,31,31
E01020966,EV motorcycles,Number,0,1,2,3,5,6,8,10,11,13,15,17,18,20,21,22,23,24,25,25,26,26,26,27,27,27,27,27,27,27
E01020967,EV motorcycles,Number,0,1,2,3,4,6,7,9,11,12,14,16,17,18,20,21,22,22,23,24,24,24,24,25,25,25,25,25,25,25
E01020968,EV motorcycles,Number,0,1,2,3,5,6,8,10,12,14,16,17,19,21,22,23,24,25,26,26,27,27,27,28,28,28,28,28,28,28
E01020969,EV motorcycles,Number,1,1,3,5,7,9,12,15,17,20,23,26,28,30,32,34,36,37,38,39,39,40,40,40,41,41,41,41,41,41
E01020970,EV motorcycles,Number,1,4,6,11,17,22,29,35,42,49,55,62,68,73,78,82,86,89,92,93,95,96,97,98,98,98,99,99,99,99
E01020971,EV motorcycles,Number,1,2,4,7,10,14,18,22,26,30,35,39,42,46,49,52,54,56,57,59,59,60,61,61,61,62,62,62,62,62
E01020972,EV motorcycles,Number,1,2,3,5,8,11,14,17,20,24,27,30,33,35,38,40,42,43,44,45,46,47,47,47,48,48,48,48,48,48
E01020973,EV motorcycles,Number,1,2,4,7,10,14,18,22,26,30,34,38,42,45,48,51,53,55,56,58,58,59,60,60,60,61,61,61,61,61
E01020974,EV motorcycles,Number,1,2,4,7,10,14,18,22,26,30,35,39,42,46,49,52,54,56,57,59,59,60,61,61,61,62,62,62,62,62
E01020975,EV motorcycles,Number,0,1,2,4,6,7,10,12,14,16,18,21,23,24,26,27,29,30,31,31,32,32,32,33,33,33,33,33,33,33
E01020976,EV motorcycles,Number,1,2,3,5,7,10,13,16,19,22,25,27,30,33,35,37,38,40,41,42,42,43,43,43,44,44,44,44,44,44
E01020977,EV motorcycles,Number,1,2,4,7,10,13,17,21,25,29,33,37,40,44,47,49,51,53,55,56,57,57,58,58,58,59,59,59,59,59
E01020978,EV motorcycles,Number,0,1,2,4,5,7,9,11,14,16,18,20,22,24,25,27,28,29,30,30,31,31,31,32,32,32,32,32,32,32
E01020979,EV motorcycles,Number,1,1,2,4,6,8,10,13,15,18,20,22,25,27,28,30,31,32,33,34,35,35,35,35,36,36,36,36,36,36
E01020980,EV motorcycles,Number,1,1,2,4,6,8,10,12,15,17,20,22,24,26,28,29,30,31,32,33,34,34,34,34,35,35,35,35,35,35
E01020981,EV motorcycles,Number,0,1,2,3,4,6,7,9,11,12,14,16,17,18,20,21,22,22,23,24,24,24,24,25,25,25,25,25,25,25
E01020982,EV motorcycles,Number,1,1,3,4,7,9,12,14,17,20,22,25,27,30,32,33,35,36,37,38,38,39,39,39,40,40,40,40,40,40
E01020983,EV motorcycles,Number,0,1,1,2,3,4,5,6,8,9,10,11,12,13,14,15,16,16,17,17,17,17,18,18,18,18,18,18,18,18
E01020984,EV motorcycles,Number,0,1,2,3,4,6,7,9,11,12,14,16,17,18,20,21,22,22,23,24,24,24,24,25,25,25,25,25,25,25
E01020985,EV motorcycles,Number,0,1,2,4,6,8,10,12,14,17,19,21,23,25,27,28,30,31,31,32,33,33,33,33,34,34,34,34,34,34
E01020986,EV motorcycles,Number,1,2,4,7,11,15,19,23,28,32,37,41,45,49,52,55,57,59,61,62,63,64,65,65,65,66,66,66,66,66
E01020987,EV motorcycles,Number,1,1,3,4,7,9,12,14,17,20,22,25,27,30,32,33,35,36,37,38,38,39,39,39,40,40,40,40,40,40
E01020988,EV motorcycles,Number,1,2,4,7,10,14,18,22,26,30,34,38,42,45,48,51,53,55,56,58,58,59,60,60,60,61,61,61,61,61
E01020989,EV motorcycles,Number,0,1,1,2,3,4,6,7,8,10,11,12,14,15,16,17,17,18,18,19,19,19,20,20,20,20,20,20,20,20
E01020990,EV motorcycles,Number,0,1,2,3,5,6,8,10,12,14,16,17,19,21,22,23,24,25,26,26,27,27,27,28,28,28,28,28,28,28
E01020991,EV motorcycles,Number,0,1,1,2,3,4,5,7,8,9,11,12,13,14,15,16,17,17,18,18,18,18,19,19,19,19,19,19,19,19
E01020992,EV motorcycles,Number,0,1,2,4,6,8,10,12,14,17,19,21,23,25,27,28,30,31,31,32,33,33,33,33,34,34,34,34,34,34
E01020993,EV motorcycles,Number,1,2,3,5,8,11,14,17,20,24,27,30,33,35,38,40,42,43,44,45,46,47,47,47,48,48,48,48,48,48
E01020994,EV motorcycles,Number,0,1,1,2,3,4,6,7,8,10,11,12,14,15,16,17,17,18,18,19,19,19,20,20,20,20,20,20,20,20
E01020995,EV motorcycles,Number,1,2,3,5,7,10,12,15,18,21,24,27,29,32,34,36,37,39,40,41,41,42,42,42,43,43,43,43,43,43
E01020996,EV motorcycles,Number,1,2,4,7,11,14,19,23,27,31,36,40,44,47,50,53,56,58,59,60,61,62,63,63,63,64,64,64,64,64
E01020997,EV motorcycles,Number,1,2,3,5,8,11,14,17,20,24,27,30,33,35,38,40,42,43,44,45,46,47,47,47,48,48,48,48,48,48
E01020998,EV motorcycles,Number,1,2,3,5,7,10,12,15,18,21,24,27,29,32,34,36,37,39,40,41,41,42,42,42,43,43,43,43,43,43
E01020999,EV motorcycles,Number,1,2,4,6,9,13,16,20,24,28,31,35,38,41,44,47,49,50,52,53,54,54,55,55,55,56,56,56,56,56
E01021000,EV motorcycles,Number,1,1,3,4,7,9,11,14,16,19,22,24,27,29,31,32,34,35,36,37,37,38,38,38,39,39,39,39,39,39
E01021001,EV motorcycles,Number,0,1,2,3,5,6,8,10,12,14,16,17,19,21,22,23,24,25,26,26,27,27,27,28,28,28,28,28,28,28
E01021002,EV motorcycles,Number,1,1,2,4,6,9,11,13,16,19,21,24,26,28,30,32,33,34,35,36,36,37,37,37,38,38,38,38,38,38
E01021003,EV motorcycles,Number,0,1,1,2,4,5,6,7,9,10,12,13,14,16,17,17,18,19,19,20,20,20,21,21,21,21,21,21,21,21
E01021004,EV motorcycles,Number,1,3,6,10,16,21,27,33,40,46,53,59,64,69,74,78,82,85,87,89,90,91,92,93,93,93,94,94,94,94
E01021005,EV motorcycles,Number,1,2,3,5,8,11,14,17,20,23,26,29,32,35,37,39,41,42,43,44,45,46,46,46,47,47,47,47,47,47
E01021006,EV motorcycles,Number,1,2,3,5,8,10,13,16,19,23,26,29,31,34,36,38,40,41,43,43,44,45,45,45,46,46,46,46,46,46
E01021007,EV motorcycles,Number,1,3,5,8,12,16,20,25,30,34,39,44,48,52,55,58,61,63,65,66,67,68,69,69,69,70,70,70,70,70
E01021008,EV motorcycles,Number,0,1,2,4,6,8,10,12,14,17,19,21,23,25,27,28,30,31,31,32,33,33,33,33,34,34,34,34,34,34
E01021009,EV motorcycles,Number,1,2,5,8,12,15,20,25,29,34,39,43,47,51,54,57,60,62,64,65,66,67,68,68,68,69,69,69,69,69
E01021010,EV motorcycles,Number,1,2,4,7,11,15,19,23,28,32,37,41,45,49,52,55,57,59,61,62,63,64,65,65,65,66,66,66,66,66
E01021011,EV motorcycles,Number,1,2,3,5,8,11,14,17,21,24,27,31,33,36,39,41,43,44,45,46,47,48,48,48,48,49,49,49,49,49
E01021012,EV motorcycles,Number,1,2,3,5,7,9,12,15,18,21,24,26,29,31,33,35,36,38,39,40,40,41,41,41,42,42,42,42,42,42
E01021013,EV motorcycles,Number,1,2,4,7,10,14,18,22,26,30,34,38,42,45,48,51,53,55,56,58,58,59,60,60,60,61,61,61,61,61
E01021014,EV motorcycles,Number,1,1,2,4,6,8,10,12,15,17,20,22,24,26,28,29,30,31,32,33,34,34,34,34,35,35,35,35,35,35
E01021015,EV motorcycles,Number,1,1,2,4,6,8,10,13,15,18,20,22,25,27,28,30,31,32,33,34,35,35,35,35,36,36,36,36,36,36
E01021016,EV motorcycles,Number,1,2,4,6,9,13,16,20,24,28,31,35,38,41,44,47,49,50,52,53,54,54,55,55,55,56,56,56,56,56
E01021017,EV motorcycles,Number,1,2,4,7,11,14,19,23,27,31,36,40,44,47,50,53,56,58,59,60,61,62,63,63,63,64,64,64,64,64
E01021018,EV motorcycles,Number,1,2,4,7,11,15,19,24,28,33,37,42,46,50,53,56,58,60,62,63,64,65,66,66,66,67,67,67,67,67
E01021019,EV motorcycles,Number,0,1,2,4,6,7,10,12,14,16,18,21,23,24,26,27,29,30,31,31,32,32,32,33,33,33,33,33,33,33
E01021020,EV motorcycles,Number,1,1,3,5,7,9,12,15,17,20,23,26,28,30,32,34,36,37,38,39,39,40,40,40,41,41,41,41,41,41
E01021021,EV motorcycles,Number,1,3,5,9,14,19,24,30,36,41,47,52,57,62,66,70,73,76,78,79,81,82,82,83,83,83,84,84,84,84
E01021022,EV motorcycles,Number,1,3,5,9,13,18,23,28,33,38,44,49,53,58,61,65,68,70,72,74,75,76,76,77,77,77,78,78,78,78
E01021023,EV motorcycles,Number,1,2,5,8,12,15,20,25,29,34,39,43,47,51,54,57,60,62,64,65,66,67,68,68,68,69,69,69,69,69
E01021024,EV motorcycles,Number,1,1,3,4,7,9,11,14,16,19,22,24,27,29,31,32,34,35,36,37,37,38,38,38,39,39,39,39,39,39
E01021025,EV motorcycles,Number,1,3,5,8,13,17,22,27,32,37,42,47,51,55,59,62,65,67,69,71,72,73,73,74,74,74,75,75,75,75
E01021026,EV motorcycles,Number,1,4,6,11,16,22,28,35,41,48,55,61,67,72,77,82,85,88,91,93,94,95,96,97,97,97,98,98,98,98
E01021027,EV motorcycles,Number,1,2,3,6,9,12,15,18,22,26,29,32,36,38,41,43,45,47,48,49,50,50,51,51,51,52,52,52,52,52
E01021028,EV motorcycles,Number,1,2,3,5,8,10,13,16,19,23,26,29,31,34,36,38,40,41,43,43,44,45,45,45,46,46,46,46,46,46
E01021029,EV motorcycles,Number,1,1,2,4,6,8,10,12,15,17,20,22,24,26,28,29,30,31,32,33,34,34,34,34,35,35,35,35,35,35
E01021030,EV motorcycles,Number,1,2,3,5,7,10,13,16,19,22,25,27,30,33,35,37,38,40,41,42,42,43,43,43,44,44,44,44,44,44
E01021031,EV motorcycles,Number,0,1,2,3,5,6,8,10,12,14,16,17,19,21,22,23,24,25,26,26,27,27,27,28,28,28,28,28,28,28
E01021032,EV motorcycles,Number,1,2,4,7,10,13,17,21,25,29,33,37,40,44,47,49,51,53,55,56,57,57,58,58,58,59,59,59,59,59
E01021033,EV motorcycles,Number,1,1,2,4,6,8,11,13,16,18,21,23,25,27,29,31,32,33,34,35,35,36,36,36,37,37,37,37,37,37
E01021034,EV motorcycles,Number,0,1,2,3,4,5,7,9,10,12,13,15,16,18,19,20,21,22,22,23,23,23,23,24,24,24,24,24,24,24
E01021035,EV motorcycles,Number,0,1,2,3,4,6,7,9,11,12,14,16,17,18,20,21,22,22,23,24,24,24,24,25,25,25,25,25,25,25
E01021036,EV motorcycles,Number,0,1,2,4,5,7,9,11,14,16,18,20,22,24,25,27,28,29,30,30,31,31,31,32,32,32,32,32,32,32
E01021037,EV motorcycles,Number,0,1,1,2,3,4,6,7,8,10,11,12,14,15,16,17,17,18,18,19,19,19,20,20,20,20,20,20,20,20
E01021038,EV motorcycles,Number,0,1,1,2,3,4,6,7,8,10,11,12,14,15,16,17,17,18,18,19,19,19,20,20,20,20,20,20,20,20
E01021039,EV motorcycles,Number,0,1,1,2,3,4,5,6,8,9,10,11,12,13,14,15,16,16,17,17,17,17,18,18,18,18,18,18,18,18
E01021040,EV motorcycles,Number,0,1,1,2,3,4,5,6,7,8,9,10,11,12,13,13,14,14,15,15,15,16,16,16,16,16,16,16,16,16
E01021041,EV motorcycles,Number,0,1,2,3,4,5,7,9,10,12,13,15,16,18,19,20,21,22,22,23,23,23,23,24,24,24,24,24,24,24
E01021042,EV motorcycles,Number,0,1,2,3,4,5,7,9,10,12,13,15,16,18,19,20,21,22,22,23,23,23,23,24,24,24,24,24,24,24
E01021043,EV motorcycles,Number,0,1,1,2,4,5,6,7,9,10,12,13,14,16,17,17,18,19,19,20,20,20,21,21,21,21,21,21,21,21
E01021044,EV motorcycles,Number,1,2,4,7,11,14,19,23,27,31,36,40,44,47,50,53,56,58,59,60,61,62,63,63,63,64,64,64,64,64
E01021045,EV motorcycles,Number,1,2,4,6,9,13,16,20,24,28,31,35,38,41,44,47,49,50,52,53,54,54,55,55,55,56,56,56,56,56
E01021046,EV motorcycles,Number,1,2,3,5,8,10,13,16,19,23,26,29,31,34,36,38,40,41,43,43,44,45,45,45,46,46,46,46,46,46
E01021047,EV motorcycles,Number,1,2,3,5,8,11,14,17,20,23,26,29,32,35,37,39,41,42,43,44,45,46,46,46,47,47,47,47,47,47
E01021048,EV motorcycles,Number,0,1,2,3,5,7,9,11,13,15,17,19,21,22,24,25,26,27,28,28,29,29,29,30,30,30,30,30,30,30
E01021049,EV motorcycles,Number,0,1,2,3,4,6,7,9,11,12,14,16,17,18,20,21,22,22,23,24,24,24,24,25,25,25,25,25,25,25
E01021050,EV motorcycles,Number,0,1,2,4,6,7,10,12,14,16,18,21,23,24,26,27,29,30,31,31,32,32,32,33,33,33,33,33,33,33
E01021051,EV motorcycles,Number,0,1,2,3,4,5,7,9,10,12,13,15,16,18,19,20,21,22,22,23,23,23,23,24,24,24,24,24,24,24
E01021052,EV motorcycles,Number,0,1,2,3,5,7,9,11,13,15,17,19,21,23,24,26,27,28,29,29,30,30,30,31,31,31,31,31,31,31
E01021053,EV motorcycles,Number,1,2,3,5,8,11,14,17,21,24,27,31,33,36,39,41,43,44,45,46,47,48,48,48,48,49,49,49,49,49
E01021054,EV motorcycles,Number,1,2,4,7,10,14,18,22,26,30,34,38,42,45,48,51,53,55,56,58,58,59,60,60,60,61,61,61,61,61
E01021055,EV motorcycles,Number,1,2,4,6,9,13,16,20,24,28,31,35,38,41,44,47,49,50,52,53,54,54,55,55,55,56,56,56,56,56
E01021056,EV motorcycles,Number,1,3,6,10,16,21,27,33,39,46,52,58,64,69,73,77,81,84,86,88,89,90,91,92,92,92,93,93,93,93
E01021057,EV motorcycles,Number,1,1,3,5,7,9,12,15,17,20,23,26,28,30,32,34,36,37,38,39,39,40,40,40,41,41,41,41,41,41
E01021058,EV motorcycles,Number,1,2,4,7,10,14,18,22,26,30,34,38,42,45,48,51,53,55,56,58,58,59,60,60,60,61,61,61,61,61
E01021059,EV motorcycles,Number,0,1,2,4,6,8,10,12,14,17,19,21,23,25,27,28,30,31,31,32,33,33,33,33,34,34,34,34,34,34
E01021060,EV motorcycles,Number,1,3,5,9,13,18,23,28,33,38,44,49,53,58,61,65,68,70,72,74,75,76,76,77,77,77,78,78,78,78
E01021061,EV motorcycles,Number,1,1,3,4,7,9,11,14,16,19,22,24,27,29,31,32,34,35,36,37,37,38,38,38,39,39,39,39,39,39
E01021062,EV motorcycles,Number,1,2,3,5,7,10,13,16,19,22,25,27,30,33,35,37,38,40,41,42,42,43,43,43,44,44,44,44,44,44
E01021063,EV motorcycles,Number,1,2,3,6,9,11,15,18,22,25,29,32,35,38,40,42,44,46,47,48,49,49,50,50,50,51,51,51,51,51
E01021064,EV motorcycles,Number,1,2,3,6,9,11,15,18,22,25,29,32,35,38,40,42,44,46,47,48,49,49,50,50,50,51,51,51,51,51
E01021065,EV motorcycles,Number,0,1,1,2,4,5,6,8,9,11,12,14,15,16,17,18,19,20,20,21,21,21,22,22,22,22,22,22,22,22
E01021066,EV motorcycles,Number,1,1,2,4,6,8,11,13,16,18,21,23,25,27,29,31,32,33,34,35,35,36,36,36,37,37,37,37,37,37
E01021067,EV motorcycles,Number,1,1,2,4,6,8,10,13,15,18,20,22,25,27,28,30,31,32,33,34,35,35,35,35,36,36,36,36,36,36
E01021068,EV motorcycles,Number,0,1,2,3,4,5,7,8,10,11,13,14,16,17,18,19,20,21,21,22,22,22,23,23,23,23,23,23,23,23
E01021069,EV motorcycles,Number,1,1,2,4,6,8,10,12,15,17,20,22,24,26,28,29,30,31,32,33,34,34,34,34,35,35,35,35,35,35
E01021070,EV motorcycles,Number,1,2,3,5,7,10,12,15,18,21,24,27,29,32,34,36,37,39,40,41,41,42,42,42,43,43,43,43,43,43
E01021071,EV motorcycles,Number,0,1,2,4,6,7,10,12,14,16,18,21,23,24,26,27,29,30,31,31,32,32,32,33,33,33,33,33,33,33
E01021072,EV motorcycles,Number,0,1,2,4,6,7,10,12,14,16,18,21,23,24,26,27,29,30,31,31,32,32,32,33,33,33,33,33,33,33
E01021073,EV motorcycles,Number,1,2,3,5,7,10,13,16,19,22,25,27,30,33,35,37,38,40,41,42,42,43,43,43,44,44,44,44,44,44
E01021074,EV motorcycles,Number,1,1,2,4,6,8,10,13,15,18,20,22,25,27,28,30,31,32,33,34,35,35,35,35,36,36,36,36,36,36
E01021075,EV motorcycles,Number,0,1,2,3,4,6,7,9,11,12,14,16,17,18,20,21,22,22,23,24,24,24,24,25,25,25,25,25,25,25
E01021076,EV motorcycles,Number,1,2,3,5,7,10,12,15,18,21,24,27,29,32,34,36,37,39,40,41,41,42,42,42,43,43,43,43,43,43
E01021077,EV motorcycles,Number,1,1,2,4,6,8,11,13,16,18,21,23,25,27,29,31,32,33,34,35,35,36,36,36,37,37,37,37,37,37
E01021078,EV motorcycles,Number,1,1,2,4,6,9,11,13,16,19,21,24,26,28,30,32,33,34,35,36,36,37,37,37,38,38,38,38,38,38
E01021079,EV motorcycles,Number,0,1,2,3,5,6,8,10,12,14,16,17,19,21,22,23,24,25,26,26,27,27,27,28,28,28,28,28,28,28
E01021080,EV motorcycles,Number,0,1,2,3,4,6,8,9,11,13,15,16,18,19,20,22,23,23,24,25,25,25,25,26,26,26,26,26,26,26
E01021081,EV motorcycles,Number,0,1,2,4,6,8,10,12,14,17,19,21,23,25,27,28,30,31,31,32,33,33,33,33,34,34,34,34,34,34
E01021082,EV motorcycles,Number,1,2,4,7,11,15,19,23,27,32,36,40,44,48,51,54,56,58,60,61,62,63,64,64,64,65,65,65,65,65
E01021083,EV motorcycles,Number,0,1,2,3,4,5,7,8,10,11,13,14,16,17,18,19,20,21,21,22,22,22,23,23,23,23,23,23,23,23
E01021084,EV motorcycles,Number,1,1,2,4,6,8,11,13,16,18,21,23,25,27,29,31,32,33,34,35,35,36,36,36,37,37,37,37,37,37
E01021085,EV motorcycles,Number,1,2,3,5,8,11,14,17,20,24,27,30,33,35,38,40,42,43,44,45,46,47,47,47,48,48,48,48,48,48
E01021086,EV motorcycles,Number,1,2,3,6,9,11,15,18,22,25,29,32,35,38,40,42,44,46,47,48,49,49,50,50,50,51,51,51,51,51
E01021087,EV motorcycles,Number,1,2,4,7,11,14,19,23,27,31,36,40,44,47,50,53,56,58,59,60,61,62,63,63,63,64,64,64,64,64
E01021088,EV motorcycles,Number,1,3,6,10,15,20,25,31,37,43,49,55,60,65,69,73,76,79,81,83,84,85,86,87,87,87,88,88,88,88
E01021089,EV motorcycles,Number,1,3,5,9,13,18,23,28,33,39,44,49,54,58,62,66,69,71,73,75,76,77,77,78,78,78,79,79,79,79
E01021090,EV motorcycles,Number,1,1,2,4,6,8,11,13,16,18,21,23,25,27,29,31,32,33,34,35,35,36,36,36,37,37,37,37,37,37
E01021091,EV motorcycles,Number,1,2,4,6,10,13,16,20,24,28,32,35,39,42,45,47,50,51,53,54,55,55,56,56,56,57,57,57,57,57
E01021092,EV motorcycles,Number,0,1,2,3,4,5,7,8,10,11,13,14,16,17,18,19,20,21,21,22,22,22,23,23,23,23,23,23,23,23
E01021093,EV motorcycles,Number,1,2,4,7,11,14,19,23,27,31,36,40,44,47,50,53,56,58,59,60,61,62,63,63,63,64,64,64,64,64
E01021094,EV motorcycles,Number,0,1,2,3,5,7,9,11,13,15,17,19,21,23,24,26,27,28,29,29,30,30,30,31,31,31,31,31,31,31
E01021095,EV motorcycles,Number,0,1,2,4,6,7,10,12,14,16,18,21,23,24,26,27,29,30,31,31,32,32,32,33,33,33,33,33,33,33
E01021096,EV motorcycles,Number,1,2,4,7,10,14,18,22,26,30,34,38,42,45,48,51,53,55,56,58,58,59,60,60,60,61,61,61,61,61
E01021097,EV motorcycles,Number,1,2,4,7,11,15,20,24,29,33,38,42,46,50,54,57,59,61,63,64,65,66,67,67,67,68,68,68,68,68
E01021098,EV motorcycles,Number,1,1,2,4,6,8,11,13,16,18,21,23,25,27,29,31,32,33,34,35,35,36,36,36,37,37,37,37,37,37
E01021099,EV motorcycles,Number,1,2,4,6,10,13,17,21,25,29,32,36,40,43,46,48,50,52,54,55,56,56,57,57,57,58,58,58,58,58
E01021100,EV motorcycles,Number,1,2,4,7,11,15,20,24,29,33,38,42,46,50,54,57,59,61,63,64,65,66,67,67,67,68,68,68,68,68
E01021101,EV motorcycles,Number,1,2,4,7,10,14,18,22,26,30,34,38,42,45,48,51,53,55,56,58,58,59,60,60,60,61,61,61,61,61
E01021102,EV motorcycles,Number,2,5,9,16,24,32,41,50,60,70,79,88,97,105,112,118,123,128,131,134,136,138,139,140,141,141,142,142,142,142
E01021103,EV motorcycles,Number,1,2,4,6,9,12,16,20,23,27,31,34,38,41,43,46,48,49,51,52,53,53,54,54,54,55,55,55,55,55
E01021104,EV motorcycles,Number,1,3,5,8,12,16,21,26,30,35,40,45,49,53,57,60,63,65,67,68,69,70,70,71,71,71,72,72,72,72
E01021105,EV motorcycles,Number,1,1,2,4,6,9,11,13,16,19,21,24,26,28,30,32,33,34,35,36,36,37,37,37,38,38,38,38,38,38
E01021106,EV motorcycles,Number,0,1,2,4,6,7,10,12,14,16,18,21,23,24,26,27,29,30,31,31,32,32,32,33,33,33,33,33,33,33
E01021107,EV motorcycles,Number,1,2,3,5,8,11,14,17,20,23,26,29,32,35,37,39,41,42,43,44,45,46,46,46,47,47,47,47,47,47
E01021108,EV motorcycles,Number,1,1,2,4,6,8,10,13,15,18,20,22,25,27,28,30,31,32,33,34,35,35,35,35,36,36,36,36,36,36
E01021109,EV motorcycles,Number,1,3,6,11,16,22,28,34,41,47,54,60,66,71,76,80,83,86,89,91,92,93,94,95,95,95,96,96,96,96
E01021110,EV motorcycles,Number,1,3,6,10,15,20,25,31,37,43,49,55,60,65,69,73,76,79,81,83,84,85,86,87,87,87,88,88,88,88
E01021111,EV motorcycles,Number,0,1,2,3,4,5,7,8,10,11,13,14,16,17,18,19,20,21,21,22,22,22,23,23,23,23,23,23,23,23
E01021112,EV motorcycles,Number,1,2,3,5,8,11,14,17,21,24,27,31,33,36,39,41,43,44,45,46,47,48,48,48,48,49,49,49,49,49
E01021113,EV motorcycles,Number,1,2,4,7,10,14,18,22,26,30,34,38,42,45,48,51,53,55,56,58,58,59,60,60,60,61,61,61,61,61
E01021114,EV motorcycles,Number,1,3,6,9,14,19,25,30,36,42,48,53,58,63,67,71,74,76,79,80,82,82,83,84,84,84,85,85,85,85
E01021115,EV motorcycles,Number,1,3,5,8,12,17,21,26,31,36,41,46,51,55,58,62,64,67,68,70,71,72,72,73,73,73,74,74,74,74
E01021116,EV motorcycles,Number,1,2,4,7,10,14,18,22,26,30,35,39,42,46,49,52,54,56,57,59,59,60,61,61,61,62,62,62,62,62
E01021117,EV motorcycles,Number,1,2,3,5,8,11,14,17,21,24,27,31,33,36,39,41,43,44,45,46,47,48,48,48,48,49,49,49,49,49
E01021118,EV motorcycles,Number,1,2,3,5,8,10,13,16,19,23,26,29,31,34,36,38,40,41,43,43,44,45,45,45,46,46,46,46,46,46
E01021119,EV motorcycles,Number,0,1,2,3,5,6,8,10,12,14,16,17,19,21,22,23,24,25,26,26,27,27,27,28,28,28,28,28,28,28
E01021120,EV motorcycles,Number,1,1,3,5,7,9,12,15,17,20,23,26,28,30,32,34,36,37,38,39,39,40,40,40,41,41,41,41,41,41
E01021121,EV motorcycles,Number,1,2,3,5,7,9,12,15,18,21,24,26,29,31,33,35,36,38,39,40,40,41,41,41,42,42,42,42,42,42
E01021122,EV motorcycles,Number,0,1,1,2,3,4,5,7,8,9,11,12,13,14,15,16,17,17,18,18,18,18,19,19,19,19,19,19,19,19
E01021123,EV motorcycles,Number,1,2,3,6,9,11,15,18,22,25,29,32,35,38,40,42,44,46,47,48,49,49,50,50,50,51,51,51,51,51
E01021124,EV motorcycles,Number,1,2,4,7,10,13,17,21,25,29,33,37,40,44,47,49,51,53,55,56,57,57,58,58,58,59,59,59,59,59
E01021125,EV motorcycles,Number,1,1,2,4,6,9,11,13,16,19,21,24,26,28,30,32,33,34,35,36,36,37,37,37,38,38,38,38,38,38
E01021126,EV motorcycles,Number,1,2,3,6,9,12,15,18,22,26,29,32,36,38,41,43,45,47,48,49,50,50,51,51,51,52,52,52,52,52
E01021127,EV motorcycles,Number,1,2,4,7,11,15,19,23,28,32,37,41,45,49,52,55,57,59,61,62,63,64,65,65,65,66,66,66,66,66
E01021128,EV motorcycles,Number,1,2,4,7,11,15,20,24,29,33,38,42,46,50,54,57,59,61,63,64,65,66,67,67,67,68,68,68,68,68
E01021129,EV motorcycles,Number,1,2,4,6,9,12,16,20,23,27,31,34,38,41,43,46,48,49,51,52,53,53,54,54,54,55,55,55,55,55
E01021130,EV motorcycles,Number,1,2,3,5,8,10,13,16,19,22,25,28,31,33,35,37,39,40,42,42,43,44,44,44,45,45,45,45,45,45
E01021131,EV motorcycles,Number,1,2,4,7,10,14,18,22,26,30,35,39,42,46,49,52,54,56,57,59,59,60,61,61,61,62,62,62,62,62
E01021132,EV motorcycles,Number,0,1,2,4,6,8,10,12,14,17,19,21,23,25,27,28,30,31,31,32,33,33,33,33,34,34,34,34,34,34
E01021133,EV motorcycles,Number,1,2,4,7,11,15,20,24,29,33,38,42,46,50,54,57,59,61,63,64,65,66,67,67,67,68,68,68,68,68
E01021134,EV motorcycles,Number,1,2,3,5,8,11,14,17,20,24,27,30,33,35,38,40,42,43,44,45,46,47,47,47,48,48,48,48,48,48
E01021135,EV motorcycles,Number,1,3,5,8,12,17,21,26,31,36,41,46,51,55,58,62,64,67,68,70,71,72,72,73,73,73,74,74,74,74
E01021136,EV motorcycles,Number,1,1,2,4,6,8,10,13,15,18,20,22,25,27,28,30,31,32,33,34,35,35,35,35,36,36,36,36,36,36
E01021137,EV motorcycles,Number,1,3,5,8,13,17,22,27,33,38,43,48,53,57,61,64,67,69,71,73,74,75,75,76,76,76,77,77,77,77
E01021138,EV motorcycles,Number,1,2,3,6,9,12,15,19,22,26,30,33,36,39,42,44,46,48,49,50,51,51,52,52,52,53,53,53,53,53
E01021139,EV motorcycles,Number,0,1,2,3,4,6,8,9,11,13,15,16,18,19,20,22,23,23,24,25,25,25,25,26,26,26,26,26,26,26
E01021140,EV motorcycles,Number,1,2,3,5,8,11,14,17,21,24,27,31,33,36,39,41,43,44,45,46,47,48,48,48,48,49,49,49,49,49
E01021141,EV motorcycles,Number,1,2,3,5,8,10,13,16,19,23,26,29,31,34,36,38,40,41,43,43,44,45,45,45,46,46,46,46,46,46
E01021142,EV motorcycles,Number,0,1,2,3,4,5,7,8,10,11,13,14,16,17,18,19,20,21,21,22,22,22,23,23,23,23,23,23,23,23
E01021143,EV motorcycles,Number,0,1,2,3,5,7,9,11,13,15,17,19,21,22,24,25,26,27,28,28,29,29,29,30,30,30,30,30,30,30
E01021144,EV motorcycles,Number,1,2,4,7,11,15,19,23,27,32,36,40,44,48,51,54,56,58,60,61,62,63,64,64,64,65,65,65,65,65
E01021145,EV motorcycles,Number,1,3,5,9,13,18,23,28,33,38,44,49,53,58,61,65,68,70,72,74,75,76,76,77,77,77,78,78,78,78
E01021146,EV motorcycles,Number,1,2,4,7,11,15,19,23,28,32,37,41,45,49,52,55,57,59,61,62,63,64,65,65,65,66,66,66,66,66
E01021147,EV motorcycles,Number,1,3,6,11,16,22,28,34,41,47,54,60,66,71,76,80,83,86,89,91,92,93,94,95,95,95,96,96,96,96
E01021148,EV motorcycles,Number,1,2,4,7,11,15,19,24,28,33,37,42,46,50,53,56,58,60,62,63,64,65,66,66,66,67,67,67,67,67
E01021149,EV motorcycles,Number,2,4,7,12,18,24,31,38,45,53,60,67,73,79,84,89,93,96,99,101,103,104,105,105,106,106,107,107,107,107
E01021150,EV motorcycles,Number,1,2,3,5,8,11,14,17,20,23,26,29,32,35,37,39,41,42,43,44,45,46,46,46,47,47,47,47,47,47
E01021151,EV motorcycles,Number,1,2,3,6,8,11,14,18,21,25,28,31,34,37,39,42,43,45,46,47,48,49,49,49,49,50,50,50,50,50
E01021152,EV motorcycles,Number,1,1,2,4,6,8,10,13,15,18,20,22,25,27,28,30,31,32,33,34,35,35,35,35,36,36,36,36,36,36
E01021153,EV motorcycles,Number,1,2,3,6,9,11,15,18,22,25,29,32,35,38,40,42,44,46,47,48,49,49,50,50,50,51,51,51,51,51
E01021154,EV motorcycles,Number,1,1,3,4,7,9,11,14,16,19,22,24,27,29,31,32,34,35,36,37,37,38,38,38,39,39,39,39,39,39
E01021155,EV motorcycles,Number,0,1,2,4,6,7,10,12,14,16,18,21,23,24,26,27,29,30,31,31,32,32,32,33,33,33,33,33,33,33
E01021156,EV motorcycles,Number,0,1,2,4,6,7,10,12,14,16,18,21,23,24,26,27,29,30,31,31,32,32,32,33,33,33,33,33,33,33
E01021157,EV motorcycles,Number,1,2,4,6,9,12,16,20,23,27,31,34,38,41,43,46,48,49,51,52,53,53,54,54,54,55,55,55,55,55
E01021158,EV motorcycles,Number,1,2,3,5,8,10,13,16,19,23,26,29,31,34,36,38,40,41,43,43,44,45,45,45,46,46,46,46,46,46
E01021159,EV motorcycles,Number,1,2,4,7,10,14,18,22,26,30,34,38,42,45,48,51,53,55,56,58,58,59,60,60,60,61,61,61,61,61
E01021160,EV motorcycles,Number,0,1,2,3,5,7,9,11,13,15,17,19,21,22,24,25,26,27,28,28,29,29,29,30,30,30,30,30,30,30
E01021161,EV motorcycles,Number,1,1,2,4,6,8,10,13,15,18,20,22,25,27,28,30,31,32,33,34,35,35,35,35,36,36,36,36,36,36
E01021162,EV motorcycles,Number,1,1,2,4,6,8,11,13,16,18,21,23,25,27,29,31,32,33,34,35,35,36,36,36,37,37,37,37,37,37
E01021163,EV motorcycles,Number,1,3,6,10,15,20,25,31,37,43,49,54,59,64,69,72,76,78,80,82,83,84,85,86,86,86,87,87,87,87
E01021164,EV motorcycles,Number,1,1,3,5,7,9,12,15,17,20,23,26,28,30,32,34,36,37,38,39,39,40,40,40,41,41,41,41,41,41
E01021165,EV motorcycles,Number,1,1,2,4,6,9,11,13,16,19,21,24,26,28,30,32,33,34,35,36,36,37,37,37,38,38,38,38,38,38
E01021166,EV motorcycles,Number,1,2,3,5,8,11,14,17,20,24,27,30,33,35,38,40,42,43,44,45,46,47,47,47,48,48,48,48,48,48
E01021167,EV motorcycles,Number,1,2,4,6,9,12,16,19,23,27,30,34,37,40,43,45,47,49,50,51,52,52,53,53,53,54,54,54,54,54
E01021168,EV motorcycles,Number,1,1,2,4,6,8,11,13,16,18,21,23,25,27,29,31,32,33,34,35,35,36,36,36,37,37,37,37,37,37
E01021169,EV motorcycles,Number,1,2,4,6,9,13,16,20,24,28,31,35,38,41,44,47,49,50,52,53,54,54,55,55,55,56,56,56,56,56
E01021170,EV motorcycles,Number,2,5,9,15,23,31,40,50,59,69,78,87,96,103,110,116,122,126,129,132,134,136,137,138,139,139,140,140,140,140
E01021171,EV motorcycles,Number,1,2,3,6,9,11,15,18,22,25,29,32,35,38,40,42,44,46,47,48,49,49,50,50,50,51,51,51,51,51
E01021172,EV motorcycles,Number,1,2,3,5,8,11,14,17,20,24,27,30,33,35,38,40,42,43,44,45,46,47,47,47,48,48,48,48,48,48
E01021173,EV motorcycles,Number,1,3,5,8,12,16,20,25,30,34,39,44,48,52,55,58,61,63,65,66,67,68,69,69,69,70,70,70,70,70
E01021174,EV motorcycles,Number,1,2,4,7,11,14,19,23,27,31,36,40,44,47,50,53,56,58,59,60,61,62,63,63,63,64,64,64,64,64
E01021175,EV motorcycles,Number,1,2,4,6,10,13,17,21,25,29,32,36,40,43,46,48,50,52,54,55,56,56,57,57,57,58,58,58,58,58
E01021176,EV motorcycles,Number,1,2,3,5,7,10,13,16,19,22,25,27,30,33,35,37,38,40,41,42,42,43,43,43,44,44,44,44,44,44
E01021177,EV motorcycles,Number,1,1,2,4,6,8,11,13,16,18,21,23,25,27,29,31,32,33,34,35,35,36,36,36,37,37,37,37,37,37
E01021178,EV motorcycles,Number,1,2,3,6,9,11,15,18,22,25,29,32,35,38,40,42,44,46,47,48,49,49,50,50,50,51,51,51,51,51
E01021179,EV motorcycles,Number,1,1,3,4,7,9,11,14,16,19,22,24,27,29,31,32,34,35,36,37,37,38,38,38,39,39,39,39,39,39
E01021180,EV motorcycles,Number,1,2,4,6,9,13,16,20,24,28,31,35,38,41,44,47,49,50,52,53,54,54,55,55,55,56,56,56,56,56
E01021181,EV motorcycles,Number,1,1,2,4,6,8,11,13,16,18,21,23,25,27,29,31,32,33,34,35,35,36,36,36,37,37,37,37,37,37
E01021182,EV motorcycles,Number,1,2,4,6,10,13,17,21,25,29,32,36,40,43,46,48,50,52,54,55,56,56,57,57,57,58,58,58,58,58
E01021183,EV motorcycles,Number,1,1,2,4,6,9,11,13,16,19,21,24,26,28,30,32,33,34,35,36,36,37,37,37,38,38,38,38,38,38
E01021184,EV motorcycles,Number,1,2,4,7,10,13,17,21,25,29,33,37,40,44,47,49,51,53,55,56,57,57,58,58,58,59,59,59,59,59
E01021185,EV motorcycles,Number,1,2,3,6,9,12,15,18,22,26,29,32,36,38,41,43,45,47,48,49,50,50,51,51,51,52,52,52,52,52
E01021186,EV motorcycles,Number,1,2,4,6,10,13,16,20,24,28,32,35,39,42,45,47,50,51,53,54,55,55,56,56,56,57,57,57,57,57
E01021187,EV motorcycles,Number,1,2,3,6,9,12,15,18,22,26,29,32,36,38,41,43,45,47,48,49,50,50,51,51,51,52,52,52,52,52
E01021188,EV motorcycles,Number,1,2,3,5,7,10,13,16,19,22,25,27,30,33,35,37,38,40,41,42,42,43,43,43,44,44,44,44,44,44
E01021189,EV motorcycles,Number,1,2,3,5,7,10,13,16,19,22,25,27,30,33,35,37,38,40,41,42,42,43,43,43,44,44,44,44,44,44
E01021190,EV motorcycles,Number,1,2,5,8,12,15,20,25,29,34,39,43,47,51,54,57,60,62,64,65,66,67,68,68,68,69,69,69,69,69
E01021191,EV motorcycles,Number,1,2,3,5,8,10,13,16,19,22,25,28,31,33,35,37,39,40,42,42,43,44,44,44,45,45,45,45,45,45
E01021192,EV motorcycles,Number,1,2,3,5,8,11,14,17,20,24,27,30,33,35,38,40,42,43,44,45,46,47,47,47,48,48,48,48,48,48
E01021193,EV motorcycles,Number,1,2,3,6,9,12,15,18,22,26,29,32,36,38,41,43,45,47,48,49,50,50,51,51,51,52,52,52,52,52
E01021194,EV motorcycles,Number,1,2,3,5,8,11,14,17,20,24,27,30,33,35,38,40,42,43,44,45,46,47,47,47,48,48,48,48,48,48
E01021195,EV motorcycles,Number,2,4,7,12,19,25,33,40,48,56,63,70,77,83,89,94,98,102,104,107,108,110,111,111,112,112,113,113,113,113
E01021196,EV motorcycles,Number,1,3,5,8,12,16,21,26,31,36,41,45,50,54,58,61,63,66,67,69,70,71,71,72,72,72,73,73,73,73
E01021197,EV motorcycles,Number,2,4,7,12,18,24,31,38,45,53,60,67,73,79,84,89,93,96,99,101,103,104,105,105,106,106,107,107,107,107
E01021198,EV motorcycles,Number,1,2,4,7,11,14,18,22,27,31,35,39,43,47,50,52,55,57,58,59,60,61,62,62,62,63,63,63,63,63
E01021199,EV motorcycles,Number,1,4,6,11,17,22,29,35,42,49,55,62,68,73,78,82,86,89,92,93,95,96,97,98,98,98,99,99,99,99
E01021200,EV motorcycles,Number,1,2,3,5,8,10,13,16,19,23,26,29,31,34,36,38,40,41,43,43,44,45,45,45,46,46,46,46,46,46
E01021201,EV motorcycles,Number,1,2,4,7,11,14,19,23,27,31,36,40,44,47,50,53,56,58,59,60,61,62,63,63,63,64,64,64,64,64
E01021202,EV motorcycles,Number,0,1,1,2,4,5,6,8,9,11,12,14,15,16,17,18,19,20,20,21,21,21,22,22,22,22,22,22,22,22
E01021203,EV motorcycles,Number,1,2,3,5,8,10,13,16,19,22,25,28,31,33,35,37,39,40,42,42,43,44,44,44,45,45,45,45,45,45
E01021204,EV motorcycles,Number,1,2,3,5,8,11,14,17,21,24,27,31,33,36,39,41,43,44,45,46,47,48,48,48,48,49,49,49,49,49
E01021205,EV motorcycles,Number,1,2,3,6,9,11,15,18,22,25,29,32,35,38,40,42,44,46,47,48,49,49,50,50,50,51,51,51,51,51
E01021206,EV motorcycles,Number,1,2,5,8,12,15,20,25,29,34,39,43,47,51,54,57,60,62,64,65,66,67,68,68,68,69,69,69,69,69
E01021207,EV motorcycles,Number,1,3,6,10,16,21,27,34,40,47,53,59,65,70,75,79,83,85,88,90,91,92,93,94,94,94,95,95,95,95
E01021208,EV motorcycles,Number,1,3,5,8,12,16,21,25,30,35,40,44,49,52,56,59,62,64,66,67,68,69,70,70,70,71,71,71,71,71
E01021209,EV motorcycles,Number,1,4,6,11,16,22,28,35,41,48,55,61,67,72,77,82,85,88,91,93,94,95,96,97,97,97,98,98,98,98
E01021210,EV motorcycles,Number,0,1,2,3,5,6,8,10,12,14,16,17,19,21,22,23,24,25,26,26,27,27,27,28,28,28,28,28,28,28
E01021211,EV motorcycles,Number,1,3,6,9,14,19,25,30,36,42,48,53,58,63,67,71,74,76,79,80,82,82,83,84,84,84,85,85,85,85
E01021212,EV motorcycles,Number,1,2,4,7,11,15,20,24,29,33,38,42,46,50,54,57,59,61,63,64,65,66,67,67,67,68,68,68,68,68
E01021213,EV motorcycles,Number,1,3,6,10,15,21,27,33,39,45,51,57,63,68,73,77,80,83,85,87,88,89,90,91,91,91,92,92,92,92
E01021214,EV motorcycles,Number,1,2,3,6,8,11,14,18,21,25,28,31,34,37,39,42,43,45,46,47,48,49,49,49,49,50,50,50,50,50
E01021215,EV motorcycles,Number,0,1,2,3,5,7,9,11,13,15,17,19,21,23,24,26,27,28,29,29,30,30,30,31,31,31,31,31,31,31
E01021216,EV motorcycles,Number,1,1,2,4,6,8,11,13,16,18,21,23,25,27,29,31,32,33,34,35,35,36,36,36,37,37,37,37,37,37
E01021217,EV motorcycles,Number,0,1,2,4,6,7,10,12,14,16,18,21,23,24,26,27,29,30,31,31,32,32,32,33,33,33,33,33,33,33
E01021218,EV motorcycles,Number,1,2,3,5,7,10,13,16,19,22,25,27,30,33,35,37,38,40,41,42,42,43,43,43,44,44,44,44,44,44
E01021219,EV motorcycles,Number,1,2,3,6,9,12,15,19,22,26,30,33,36,39,42,44,46,48,49,50,51,51,52,52,52,53,53,53,53,53
E01021220,EV motorcycles,Number,1,1,3,4,7,9,11,14,16,19,22,24,27,29,31,32,34,35,36,37,37,38,38,38,39,39,39,39,39,39
E01021221,EV motorcycles,Number,1,1,2,4,6,8,10,12,15,17,20,22,24,26,28,29,30,31,32,33,34,34,34,34,35,35,35,35,35,35
E01021222,EV motorcycles,Number,1,1,3,4,7,9,11,14,16,19,22,24,27,29,31,32,34,35,36,37,37,38,38,38,39,39,39,39,39,39
E01021223,EV motorcycles,Number,0,1,1,2,3,4,5,7,8,9,11,12,13,14,15,16,17,17,18,18,18,18,19,19,19,19,19,19,19,19
E01021224,EV motorcycles,Number,0,1,2,3,5,7,9,11,13,15,17,19,21,23,24,26,27,28,29,29,30,30,30,31,31,31,31,31,31,31
E01021225,EV motorcycles,Number,1,1,3,5,7,9,12,15,17,20,23,26,28,30,32,34,36,37,38,39,39,40,40,40,41,41,41,41,41,41
E01021226,EV motorcycles,Number,1,2,3,5,7,10,13,16,19,22,25,27,30,33,35,37,38,40,41,42,42,43,43,43,44,44,44,44,44,44
E01021227,EV motorcycles,Number,1,1,3,4,7,9,12,14,17,20,22,25,27,30,32,33,35,36,37,38,38,39,39,39,40,40,40,40,40,40
E01021228,EV motorcycles,Number,1,1,2,4,6,8,10,13,15,18,20,22,25,27,28,30,31,32,33,34,35,35,35,35,36,36,36,36,36,36
E01021229,EV motorcycles,Number,1,2,4,6,9,13,16,20,24,28,31,35,38,41,44,47,49,50,52,53,54,54,55,55,55,56,56,56,56,56
E01021230,EV motorcycles,Number,1,3,5,8,12,16,21,26,31,36,41,45,50,54,58,61,63,66,67,69,70,71,71,72,72,72,73,73,73,73
E01021231,EV motorcycles,Number,0,1,2,3,5,6,8,10,12,14,16,17,19,21,22,23,24,25,26,26,27,27,27,28,28,28,28,28,28,28
E01021232,EV motorcycles,Number,1,1,2,4,6,8,10,12,15,17,20,22,24,26,28,29,30,31,32,33,34,34,34,34,35,35,35,35,35,35
E01021233,EV motorcycles,Number,1,1,3,5,7,9,12,15,17,20,23,26,28,30,32,34,36,37,38,39,39,40,40,40,41,41,41,41,41,41
E01021234,EV motorcycles,Number,1,2,3,5,7,10,13,16,19,22,25,27,30,33,35,37,38,40,41,42,42,43,43,43,44,44,44,44,44,44
E01021235,EV motorcycles,Number,0,1,2,3,5,7,9,11,13,15,17,19,21,22,24,25,26,27,28,28,29,29,29,30,30,30,30,30,30,30
E01021236,EV motorcycles,Number,1,2,3,6,9,12,15,19,22,26,30,33,36,39,42,44,46,48,49,50,51,51,52,52,52,53,53,53,53,53
E01021237,EV motorcycles,Number,0,0,1,1,2,3,4,5,5,6,7,8,9,10,10,11,11,12,12,12,12,13,13,13,13,13,13,13,13,13
E01021238,EV motorcycles,Number,0,1,1,2,4,5,6,7,9,10,12,13,14,16,17,17,18,19,19,20,20,20,21,21,21,21,21,21,21,21
E01021239,EV motorcycles,Number,0,1,2,3,4,5,7,8,10,11,13,14,16,17,18,19,20,21,21,22,22,22,23,23,23,23,23,23,23,23
E01021240,EV motorcycles,Number,0,1,1,2,3,4,5,6,7,8,9,10,11,12,13,13,14,14,15,15,15,16,16,16,16,16,16,16,16,16
E01021241,EV motorcycles,Number,0,1,1,2,4,5,6,7,9,10,12,13,14,16,17,17,18,19,19,20,20,20,21,21,21,21,21,21,21,21
E01021242,EV motorcycles,Number,0,1,2,3,5,7,9,11,13,15,17,19,21,23,24,26,27,28,29,29,30,30,30,31,31,31,31,31,31,31
E01021243,EV motorcycles,Number,0,1,2,3,5,6,8,10,12,14,16,17,19,21,22,23,24,25,26,26,27,27,27,28,28,28,28,28,28,28
E01021244,EV motorcycles,Number,0,1,1,2,3,3,4,5,6,7,8,9,10,11,12,12,13,13,14,14,14,15,15,15,15,15,15,15,15,15
E01021245,EV motorcycles,Number,0,1,2,3,5,6,8,10,12,14,16,17,19,21,22,23,24,25,26,26,27,27,27,28,28,28,28,28,28,28
E01021246,EV motorcycles,Number,0,1,1,2,4,5,6,8,9,11,12,14,15,16,17,18,19,20,20,21,21,21,22,22,22,22,22,22,22,22
E01021247,EV motorcycles,Number,0,1,2,4,5,7,9,11,14,16,18,20,22,24,25,27,28,29,30,30,31,31,31,32,32,32,32,32,32,32
E01021248,EV motorcycles,Number,0,1,1,2,3,3,4,5,6,7,8,9,10,11,12,12,13,13,14,14,14,15,15,15,15,15,15,15,15,15
E01021249,EV motorcycles,Number,0,1,2,3,4,6,8,9,11,13,15,16,18,19,20,22,23,23,24,25,25,25,25,26,26,26,26,26,26,26
E01021250,EV motorcycles,Number,0,1,2,3,5,6,8,10,12,14,16,17,19,21,22,23,24,25,26,26,27,27,27,28,28,28,28,28,28,28
E01021251,EV motorcycles,Number,0,1,2,3,5,7,8,10,12,14,16,18,20,21,23,24,25,26,27,27,28,28,28,29,29,29,29,29,29,29
E01021252,EV motorcycles,Number,0,1,1,2,3,4,5,6,7,8,10,11,12,13,13,14,15,15,16,16,16,16,17,17,17,17,17,17,17,17
E01021253,EV motorcycles,Number,0,1,2,4,6,7,10,12,14,16,18,21,23,24,26,27,29,30,31,31,32,32,32,33,33,33,33,33,33,33
E01021254,EV motorcycles,Number,0,1,2,4,6,8,10,12,14,17,19,21,23,25,27,28,30,31,31,32,33,33,33,33,34,34,34,34,34,34
E01021255,EV motorcycles,Number,0,1,1,2,3,4,5,6,8,9,10,11,12,13,14,15,16,16,17,17,17,17,18,18,18,18,18,18,18,18
E01021256,EV motorcycles,Number,0,1,2,3,4,6,8,9,11,13,15,16,18,19,20,22,23,23,24,25,25,25,25,26,26,26,26,26,26,26
E01021257,EV motorcycles,Number,1,2,3,5,7,10,13,16,19,22,25,27,30,33,35,37,38,40,41,42,42,43,43,43,44,44,44,44,44,44
E01021258,EV motorcycles,Number,1,2,3,5,7,9,12,15,18,21,24,26,29,31,33,35,36,38,39,40,40,41,41,41,42,42,42,42,42,42
E01021259,EV motorcycles,Number,1,2,3,6,9,12,15,19,22,26,30,33,36,39,42,44,46,48,49,50,51,51,52,52,52,53,53,53,53,53
E01021260,EV motorcycles,Number,1,2,4,6,9,12,16,19,23,27,30,34,37,40,43,45,47,49,50,51,52,52,53,53,53,54,54,54,54,54
E01021261,EV motorcycles,Number,1,1,2,4,6,8,11,13,16,18,21,23,25,27,29,31,32,33,34,35,35,36,36,36,37,37,37,37,37,37
E01021262,EV motorcycles,Number,1,2,3,5,7,9,12,15,18,21,24,26,29,31,33,35,36,38,39,40,40,41,41,41,42,42,42,42,42,42
E01021263,EV motorcycles,Number,0,1,2,4,5,7,9,11,14,16,18,20,22,24,25,27,28,29,30,30,31,31,31,32,32,32,32,32,32,32
E01021264,EV motorcycles,Number,1,1,2,4,6,9,11,13,16,19,21,24,26,28,30,32,33,34,35,36,36,37,37,37,38,38,38,38,38,38
E01021265,EV motorcycles,Number,0,1,2,3,5,7,8,10,12,14,16,18,20,21,23,24,25,26,27,27,28,28,28,29,29,29,29,29,29,29
E01021266,EV motorcycles,Number,0,1,2,4,5,7,9,11,14,16,18,20,22,24,25,27,28,29,30,30,31,31,31,32,32,32,32,32,32,32
E01021267,EV motorcycles,Number,0,1,2,3,4,6,8,9,11,13,15,16,18,19,20,22,23,23,24,25,25,25,25,26,26,26,26,26,26,26
E01021268,EV motorcycles,Number,0,1,2,3,4,5,7,9,10,12,13,15,16,18,19,20,21,22,22,23,23,23,23,24,24,24,24,24,24,24
E01021269,EV motorcycles,Number,1,1,2,4,6,8,10,12,15,17,20,22,24,26,28,29,30,31,32,33,34,34,34,34,35,35,35,35,35,35
E01021270,EV motorcycles,Number,0,1,2,4,6,8,10,12,14,17,19,21,23,25,27,28,30,31,31,32,33,33,33,33,34,34,34,34,34,34
E01021271,EV motorcycles,Number,0,1,2,3,5,7,9,11,13,15,17,19,21,23,24,26,27,28,29,29,30,30,30,31,31,31,31,31,31,31
E01021272,EV motorcycles,Number,0,1,1,2,3,4,5,6,8,9,10,11,12,13,14,15,16,16,17,17,17,17,18,18,18,18,18,18,18,18
E01021273,EV motorcycles,Number,0,1,2,3,5,6,8,10,12,14,16,17,19,21,22,23,24,25,26,26,27,27,27,28,28,28,28,28,28,28
E01021274,EV motorcycles,Number,1,1,2,4,6,8,10,13,15,18,20,22,25,27,28,30,31,32,33,34,35,35,35,35,36,36,36,36,36,36
E01021275,EV motorcycles,Number,1,2,3,6,8,11,14,18,21,25,28,31,34,37,39,42,43,45,46,47,48,49,49,49,49,50,50,50,50,50
E01021276,EV motorcycles,Number,0,1,2,3,5,7,8,10,12,14,16,18,20,21,23,24,25,26,27,27,28,28,28,29,29,29,29,29,29,29
E01021277,EV motorcycles,Number,0,1,2,3,5,7,8,10,12,14,16,18,20,21,23,24,25,26,27,27,28,28,28,29,29,29,29,29,29,29
E01021278,EV motorcycles,Number,0,1,2,3,5,7,9,11,13,15,17,19,21,23,24,26,27,28,29,29,30,30,30,31,31,31,31,31,31,31
E01021279,EV motorcycles,Number,1,1,2,4,6,9,11,13,16,19,21,24,26,28,30,32,33,34,35,36,36,37,37,37,38,38,38,38,38,38
E01021280,EV motorcycles,Number,0,1,2,3,4,5,7,9,10,12,13,15,16,18,19,20,21,22,22,23,23,23,23,24,24,24,24,24,24,24
E01021281,EV motorcycles,Number,0,1,2,3,5,6,8,10,12,14,16,17,19,21,22,23,24,25,26,26,27,27,27,28,28,28,28,28,28,28
E01021282,EV motorcycles,Number,0,1,2,3,4,5,7,9,10,12,13,15,16,18,19,20,21,22,22,23,23,23,23,24,24,24,24,24,24,24
E01021283,EV motorcycles,Number,0,1,1,2,4,5,6,7,9,10,12,13,14,16,17,17,18,19,19,20,20,20,21,21,21,21,21,21,21,21
E01021284,EV motorcycles,Number,0,1,1,2,3,3,4,5,6,7,8,9,10,11,12,12,13,13,14,14,14,15,15,15,15,15,15,15,15,15
E01021285,EV motorcycles,Number,1,1,2,4,6,8,11,13,16,18,21,23,25,27,29,31,32,33,34,35,35,36,36,36,37,37,37,37,37,37
E01021286,EV motorcycles,Number,0,1,1,2,3,4,5,6,7,8,10,11,12,13,13,14,15,15,16,16,16,16,17,17,17,17,17,17,17,17
E01021287,EV motorcycles,Number,0,1,2,3,4,5,7,8,10,11,13,14,16,17,18,19,20,21,21,22,22,22,23,23,23,23,23,23,23,23
E01021288,EV motorcycles,Number,0,1,1,2,4,5,6,7,9,10,12,13,14,16,17,17,18,19,19,20,20,20,21,21,21,21,21,21,21,21
E01021289,EV motorcycles,Number,1,2,3,5,8,10,13,16,19,22,25,28,31,33,35,37,39,40,42,42,43,44,44,44,45,45,45,45,45,45
E01021290,EV motorcycles,Number,0,1,2,3,5,7,9,11,13,15,17,19,21,22,24,25,26,27,28,28,29,29,29,30,30,30,30,30,30,30
E01021291,EV motorcycles,Number,0,1,2,3,5,7,9,11,13,15,17,19,21,23,24,26,27,28,29,29,30,30,30,31,31,31,31,31,31,31
E01021292,EV motorcycles,Number,0,1,2,3,5,6,8,10,12,14,16,17,19,21,22,23,24,25,26,26,27,27,27,28,28,28,28,28,28,28
E01021293,EV motorcycles,Number,0,1,2,3,4,6,8,9,11,13,15,16,18,19,20,22,23,23,24,25,25,25,25,26,26,26,26,26,26,26
E01021294,EV motorcycles,Number,1,1,2,4,6,8,10,13,15,18,20,22,25,27,28,30,31,32,33,34,35,35,35,35,36,36,36,36,36,36
E01021295,EV motorcycles,Number,0,1,2,4,6,7,10,12,14,16,18,21,23,24,26,27,29,30,31,31,32,32,32,33,33,33,33,33,33,33
E01021296,EV motorcycles,Number,1,1,3,4,7,9,11,14,16,19,22,24,27,29,31,32,34,35,36,37,37,38,38,38,39,39,39,39,39,39
E01021297,EV motorcycles,Number,0,1,1,2,4,5,6,7,9,10,12,13,14,16,17,17,18,19,19,20,20,20,21,21,21,21,21,21,21,21
E01021298,EV motorcycles,Number,0,1,2,4,5,7,9,11,14,16,18,20,22,24,25,27,28,29,30,30,31,31,31,32,32,32,32,32,32,32
E01021299,EV motorcycles,Number,1,2,3,5,8,10,13,16,19,23,26,29,31,34,36,38,40,41,43,43,44,45,45,45,46,46,46,46,46,46
E01021300,EV motorcycles,Number,1,1,2,4,6,8,10,13,15,18,20,22,25,27,28,30,31,32,33,34,35,35,35,35,36,36,36,36,36,36
E01021301,EV motorcycles,Number,1,1,3,4,7,9,11,14,16,19,22,24,27,29,31,32,34,35,36,37,37,38,38,38,39,39,39,39,39,39
E01021302,EV motorcycles,Number,0,1,2,3,5,7,8,10,12,14,16,18,20,21,23,24,25,26,27,27,28,28,28,29,29,29,29,29,29,29
E01021303,EV motorcycles,Number,0,1,2,4,6,7,10,12,14,16,18,21,23,24,26,27,29,30,31,31,32,32,32,33,33,33,33,33,33,33
E01021304,EV motorcycles,Number,0,1,2,3,5,6,8,10,12,14,16,17,19,21,22,23,24,25,26,26,27,27,27,28,28,28,28,28,28,28
E01021305,EV motorcycles,Number,0,1,1,2,3,4,5,6,8,9,10,11,12,13,14,15,16,16,17,17,17,17,18,18,18,18,18,18,18,18
E01021306,EV motorcycles,Number,0,1,1,2,3,4,6,7,8,10,11,12,14,15,16,17,17,18,18,19,19,19,20,20,20,20,20,20,20,20
E01021307,EV motorcycles,Number,0,1,1,2,3,4,5,7,8,9,11,12,13,14,15,16,17,17,18,18,18,18,19,19,19,19,19,19,19,19
E01021308,EV motorcycles,Number,1,2,3,5,7,9,12,15,18,21,24,26,29,31,33,35,36,38,39,40,40,41,41,41,42,42,42,42,42,42
E01021309,EV motorcycles,Number,0,1,2,4,6,7,10,12,14,16,18,21,23,24,26,27,29,30,31,31,32,32,32,33,33,33,33,33,33,33
E01021310,EV motorcycles,Number,0,1,2,3,5,7,8,10,12,14,16,18,20,21,23,24,25,26,27,27,28,28,28,29,29,29,29,29,29,29
E01021311,EV motorcycles,Number,0,1,2,3,5,7,8,10,12,14,16,18,20,21,23,24,25,26,27,27,28,28,28,29,29,29,29,29,29,29
E01021312,EV motorcycles,Number,1,3,5,8,13,17,22,27,32,37,42,47,51,55,59,62,65,67,69,71,72,73,73,74,74,74,75,75,75,75
E01021313,EV motorcycles,Number,0,1,2,4,6,7,10,12,14,16,18,21,23,24,26,27,29,30,31,31,32,32,32,33,33,33,33,33,33,33
E01021314,EV motorcycles,Number,1,2,3,5,7,10,12,15,18,21,24,27,29,32,34,36,37,39,40,41,41,42,42,42,43,43,43,43,43,43
E01021315,EV motorcycles,Number,0,1,1,2,3,4,5,6,8,9,10,11,12,13,14,15,16,16,17,17,17,17,18,18,18,18,18,18,18,18
E01021316,EV motorcycles,Number,0,1,1,2,4,5,6,7,9,10,12,13,14,16,17,17,18,19,19,20,20,20,21,21,21,21,21,21,21,21
E01021317,EV motorcycles,Number,0,1,2,3,5,7,8,10,12,14,16,18,20,21,23,24,25,26,27,27,28,28,28,29,29,29,29,29,29,29
E01021318,EV motorcycles,Number,0,1,2,3,5,6,8,10,11,13,15,17,18,20,21,22,23,24,25,25,26,26,26,27,27,27,27,27,27,27
E01021319,EV motorcycles,Number,0,1,2,3,4,5,7,9,10,12,13,15,16,18,19,20,21,22,22,23,23,23,23,24,24,24,24,24,24,24
E01021320,EV motorcycles,Number,0,1,1,2,3,4,5,7,8,9,11,12,13,14,15,16,17,17,18,18,18,18,19,19,19,19,19,19,19,19
E01021321,EV motorcycles,Number,0,1,2,3,4,5,7,8,10,11,13,14,16,17,18,19,20,21,21,22,22,22,23,23,23,23,23,23,23,23
E01021322,EV motorcycles,Number,0,1,2,3,4,5,7,8,10,11,13,14,16,17,18,19,20,21,21,22,22,22,23,23,23,23,23,23,23,23
E01021323,EV motorcycles,Number,0,1,1,2,3,4,5,6,7,8,10,11,12,13,13,14,15,15,16,16,16,16,17,17,17,17,17,17,17,17
E01021324,EV motorcycles,Number,0,1,2,3,4,5,7,8,10,11,13,14,16,17,18,19,20,21,21,22,22,22,23,23,23,23,23,23,23,23
E01021325,EV motorcycles,Number,0,1,1,2,3,4,5,6,8,9,10,11,12,13,14,15,16,16,17,17,17,17,18,18,18,18,18,18,18,18
E01021326,EV motorcycles,Number,0,1,2,3,4,6,8,9,11,13,15,16,18,19,20,22,23,23,24,25,25,25,25,26,26,26,26,26,26,26
E01021327,EV motorcycles,Number,0,1,2,3,4,5,7,8,10,11,13,14,16,17,18,19,20,21,21,22,22,22,23,23,23,23,23,23,23,23
E01021328,EV motorcycles,Number,0,1,2,3,5,6,8,10,11,13,15,17,18,20,21,22,23,24,25,25,26,26,26,27,27,27,27,27,27,27
E01021329,EV motorcycles,Number,0,1,1,2,3,4,5,7,8,9,11,12,13,14,15,16,17,17,18,18,18,18,19,19,19,19,19,19,19,19
E01021330,EV motorcycles,Number,1,2,3,6,8,11,14,18,21,25,28,31,34,37,39,42,43,45,46,47,48,49,49,49,49,50,50,50,50,50
E01021331,EV motorcycles,Number,1,2,3,5,7,9,12,15,18,21,24,26,29,31,33,35,36,38,39,40,40,41,41,41,42,42,42,42,42,42
E01021332,EV motorcycles,Number,1,1,2,4,6,8,11,13,16,18,21,23,25,27,29,31,32,33,34,35,35,36,36,36,37,37,37,37,37,37
E01021333,EV motorcycles,Number,0,1,2,3,5,6,8,10,11,13,15,17,18,20,21,22,23,24,25,25,26,26,26,27,27,27,27,27,27,27
E01021334,EV motorcycles,Number,1,2,3,5,8,10,13,16,19,22,25,28,31,33,35,37,39,40,42,42,43,44,44,44,45,45,45,45,45,45
E01021335,EV motorcycles,Number,1,1,3,4,7,9,11,14,16,19,22,24,27,29,31,32,34,35,36,37,37,38,38,38,39,39,39,39,39,39
E01021336,EV motorcycles,Number,0,1,2,3,4,6,8,9,11,13,15,16,18,19,20,22,23,23,24,25,25,25,25,26,26,26,26,26,26,26
E01021337,EV motorcycles,Number,0,1,2,4,6,8,10,12,14,17,19,21,23,25,27,28,30,31,31,32,33,33,33,33,34,34,34,34,34,34
E01021338,EV motorcycles,Number,1,2,3,5,8,11,14,17,20,23,26,29,32,35,37,39,41,42,43,44,45,46,46,46,47,47,47,47,47,47
E01021339,EV motorcycles,Number,1,1,2,4,6,9,11,13,16,19,21,24,26,28,30,32,33,34,35,36,36,37,37,37,38,38,38,38,38,38
E01021340,EV motorcycles,Number,1,2,3,5,8,11,14,17,20,24,27,30,33,35,38,40,42,43,44,45,46,47,47,47,48,48,48,48,48,48
E01021341,EV motorcycles,Number,1,1,3,4,7,9,12,14,17,20,22,25,27,30,32,33,35,36,37,38,38,39,39,39,40,40,40,40,40,40
E01021342,EV motorcycles,Number,0,1,2,4,6,7,10,12,14,16,18,21,23,24,26,27,29,30,31,31,32,32,32,33,33,33,33,33,33,33
E01021343,EV motorcycles,Number,0,1,1,2,3,4,5,7,8,9,11,12,13,14,15,16,17,17,18,18,18,18,19,19,19,19,19,19,19,19
E01021344,EV motorcycles,Number,1,2,4,6,9,13,16,20,24,28,31,35,38,41,44,47,49,50,52,53,54,54,55,55,55,56,56,56,56,56
E01021345,EV motorcycles,Number,0,1,2,4,6,7,10,12,14,16,18,21,23,24,26,27,29,30,31,31,32,32,32,33,33,33,33,33,33,33
E01021346,EV motorcycles,Number,1,2,4,7,10,13,17,21,25,30,34,37,41,44,47,50,52,54,55,57,58,58,59,59,59,60,60,60,60,60
E01021347,EV motorcycles,Number,1,2,4,6,10,13,17,21,25,29,32,36,40,43,46,48,50,52,54,55,56,56,57,57,57,58,58,58,58,58
E01021348,EV motorcycles,Number,1,2,3,5,7,10,13,16,19,22,25,27,30,33,35,37,38,40,41,42,42,43,43,43,44,44,44,44,44,44
E01021349,EV motorcycles,Number,1,2,4,7,10,13,17,21,25,30,34,37,41,44,47,50,52,54,55,57,58,58,59,59,59,60,60,60,60,60
E01021350,EV motorcycles,Number,1,2,3,5,8,11,14,17,21,24,27,31,33,36,39,41,43,44,45,46,47,48,48,48,48,49,49,49,49,49
E01021351,EV motorcycles,Number,0,1,2,3,5,7,9,11,13,15,17,19,21,22,24,25,26,27,28,28,29,29,29,30,30,30,30,30,30,30
E01021352,EV motorcycles,Number,1,2,3,5,7,9,12,15,18,21,24,26,29,31,33,35,36,38,39,40,40,41,41,41,42,42,42,42,42,42
E01021353,EV motorcycles,Number,1,2,3,6,9,11,15,18,22,25,29,32,35,38,40,42,44,46,47,48,49,49,50,50,50,51,51,51,51,51
E01021354,EV motorcycles,Number,1,2,3,5,7,10,13,16,19,22,25,27,30,33,35,37,38,40,41,42,42,43,43,43,44,44,44,44,44,44
E01021355,EV motorcycles,Number,1,3,5,8,12,16,21,25,30,35,40,44,49,52,56,59,62,64,66,67,68,69,70,70,70,71,71,71,71,71
E01021356,EV motorcycles,Number,0,1,2,4,5,7,9,11,14,16,18,20,22,24,25,27,28,29,30,30,31,31,31,32,32,32,32,32,32,32
E01021357,EV motorcycles,Number,1,1,2,4,6,8,10,13,15,18,20,22,25,27,28,30,31,32,33,34,35,35,35,35,36,36,36,36,36,36
E01021358,EV motorcycles,Number,1,2,3,6,8,11,14,18,21,25,28,31,34,37,39,42,43,45,46,47,48,49,49,49,49,50,50,50,50,50
E01021359,EV motorcycles,Number,1,2,4,6,9,12,16,19,23,27,30,34,37,40,43,45,47,49,50,51,52,52,53,53,53,54,54,54,54,54
E01021360,EV motorcycles,Number,1,2,4,6,10,13,17,21,25,29,32,36,40,43,46,48,50,52,54,55,56,56,57,57,57,58,58,58,58,58
E01021361,EV motorcycles,Number,1,2,4,6,9,12,16,20,23,27,31,34,38,41,43,46,48,49,51,52,53,53,54,54,54,55,55,55,55,55
E01021362,EV motorcycles,Number,1,2,3,5,8,11,14,17,20,24,27,30,33,35,38,40,42,43,44,45,46,47,47,47,48,48,48,48,48,48
E01021364,EV motorcycles,Number,1,2,3,5,7,10,12,15,18,21,24,27,29,32,34,36,37,39,40,41,41,42,42,42,43,43,43,43,43,43
E01021365,EV motorcycles,Number,1,2,4,6,9,12,16,20,23,27,31,34,38,41,43,46,48,49,51,52,53,53,54,54,54,55,55,55,55,55
E01021366,EV motorcycles,Number,0,1,2,3,4,5,7,8,10,11,13,14,16,17,18,19,20,21,21,22,22,22,23,23,23,23,23,23,23,23
E01021367,EV motorcycles,Number,0,1,2,4,5,7,9,11,14,16,18,20,22,24,25,27,28,29,30,30,31,31,31,32,32,32,32,32,32,32
E01021368,EV motorcycles,Number,1,2,4,7,10,13,17,21,25,29,33,37,40,44,47,49,51,53,55,56,57,57,58,58,58,59,59,59,59,59
E01021369,EV motorcycles,Number,1,2,4,6,9,12,16,20,23,27,31,34,38,41,43,46,48,49,51,52,53,53,54,54,54,55,55,55,55,55
E01021370,EV motorcycles,Number,0,1,2,4,6,8,10,12,14,17,19,21,23,25,27,28,30,31,31,32,33,33,33,33,34,34,34,34,34,34
E01021371,EV motorcycles,Number,1,2,4,6,9,12,16,19,23,27,30,34,37,40,43,45,47,49,50,51,52,52,53,53,53,54,54,54,54,54
E01021372,EV motorcycles,Number,1,2,4,6,10,13,17,21,25,29,32,36,40,43,46,48,50,52,54,55,56,56,57,57,57,58,58,58,58,58
E01021373,EV motorcycles,Number,1,2,5,8,12,15,20,25,29,34,39,43,47,51,54,57,60,62,64,65,66,67,68,68,68,69,69,69,69,69
E01021374,EV motorcycles,Number,1,1,3,4,7,9,12,14,17,20,22,25,27,30,32,33,35,36,37,38,38,39,39,39,40,40,40,40,40,40
E01021375,EV motorcycles,Number,1,2,3,5,8,11,14,17,21,24,27,31,33,36,39,41,43,44,45,46,47,48,48,48,48,49,49,49,49,49
E01021376,EV motorcycles,Number,1,2,3,5,8,11,14,17,20,24,27,30,33,35,38,40,42,43,44,45,46,47,47,47,48,48,48,48,48,48
E01021377,EV motorcycles,Number,1,2,4,6,10,13,16,20,24,28,32,35,39,42,45,47,50,51,53,54,55,55,56,56,56,57,57,57,57,57
E01021378,EV motorcycles,Number,1,1,3,4,7,9,11,14,16,19,22,24,27,29,31,32,34,35,36,37,37,38,38,38,39,39,39,39,39,39
E01021379,EV motorcycles,Number,1,2,3,5,8,11,14,17,20,23,26,29,32,35,37,39,41,42,43,44,45,46,46,46,47,47,47,47,47,47
E01021380,EV motorcycles,Number,2,4,8,13,20,26,34,42,49,58,65,73,80,86,92,97,102,105,108,110,112,114,115,115,116,116,117,117,117,117
E01021381,EV motorcycles,Number,1,2,4,7,10,13,17,21,25,30,34,37,41,44,47,50,52,54,55,57,58,58,59,59,59,60,60,60,60,60
E01021382,EV motorcycles,Number,1,2,4,7,11,14,19,23,27,31,36,40,44,47,50,53,56,58,59,60,61,62,63,63,63,64,64,64,64,64
E01021383,EV motorcycles,Number,1,3,6,9,14,19,25,31,36,42,48,54,59,64,68,72,75,77,79,81,82,83,84,85,85,85,86,86,86,86
E01021384,EV motorcycles,Number,1,2,4,6,9,12,16,19,23,27,30,34,37,40,43,45,47,49,50,51,52,52,53,53,53,54,54,54,54,54
E01021385,EV motorcycles,Number,0,1,1,2,3,4,5,7,8,9,11,12,13,14,15,16,17,17,18,18,18,18,19,19,19,19,19,19,19,19
E01021386,EV motorcycles,Number,0,1,2,3,5,6,8,10,11,13,15,17,18,20,21,22,23,24,25,25,26,26,26,27,27,27,27,27,27,27
E01021387,EV motorcycles,Number,1,2,3,5,7,10,13,16,19,22,25,27,30,33,35,37,38,40,41,42,42,43,43,43,44,44,44,44,44,44
E01021388,EV motorcycles,Number,1,2,3,5,7,10,12,15,18,21,24,27,29,32,34,36,37,39,40,41,41,42,42,42,43,43,43,43,43,43
E01021389,EV motorcycles,Number,1,3,5,8,13,17,22,27,33,38,43,48,53,57,61,64,67,69,71,73,74,75,75,76,76,76,77,77,77,77
E01021390,EV motorcycles,Number,1,2,3,5,7,10,13,16,19,22,25,27,30,33,35,37,38,40,41,42,42,43,43,43,44,44,44,44,44,44
E01021391,EV motorcycles,Number,1,1,2,4,6,8,10,12,15,17,20,22,24,26,28,29,30,31,32,33,34,34,34,34,35,35,35,35,35,35
E01021392,EV motorcycles,Number,1,2,4,6,9,12,16,20,23,27,31,34,38,41,43,46,48,49,51,52,53,53,54,54,54,55,55,55,55,55
E01021393,EV motorcycles,Number,1,2,4,7,11,15,19,23,27,32,36,40,44,48,51,54,56,58,60,61,62,63,64,64,64,65,65,65,65,65
E01021394,EV motorcycles,Number,1,2,3,6,9,11,15,18,22,25,29,32,35,38,40,42,44,46,47,48,49,49,50,50,50,51,51,51,51,51
E01021395,EV motorcycles,Number,0,1,2,3,5,7,9,11,13,15,17,19,21,22,24,25,26,27,28,28,29,29,29,30,30,30,30,30,30,30
E01021396,EV motorcycles,Number,1,2,3,5,8,11,14,17,20,23,26,29,32,35,37,39,41,42,43,44,45,46,46,46,47,47,47,47,47,47
E01021397,EV motorcycles,Number,1,3,6,9,14,19,25,30,36,42,48,53,58,63,67,71,74,76,79,80,82,82,83,84,84,84,85,85,85,85
E01021398,EV motorcycles,Number,1,2,3,6,9,11,15,18,22,25,29,32,35,38,40,42,44,46,47,48,49,49,50,50,50,51,51,51,51,51
E01021399,EV motorcycles,Number,1,3,5,8,13,17,22,27,32,37,42,47,51,55,59,62,65,67,69,71,72,73,73,74,74,74,75,75,75,75
E01021400,EV motorcycles,Number,1,2,4,7,11,15,19,24,28,33,37,42,46,50,53,56,58,60,62,63,64,65,66,66,66,67,67,67,67,67
E01021401,EV motorcycles,Number,1,2,3,5,7,10,13,16,19,22,25,27,30,33,35,37,38,40,41,42,42,43,43,43,44,44,44,44,44,44
E01021402,EV motorcycles,Number,0,1,2,4,6,8,10,12,14,17,19,21,23,25,27,28,30,31,31,32,33,33,33,33,34,34,34,34,34,34
E01021403,EV motorcycles,Number,1,1,3,4,7,9,11,14,16,19,22,24,27,29,31,32,34,35,36,37,37,38,38,38,39,39,39,39,39,39
E01021404,EV motorcycles,Number,1,3,6,10,15,20,26,32,38,44,50,56,62,67,71,75,78,81,83,85,86,87,88,89,89,89,90,90,90,90
E01021405,EV motorcycles,Number,1,4,6,11,16,22,28,35,41,48,55,61,67,72,77,82,85,88,91,93,94,95,96,97,97,97,98,98,98,98
E01021406,EV motorcycles,Number,1,3,6,10,15,20,26,32,38,44,50,55,61,66,70,74,77,80,82,84,85,86,87,88,88,88,89,89,89,89
E01021407,EV motorcycles,Number,1,3,5,8,12,16,21,25,30,35,40,44,49,52,56,59,62,64,66,67,68,69,70,70,70,71,71,71,71,71
E01021408,EV motorcycles,Number,1,2,4,7,10,13,17,21,25,29,33,37,40,44,47,49,51,53,55,56,57,57,58,58,58,59,59,59,59,59
E01021409,EV motorcycles,Number,1,2,3,6,9,12,15,18,22,26,29,32,36,38,41,43,45,47,48,49,50,50,51,51,51,52,52,52,52,52
E01021410,EV motorcycles,Number,1,2,4,7,10,13,17,21,25,29,33,37,40,44,47,49,51,53,55,56,57,57,58,58,58,59,59,59,59,59
E01021411,EV motorcycles,Number,1,1,3,4,7,9,11,14,16,19,22,24,27,29,31,32,34,35,36,37,37,38,38,38,39,39,39,39,39,39
E01021412,EV motorcycles,Number,1,2,4,7,10,13,17,21,25,30,34,37,41,44,47,50,52,54,55,57,58,58,59,59,59,60,60,60,60,60
E01021413,EV motorcycles,Number,1,3,6,9,14,19,25,30,36,42,48,53,58,63,67,71,74,76,79,80,82,82,83,84,84,84,85,85,85,85
E01021414,EV motorcycles,Number,2,5,9,15,22,30,39,48,57,66,75,83,92,99,106,111,116,120,124,126,128,130,131,132,133,133,134,134,134,134
E01021415,EV motorcycles,Number,0,1,2,3,5,7,8,10,12,14,16,18,20,21,23,24,25,26,27,27,28,28,28,29,29,29,29,29,29,29
E01021416,EV motorcycles,Number,1,2,4,6,9,13,16,20,24,28,31,35,38,41,44,47,49,50,52,53,54,54,55,55,55,56,56,56,56,56
E01021417,EV motorcycles,Number,1,1,2,4,6,8,10,12,15,17,20,22,24,26,28,29,30,31,32,33,34,34,34,34,35,35,35,35,35,35
E01021418,EV motorcycles,Number,1,1,2,4,6,8,11,13,16,18,21,23,25,27,29,31,32,33,34,35,35,36,36,36,37,37,37,37,37,37
E01021419,EV motorcycles,Number,1,2,4,6,9,13,16,20,24,28,31,35,38,41,44,47,49,50,52,53,54,54,55,55,55,56,56,56,56,56
E01021420,EV motorcycles,Number,1,1,2,4,6,8,11,13,16,18,21,23,25,27,29,31,32,33,34,35,35,36,36,36,37,37,37,37,37,37
E01021422,EV motorcycles,Number,1,1,3,4,7,9,11,14,16,19,22,24,27,29,31,32,34,35,36,37,37,38,38,38,39,39,39,39,39,39
E01021423,EV motorcycles,Number,0,1,1,2,4,5,6,8,9,11,12,14,15,16,17,18,19,20,20,21,21,21,22,22,22,22,22,22,22,22
E01021424,EV motorcycles,Number,1,1,3,4,7,9,11,14,16,19,22,24,27,29,31,32,34,35,36,37,37,38,38,38,39,39,39,39,39,39
E01021425,EV motorcycles,Number,0,1,2,3,5,7,9,11,13,15,17,19,21,22,24,25,26,27,28,28,29,29,29,30,30,30,30,30,30,30
E01021426,EV motorcycles,Number,0,1,2,3,4,6,8,9,11,13,15,16,18,19,20,22,23,23,24,25,25,25,25,26,26,26,26,26,26,26
E01021427,EV motorcycles,Number,0,1,1,2,3,4,5,6,7,8,9,10,11,12,13,13,14,14,15,15,15,16,16,16,16,16,16,16,16,16
E01021428,EV motorcycles,Number,1,1,3,4,7,9,12,14,17,20,22,25,27,30,32,33,35,36,37,38,38,39,39,39,40,40,40,40,40,40
E01021429,EV motorcycles,Number,0,1,2,3,4,6,8,9,11,13,15,16,18,19,20,22,23,23,24,25,25,25,25,26,26,26,26,26,26,26
E01021430,EV motorcycles,Number,1,3,6,9,14,19,25,30,36,42,48,53,58,63,67,71,74,76,79,80,82,82,83,84,84,84,85,85,85,85
E01021431,EV motorcycles,Number,0,1,1,2,4,5,6,8,9,11,12,14,15,16,17,18,19,20,20,21,21,21,22,22,22,22,22,22,22,22
E01021432,EV motorcycles,Number,0,1,2,3,5,7,8,10,12,14,16,18,20,21,23,24,25,26,27,27,28,28,28,29,29,29,29,29,29,29
E01021433,EV motorcycles,Number,0,1,2,4,6,8,10,12,14,17,19,21,23,25,27,28,30,31,31,32,33,33,33,33,34,34,34,34,34,34
E01021434,EV motorcycles,Number,0,1,2,3,5,7,8,10,12,14,16,18,20,21,23,24,25,26,27,27,28,28,28,29,29,29,29,29,29,29
E01021435,EV motorcycles,Number,0,1,2,3,5,7,9,11,13,15,17,19,21,22,24,25,26,27,28,28,29,29,29,30,30,30,30,30,30,30
E01021436,EV motorcycles,Number,0,1,2,3,5,6,8,10,11,13,15,17,18,20,21,22,23,24,25,25,26,26,26,27,27,27,27,27,27,27
E01021437,EV motorcycles,Number,0,1,2,4,5,7,9,11,14,16,18,20,22,24,25,27,28,29,30,30,31,31,31,32,32,32,32,32,32,32
E01021438,EV motorcycles,Number,0,1,2,3,4,5,7,8,10,11,13,14,16,17,18,19,20,21,21,22,22,22,23,23,23,23,23,23,23,23
E01021439,EV motorcycles,Number,0,1,2,3,5,7,8,10,12,14,16,18,20,21,23,24,25,26,27,27,28,28,28,29,29,29,29,29,29,29
E01021441,EV motorcycles,Number,0,1,2,4,5,7,9,11,14,16,18,20,22,24,25,27,28,29,30,30,31,31,31,32,32,32,32,32,32,32
E01021442,EV motorcycles,Number,1,1,2,4,6,8,10,12,15,17,20,22,24,26,28,29,30,31,32,33,34,34,34,34,35,35,35,35,35,35
E01021443,EV motorcycles,Number,1,1,2,4,6,8,11,13,16,18,21,23,25,27,29,31,32,33,34,35,35,36,36,36,37,37,37,37,37,37
E01021444,EV motorcycles,Number,1,3,5,8,12,16,21,26,31,36,41,45,50,54,58,61,63,66,67,69,70,71,71,72,72,72,73,73,73,73
E01021445,EV motorcycles,Number,1,2,3,5,8,11,14,17,21,24,27,31,33,36,39,41,43,44,45,46,47,48,48,48,48,49,49,49,49,49
E01021446,EV motorcycles,Number,1,2,3,6,9,12,15,18,22,26,29,32,36,38,41,43,45,47,48,49,50,50,51,51,51,52,52,52,52,52
E01021447,EV motorcycles,Number,0,1,2,3,5,7,9,11,13,15,17,19,21,22,24,25,26,27,28,28,29,29,29,30,30,30,30,30,30,30
E01021448,EV motorcycles,Number,0,1,2,3,4,5,7,8,10,11,13,14,16,17,18,19,20,21,21,22,22,22,23,23,23,23,23,23,23,23
E01021449,EV motorcycles,Number,1,2,3,5,8,10,13,16,19,22,25,28,31,33,35,37,39,40,42,42,43,44,44,44,45,45,45,45,45,45
E01021450,EV motorcycles,Number,0,1,2,3,4,6,8,9,11,13,15,16,18,19,20,22,23,23,24,25,25,25,25,26,26,26,26,26,26,26
E01021451,EV motorcycles,Number,0,1,2,3,4,5,7,9,10,12,13,15,16,18,19,20,21,22,22,23,23,23,23,24,24,24,24,24,24,24
E01021452,EV motorcycles,Number,0,1,1,2,3,4,6,7,8,10,11,12,14,15,16,17,17,18,18,19,19,19,20,20,20,20,20,20,20,20
E01021453,EV motorcycles,Number,0,1,2,3,4,6,7,9,11,12,14,16,17,18,20,21,22,22,23,24,24,24,24,25,25,25,25,25,25,25
E01021454,EV motorcycles,Number,0,0,1,1,2,2,3,4,4,5,6,6,7,7,8,8,9,9,9,9,10,10,10,10,10,10,10,10,10,10
E01021455,EV motorcycles,Number,0,1,1,2,3,4,6,7,8,10,11,12,14,15,16,17,17,18,18,19,19,19,20,20,20,20,20,20,20,20
E01021456,EV motorcycles,Number,0,1,2,3,4,5,7,9,10,12,13,15,16,18,19,20,21,22,22,23,23,23,23,24,24,24,24,24,24,24
E01021457,EV motorcycles,Number,0,1,2,3,5,6,8,10,12,14,16,17,19,21,22,23,24,25,26,26,27,27,27,28,28,28,28,28,28,28
E01021458,EV motorcycles,Number,0,1,2,3,5,6,8,10,12,14,16,17,19,21,22,23,24,25,26,26,27,27,27,28,28,28,28,28,28,28
E01021459,EV motorcycles,Number,0,1,2,4,6,7,10,12,14,16,18,21,23,24,26,27,29,30,31,31,32,32,32,33,33,33,33,33,33,33
E01021460,EV motorcycles,Number,0,1,2,3,5,7,8,10,12,14,16,18,20,21,23,24,25,26,27,27,28,28,28,29,29,29,29,29,29,29
E01021461,EV motorcycles,Number,0,1,2,3,4,6,7,9,11,12,14,16,17,18,20,21,22,22,23,24,24,24,24,25,25,25,25,25,25,25
E01021462,EV motorcycles,Number,1,1,2,4,6,8,11,13,16,18,21,23,25,27,29,31,32,33,34,35,35,36,36,36,37,37,37,37,37,37
E01021463,EV motorcycles,Number,1,2,3,5,8,11,14,17,20,23,26,29,32,35,37,39,41,42,43,44,45,46,46,46,47,47,47,47,47,47
E01021464,EV motorcycles,Number,0,1,2,4,6,8,10,12,14,17,19,21,23,25,27,28,30,31,31,32,33,33,33,33,34,34,34,34,34,34
E01021465,EV motorcycles,Number,0,0,1,1,2,2,3,4,4,5,6,6,7,7,8,8,9,9,9,9,10,10,10,10,10,10,10,10,10,10
E01021466,EV motorcycles,Number,0,1,2,4,6,7,10,12,14,16,18,21,23,24,26,27,29,30,31,31,32,32,32,33,33,33,33,33,33,33
E01021467,EV motorcycles,Number,0,1,1,2,4,5,6,7,9,10,12,13,14,16,17,17,18,19,19,20,20,20,21,21,21,21,21,21,21,21
E01021468,EV motorcycles,Number,1,3,5,8,13,17,22,27,32,37,43,47,52,56,60,63,66,68,70,72,73,74,74,75,75,75,76,76,76,76
E01021469,EV motorcycles,Number,0,1,2,3,4,6,8,9,11,13,15,16,18,19,20,22,23,23,24,25,25,25,25,26,26,26,26,26,26,26
E01021470,EV motorcycles,Number,1,2,3,5,8,11,14,17,21,24,27,31,33,36,39,41,43,44,45,46,47,48,48,48,48,49,49,49,49,49
E01021471,EV motorcycles,Number,1,2,3,6,9,12,15,19,22,26,30,33,36,39,42,44,46,48,49,50,51,51,52,52,52,53,53,53,53,53
E01021472,EV motorcycles,Number,0,1,1,2,2,3,4,5,6,7,8,9,10,10,11,12,12,13,13,13,13,14,14,14,14,14,14,14,14,14
E01021473,EV motorcycles,Number,1,1,3,4,7,9,12,14,17,20,22,25,27,30,32,33,35,36,37,38,38,39,39,39,40,40,40,40,40,40
E01021474,EV motorcycles,Number,0,1,1,2,3,4,5,6,7,8,9,10,11,12,13,13,14,14,15,15,15,16,16,16,16,16,16,16,16,16
E01021475,EV motorcycles,Number,0,1,2,3,5,6,8,10,11,13,15,17,18,20,21,22,23,24,25,25,26,26,26,27,27,27,27,27,27,27
E01021476,EV motorcycles,Number,1,2,3,6,9,11,15,18,22,25,29,32,35,38,40,42,44,46,47,48,49,49,50,50,50,51,51,51,51,51
E01021477,EV motorcycles,Number,0,1,2,4,6,8,10,12,14,17,19,21,23,25,27,28,30,31,31,32,33,33,33,33,34,34,34,34,34,34
E01021478,EV motorcycles,Number,1,1,2,4,6,8,10,13,15,18,20,22,25,27,28,30,31,32,33,34,35,35,35,35,36,36,36,36,36,36
E01021479,EV motorcycles,Number,0,1,2,3,4,6,7,9,11,12,14,16,17,18,20,21,22,22,23,24,24,24,24,25,25,25,25,25,25,25
E01021480,EV motorcycles,Number,1,2,3,5,8,11,14,17,20,24,27,30,33,35,38,40,42,43,44,45,46,47,47,47,48,48,48,48,48,48
E01021481,EV motorcycles,Number,1,2,3,5,7,10,13,16,19,22,25,27,30,33,35,37,38,40,41,42,42,43,43,43,44,44,44,44,44,44
E01021482,EV motorcycles,Number,1,1,3,5,7,9,12,15,17,20,23,26,28,30,32,34,36,37,38,39,39,40,40,40,41,41,41,41,41,41
E01021483,EV motorcycles,Number,1,3,5,8,12,16,20,25,30,34,39,44,48,52,55,58,61,63,65,66,67,68,69,69,69,70,70,70,70,70
E01021484,EV motorcycles,Number,0,1,2,3,4,5,7,9,10,12,13,15,16,18,19,20,21,22,22,23,23,23,23,24,24,24,24,24,24,24
E01021485,EV motorcycles,Number,0,1,2,3,5,6,8,10,12,14,16,17,19,21,22,23,24,25,26,26,27,27,27,28,28,28,28,28,28,28
E01021486,EV motorcycles,Number,0,1,1,2,3,3,4,5,6,7,8,9,10,11,12,12,13,13,14,14,14,15,15,15,15,15,15,15,15,15
E01021487,EV motorcycles,Number,0,1,2,3,5,7,9,11,13,15,17,19,21,23,24,26,27,28,29,29,30,30,30,31,31,31,31,31,31,31
E01021488,EV motorcycles,Number,0,1,2,3,4,6,8,9,11,13,15,16,18,19,20,22,23,23,24,25,25,25,25,26,26,26,26,26,26,26
E01021489,EV motorcycles,Number,1,2,3,5,8,11,14,17,20,23,26,29,32,35,37,39,41,42,43,44,45,46,46,46,47,47,47,47,47,47
E01021490,EV motorcycles,Number,1,1,2,4,6,9,11,13,16,19,21,24,26,28,30,32,33,34,35,36,36,37,37,37,38,38,38,38,38,38
E01021491,EV motorcycles,Number,1,1,3,4,7,9,11,14,16,19,22,24,27,29,31,32,34,35,36,37,37,38,38,38,39,39,39,39,39,39
E01021492,EV motorcycles,Number,0,1,2,4,5,7,9,11,14,16,18,20,22,24,25,27,28,29,30,30,31,31,31,32,32,32,32,32,32,32
E01021493,EV motorcycles,Number,1,2,3,5,8,11,14,17,20,24,27,30,33,35,38,40,42,43,44,45,46,47,47,47,48,48,48,48,48,48
E01021494,EV motorcycles,Number,0,1,2,3,5,7,9,11,13,15,17,19,21,22,24,25,26,27,28,28,29,29,29,30,30,30,30,30,30,30
E01021495,EV motorcycles,Number,1,1,2,4,6,8,10,12,15,17,20,22,24,26,28,29,30,31,32,33,34,34,34,34,35,35,35,35,35,35
E01021496,EV motorcycles,Number,1,1,3,4,7,9,11,14,16,19,22,24,27,29,31,32,34,35,36,37,37,38,38,38,39,39,39,39,39,39
E01021497,EV motorcycles,Number,1,2,3,5,7,9,12,15,18,21,24,26,29,31,33,35,36,38,39,40,40,41,41,41,42,42,42,42,42,42
E01021498,EV motorcycles,Number,1,1,3,4,7,9,11,14,16,19,22,24,27,29,31,32,34,35,36,37,37,38,38,38,39,39,39,39,39,39
E01021499,EV motorcycles,Number,0,1,2,4,6,7,10,12,14,16,18,21,23,24,26,27,29,30,31,31,32,32,32,33,33,33,33,33,33,33
E01021500,EV motorcycles,Number,1,2,3,5,7,9,12,15,18,21,24,26,29,31,33,35,36,38,39,40,40,41,41,41,42,42,42,42,42,42
E01021501,EV motorcycles,Number,0,1,2,4,6,8,10,12,14,17,19,21,23,25,27,28,30,31,31,32,33,33,33,33,34,34,34,34,34,34
E01021502,EV motorcycles,Number,1,2,4,6,10,13,17,21,25,29,32,36,40,43,46,48,50,52,54,55,56,56,57,57,57,58,58,58,58,58
E01021503,EV motorcycles,Number,1,2,3,5,8,10,13,16,19,22,25,28,31,33,35,37,39,40,42,42,43,44,44,44,45,45,45,45,45,45
E01021504,EV motorcycles,Number,0,1,2,3,4,6,8,9,11,13,15,16,18,19,20,22,23,23,24,25,25,25,25,26,26,26,26,26,26,26
E01021505,EV motorcycles,Number,1,2,3,5,8,10,13,16,19,22,25,28,31,33,35,37,39,40,42,42,43,44,44,44,45,45,45,45,45,45
E01021506,EV motorcycles,Number,0,1,2,3,5,6,8,10,11,13,15,17,18,20,21,22,23,24,25,25,26,26,26,27,27,27,27,27,27,27
E01021507,EV motorcycles,Number,0,1,2,4,6,7,10,12,14,16,18,21,23,24,26,27,29,30,31,31,32,32,32,33,33,33,33,33,33,33
E01021508,EV motorcycles,Number,0,1,2,3,5,7,9,11,13,15,17,19,21,23,24,26,27,28,29,29,30,30,30,31,31,31,31,31,31,31
E01021509,EV motorcycles,Number,0,1,2,3,5,6,8,10,12,14,16,17,19,21,22,23,24,25,26,26,27,27,27,28,28,28,28,28,28,28
E01021510,EV motorcycles,Number,1,1,2,4,6,8,10,12,15,17,20,22,24,26,28,29,30,31,32,33,34,34,34,34,35,35,35,35,35,35
E01021511,EV motorcycles,Number,1,2,3,5,7,9,12,15,18,21,24,26,29,31,33,35,36,38,39,40,40,41,41,41,42,42,42,42,42,42
E01021512,EV motorcycles,Number,1,2,4,6,9,12,16,19,23,27,30,34,37,40,43,45,47,49,50,51,52,52,53,53,53,54,54,54,54,54
E01021513,EV motorcycles,Number,0,1,2,3,4,6,8,9,11,13,15,16,18,19,20,22,23,23,24,25,25,25,25,26,26,26,26,26,26,26
E01021514,EV motorcycles,Number,0,1,2,3,5,6,8,10,11,13,15,17,18,20,21,22,23,24,25,25,26,26,26,27,27,27,27,27,27,27
E01021515,EV motorcycles,Number,0,1,2,3,4,6,8,9,11,13,15,16,18,19,20,22,23,23,24,25,25,25,25,26,26,26,26,26,26,26
E01021516,EV motorcycles,Number,1,2,3,5,8,11,14,17,20,23,26,29,32,35,37,39,41,42,43,44,45,46,46,46,47,47,47,47,47,47
E01021517,EV motorcycles,Number,0,1,2,3,4,6,8,9,11,13,15,16,18,19,20,22,23,23,24,25,25,25,25,26,26,26,26,26,26,26
E01021518,EV motorcycles,Number,1,1,3,5,7,9,12,15,17,20,23,26,28,30,32,34,36,37,38,39,39,40,40,40,41,41,41,41,41,41
E01021519,EV motorcycles,Number,0,1,2,3,4,6,8,9,11,13,15,16,18,19,20,22,23,23,24,25,25,25,25,26,26,26,26,26,26,26
E01021520,EV motorcycles,Number,1,1,2,4,6,8,10,12,15,17,20,22,24,26,28,29,30,31,32,33,34,34,34,34,35,35,35,35,35,35
E01021521,EV motorcycles,Number,0,1,2,4,6,7,10,12,14,16,18,21,23,24,26,27,29,30,31,31,32,32,32,33,33,33,33,33,33,33
E01021522,EV motorcycles,Number,1,2,3,5,8,10,13,16,19,22,25,28,31,33,35,37,39,40,42,42,43,44,44,44,45,45,45,45,45,45
E01021523,EV motorcycles,Number,1,1,3,4,7,9,12,14,17,20,22,25,27,30,32,33,35,36,37,38,38,39,39,39,40,40,40,40,40,40
E01021524,EV motorcycles,Number,1,2,3,5,7,9,12,15,18,21,24,26,29,31,33,35,36,38,39,40,40,41,41,41,42,42,42,42,42,42
E01021525,EV motorcycles,Number,0,1,2,4,5,7,9,11,14,16,18,20,22,24,25,27,28,29,30,30,31,31,31,32,32,32,32,32,32,32
E01021526,EV motorcycles,Number,1,2,3,5,7,9,12,15,18,21,24,26,29,31,33,35,36,38,39,40,40,41,41,41,42,42,42,42,42,42
E01021527,EV motorcycles,Number,1,2,3,5,7,10,12,15,18,21,24,27,29,32,34,36,37,39,40,41,41,42,42,42,43,43,43,43,43,43
E01021528,EV motorcycles,Number,1,2,3,6,9,12,15,19,22,26,30,33,36,39,42,44,46,48,49,50,51,51,52,52,52,53,53,53,53,53
E01021529,EV motorcycles,Number,1,1,2,4,6,9,11,13,16,19,21,24,26,28,30,32,33,34,35,36,36,37,37,37,38,38,38,38,38,38
E01021530,EV motorcycles,Number,1,2,3,5,8,11,14,17,20,23,26,29,32,35,37,39,41,42,43,44,45,46,46,46,47,47,47,47,47,47
E01021531,EV motorcycles,Number,0,1,2,4,6,7,10,12,14,16,18,21,23,24,26,27,29,30,31,31,32,32,32,33,33,33,33,33,33,33
E01021532,EV motorcycles,Number,1,2,3,5,7,9,12,15,18,21,24,26,29,31,33,35,36,38,39,40,40,41,41,41,42,42,42,42,42,42
E01021533,EV motorcycles,Number,1,2,4,6,9,13,16,20,24,28,31,35,38,41,44,47,49,50,52,53,54,54,55,55,55,56,56,56,56,56
E01021535,EV motorcycles,Number,1,3,5,8,13,17,22,27,32,37,43,47,52,56,60,63,66,68,70,72,73,74,74,75,75,75,76,76,76,76
E01021536,EV motorcycles,Number,1,2,4,7,11,15,19,23,28,32,37,41,45,49,52,55,57,59,61,62,63,64,65,65,65,66,66,66,66,66
E01021537,EV motorcycles,Number,1,2,4,7,10,13,17,21,25,29,33,37,40,44,47,49,51,53,55,56,57,57,58,58,58,59,59,59,59,59
E01021538,EV motorcycles,Number,1,3,6,9,14,19,25,31,36,42,48,54,59,64,68,72,75,77,79,81,82,83,84,85,85,85,86,86,86,86
E01021539,EV motorcycles,Number,1,2,3,5,7,9,12,15,18,21,24,26,29,31,33,35,36,38,39,40,40,41,41,41,42,42,42,42,42,42
E01021540,EV motorcycles,Number,1,2,3,6,8,11,14,18,21,25,28,31,34,37,39,42,43,45,46,47,48,49,49,49,49,50,50,50,50,50
E01021541,EV motorcycles,Number,1,2,3,6,8,11,14,18,21,25,28,31,34,37,39,42,43,45,46,47,48,49,49,49,49,50,50,50,50,50
E01021542,EV motorcycles,Number,1,2,4,7,10,14,18,22,26,30,34,38,42,45,48,51,53,55,56,58,58,59,60,60,60,61,61,61,61,61
E01021543,EV motorcycles,Number,1,2,4,6,9,12,16,20,23,27,31,34,38,41,43,46,48,49,51,52,53,53,54,54,54,55,55,55,55,55
E01021544,EV motorcycles,Number,1,2,3,6,9,12,15,18,22,26,29,32,36,38,41,43,45,47,48,49,50,50,51,51,51,52,52,52,52,52
E01021545,EV motorcycles,Number,0,1,2,3,5,6,8,10,12,14,16,17,19,21,22,23,24,25,26,26,27,27,27,28,28,28,28,28,28,28
E01021546,EV motorcycles,Number,0,1,2,3,4,5,7,9,10,12,13,15,16,18,19,20,21,22,22,23,23,23,23,24,24,24,24,24,24,24
E01021547,EV motorcycles,Number,0,1,1,2,3,4,5,7,8,9,11,12,13,14,15,16,17,17,18,18,18,18,19,19,19,19,19,19,19,19
E01021548,EV motorcycles,Number,0,1,2,3,4,5,7,8,10,11,13,14,16,17,18,19,20,21,21,22,22,22,23,23,23,23,23,23,23,23
E01021550,EV motorcycles,Number,1,2,4,7,11,14,19,23,27,31,36,40,44,47,50,53,56,58,59,60,61,62,63,63,63,64,64,64,64,64
E01021551,EV motorcycles,Number,1,1,3,5,7,9,12,15,17,20,23,26,28,30,32,34,36,37,38,39,39,40,40,40,41,41,41,41,41,41
E01021552,EV motorcycles,Number,1,2,3,5,8,11,14,17,20,24,27,30,33,35,38,40,42,43,44,45,46,47,47,47,48,48,48,48,48,48
E01021553,EV motorcycles,Number,0,1,1,2,3,4,6,7,8,10,11,12,14,15,16,17,17,18,18,19,19,19,20,20,20,20,20,20,20,20
E01021554,EV motorcycles,Number,0,1,2,3,4,6,8,9,11,13,15,16,18,19,20,22,23,23,24,25,25,25,25,26,26,26,26,26,26,26
E01021555,EV motorcycles,Number,1,1,3,4,7,9,12,14,17,20,22,25,27,30,32,33,35,36,37,38,38,39,39,39,40,40,40,40,40,40
E01021556,EV motorcycles,Number,1,2,3,5,8,11,14,17,20,23,26,29,32,35,37,39,41,42,43,44,45,46,46,46,47,47,47,47,47,47
E01021557,EV motorcycles,Number,0,1,2,3,5,6,8,10,11,13,15,17,18,20,21,22,23,24,25,25,26,26,26,27,27,27,27,27,27,27
E01021558,EV motorcycles,Number,0,1,2,3,4,5,7,9,10,12,13,15,16,18,19,20,21,22,22,23,23,23,23,24,24,24,24,24,24,24
E01021559,EV motorcycles,Number,1,2,3,5,8,10,13,16,19,23,26,29,31,34,36,38,40,41,43,43,44,45,45,45,46,46,46,46,46,46
E01021560,EV motorcycles,Number,1,1,2,4,6,9,11,13,16,19,21,24,26,28,30,32,33,34,35,36,36,37,37,37,38,38,38,38,38,38
E01021561,EV motorcycles,Number,1,2,4,6,9,13,16,20,24,28,31,35,38,41,44,47,49,50,52,53,54,54,55,55,55,56,56,56,56,56
E01021562,EV motorcycles,Number,1,2,3,6,9,12,15,19,22,26,30,33,36,39,42,44,46,48,49,50,51,51,52,52,52,53,53,53,53,53
E01021563,EV motorcycles,Number,0,1,1,2,3,4,5,7,8,9,11,12,13,14,15,16,17,17,18,18,18,18,19,19,19,19,19,19,19,19
E01021564,EV motorcycles,Number,1,1,2,4,6,9,11,13,16,19,21,24,26,28,30,32,33,34,35,36,36,37,37,37,38,38,38,38,38,38
E01021565,EV motorcycles,Number,0,1,2,3,5,7,9,11,13,15,17,19,21,23,24,26,27,28,29,29,30,30,30,31,31,31,31,31,31,31
E01021566,EV motorcycles,Number,1,1,2,4,6,9,11,13,16,19,21,24,26,28,30,32,33,34,35,36,36,37,37,37,38,38,38,38,38,38
E01021568,EV motorcycles,Number,0,1,2,4,6,8,10,12,14,17,19,21,23,25,27,28,30,31,31,32,33,33,33,33,34,34,34,34,34,34
E01021569,EV motorcycles,Number,1,1,2,4,6,8,10,12,15,17,20,22,24,26,28,29,30,31,32,33,34,34,34,34,35,35,35,35,35,35
E01021570,EV motorcycles,Number,1,2,3,5,8,10,13,16,19,23,26,29,31,34,36,38,40,41,43,43,44,45,45,45,46,46,46,46,46,46
E01021571,EV motorcycles,Number,0,1,2,4,5,7,9,11,14,16,18,20,22,24,25,27,28,29,30,30,31,31,31,32,32,32,32,32,32,32
E01021572,EV motorcycles,Number,1,2,3,5,8,10,13,16,19,22,25,28,31,33,35,37,39,40,42,42,43,44,44,44,45,45,45,45,45,45
E01021573,EV motorcycles,Number,1,1,2,4,6,8,11,13,16,18,21,23,25,27,29,31,32,33,34,35,35,36,36,36,37,37,37,37,37,37
E01021574,EV motorcycles,Number,0,1,2,3,5,7,9,11,13,15,17,19,21,23,24,26,27,28,29,29,30,30,30,31,31,31,31,31,31,31
E01021575,EV motorcycles,Number,0,1,2,3,4,5,7,9,10,12,13,15,16,18,19,20,21,22,22,23,23,23,23,24,24,24,24,24,24,24
E01021576,EV motorcycles,Number,1,1,2,4,6,9,11,13,16,19,21,24,26,28,30,32,33,34,35,36,36,37,37,37,38,38,38,38,38,38
E01021577,EV motorcycles,Number,0,1,2,3,4,5,7,8,10,11,13,14,16,17,18,19,20,21,21,22,22,22,23,23,23,23,23,23,23,23
E01021578,EV motorcycles,Number,0,1,1,2,4,5,6,7,9,10,12,13,14,16,17,17,18,19,19,20,20,20,21,21,21,21,21,21,21,21
E01021579,EV motorcycles,Number,0,1,2,3,5,7,8,10,12,14,16,18,20,21,23,24,25,26,27,27,28,28,28,29,29,29,29,29,29,29
E01021580,EV motorcycles,Number,0,1,2,4,6,8,10,12,14,17,19,21,23,25,27,28,30,31,31,32,33,33,33,33,34,34,34,34,34,34
E01021582,EV motorcycles,Number,0,0,1,1,2,3,3,4,5,6,7,7,8,9,9,10,10,11,11,11,12,12,12,12,12,12,12,12,12,12
E01021583,EV motorcycles,Number,0,1,2,3,4,5,7,8,10,11,13,14,16,17,18,19,20,21,21,22,22,22,23,23,23,23,23,23,23,23
E01021584,EV motorcycles,Number,0,1,1,2,4,5,6,8,9,11,12,14,15,16,17,18,19,20,20,21,21,21,22,22,22,22,22,22,22,22
E01021585,EV motorcycles,Number,0,1,2,3,5,7,8,10,12,14,16,18,20,21,23,24,25,26,27,27,28,28,28,29,29,29,29,29,29,29
E01021586,EV motorcycles,Number,1,1,2,4,6,8,10,13,15,18,20,22,25,27,28,30,31,32,33,34,35,35,35,35,36,36,36,36,36,36
E01021587,EV motorcycles,Number,0,1,2,3,5,6,8,10,11,13,15,17,18,20,21,22,23,24,25,25,26,26,26,27,27,27,27,27,27,27
E01021588,EV motorcycles,Number,0,1,1,2,4,5,6,7,9,10,12,13,14,16,17,17,18,19,19,20,20,20,21,21,21,21,21,21,21,21
E01021589,EV motorcycles,Number,0,1,2,3,5,7,8,10,12,14,16,18,20,21,23,24,25,26,27,27,28,28,28,29,29,29,29,29,29,29
E01021590,EV motorcycles,Number,0,1,2,3,4,5,7,9,10,12,13,15,16,18,19,20,21,22,22,23,23,23,23,24,24,24,24,24,24,24
E01021591,EV motorcycles,Number,1,1,2,4,6,8,10,13,15,18,20,22,25,27,28,30,31,32,33,34,35,35,35,35,36,36,36,36,36,36
E01021592,EV motorcycles,Number,0,1,1,2,3,4,6,7,8,10,11,12,14,15,16,17,17,18,18,19,19,19,20,20,20,20,20,20,20,20
E01021593,EV motorcycles,Number,0,1,2,3,5,7,9,11,13,15,17,19,21,23,24,26,27,28,29,29,30,30,30,31,31,31,31,31,31,31
E01021594,EV motorcycles,Number,1,3,6,10,16,21,27,33,39,46,52,58,64,69,73,77,81,84,86,88,89,90,91,92,92,92,93,93,93,93
E01021595,EV motorcycles,Number,1,2,3,5,8,11,14,17,20,24,27,30,33,35,38,40,42,43,44,45,46,47,47,47,48,48,48,48,48,48
E01021596,EV motorcycles,Number,0,1,2,3,4,5,7,8,10,11,13,14,16,17,18,19,20,21,21,22,22,22,23,23,23,23,23,23,23,23
E01021597,EV motorcycles,Number,0,1,2,4,6,8,10,12,14,17,19,21,23,25,27,28,30,31,31,32,33,33,33,33,34,34,34,34,34,34
E01021598,EV motorcycles,Number,0,1,1,2,3,4,6,7,8,10,11,12,14,15,16,17,17,18,18,19,19,19,20,20,20,20,20,20,20,20
E01021599,EV motorcycles,Number,1,1,2,4,6,8,11,13,16,18,21,23,25,27,29,31,32,33,34,35,35,36,36,36,37,37,37,37,37,37
E01021600,EV motorcycles,Number,0,1,2,4,5,7,9,11,14,16,18,20,22,24,25,27,28,29,30,30,31,31,31,32,32,32,32,32,32,32
E01021601,EV motorcycles,Number,1,2,3,5,7,9,12,15,18,21,24,26,29,31,33,35,36,38,39,40,40,41,41,41,42,42,42,42,42,42
E01021602,EV motorcycles,Number,1,2,4,7,10,13,17,21,25,29,33,37,40,44,47,49,51,53,55,56,57,57,58,58,58,59,59,59,59,59
E01021604,EV motorcycles,Number,1,2,4,7,11,14,18,22,27,31,35,39,43,47,50,52,55,57,58,59,60,61,62,62,62,63,63,63,63,63
E01021605,EV motorcycles,Number,0,1,1,2,4,5,6,7,9,10,12,13,14,16,17,17,18,19,19,20,20,20,21,21,21,21,21,21,21,21
E01021606,EV motorcycles,Number,1,2,3,5,7,9,12,15,18,21,24,26,29,31,33,35,36,38,39,40,40,41,41,41,42,42,42,42,42,42
E01021607,EV motorcycles,Number,0,1,2,3,5,6,8,10,11,13,15,17,18,20,21,22,23,24,25,25,26,26,26,27,27,27,27,27,27,27
E01021608,EV motorcycles,Number,0,0,1,1,2,3,3,4,5,6,7,7,8,9,9,10,10,11,11,11,12,12,12,12,12,12,12,12,12,12
E01021609,EV motorcycles,Number,1,1,2,4,6,8,10,13,15,18,20,22,25,27,28,30,31,32,33,34,35,35,35,35,36,36,36,36,36,36
E01021610,EV motorcycles,Number,0,1,1,2,3,4,6,7,8,10,11,12,14,15,16,17,17,18,18,19,19,19,20,20,20,20,20,20,20,20
E01021611,EV motorcycles,Number,1,2,3,5,8,11,14,17,20,23,26,29,32,35,37,39,41,42,43,44,45,46,46,46,47,47,47,47,47,47
E01021612,EV motorcycles,Number,0,1,2,4,6,7,10,12,14,16,18,21,23,24,26,27,29,30,31,31,32,32,32,33,33,33,33,33,33,33
E01021613,EV motorcycles,Number,1,2,3,5,8,10,13,16,19,23,26,29,31,34,36,38,40,41,43,43,44,45,45,45,46,46,46,46,46,46
E01021614,EV motorcycles,Number,0,1,2,3,5,7,9,11,13,15,17,19,21,23,24,26,27,28,29,29,30,30,30,31,31,31,31,31,31,31
E01021615,EV motorcycles,Number,0,1,2,3,5,6,8,10,12,14,16,17,19,21,22,23,24,25,26,26,27,27,27,28,28,28,28,28,28,28
E01021616,EV motorcycles,Number,1,2,3,5,8,11,14,17,21,24,27,31,33,36,39,41,43,44,45,46,47,48,48,48,48,49,49,49,49,49
E01021617,EV motorcycles,Number,0,1,2,3,4,5,7,8,10,11,13,14,16,17,18,19,20,21,21,22,22,22,23,23,23,23,23,23,23,23
E01021618,EV motorcycles,Number,1,2,3,5,7,10,12,15,18,21,24,27,29,32,34,36,37,39,40,41,41,42,42,42,43,43,43,43,43,43
E01021619,EV motorcycles,Number,0,1,2,3,4,6,7,9,11,12,14,16,17,18,20,21,22,22,23,24,24,24,24,25,25,25,25,25,25,25
E01021620,EV motorcycles,Number,0,1,2,3,5,6,8,10,11,13,15,17,18,20,21,22,23,24,25,25,26,26,26,27,27,27,27,27,27,27
E01021621,EV motorcycles,Number,1,2,3,5,7,10,13,16,19,22,25,27,30,33,35,37,38,40,41,42,42,43,43,43,44,44,44,44,44,44
E01021622,EV motorcycles,Number,0,1,2,3,4,6,8,9,11,13,15,16,18,19,20,22,23,23,24,25,25,25,25,26,26,26,26,26,26,26
E01021623,EV motorcycles,Number,0,1,1,2,3,4,5,6,7,8,9,10,11,12,13,13,14,14,15,15,15,16,16,16,16,16,16,16,16,16
E01021624,EV motorcycles,Number,0,1,2,4,6,8,10,12,14,17,19,21,23,25,27,28,30,31,31,32,33,33,33,33,34,34,34,34,34,34
E01021625,EV motorcycles,Number,0,1,2,3,4,6,7,9,11,12,14,16,17,18,20,21,22,22,23,24,24,24,24,25,25,25,25,25,25,25
E01021626,EV motorcycles,Number,1,2,3,5,7,10,13,16,19,22,25,27,30,33,35,37,38,40,41,42,42,43,43,43,44,44,44,44,44,44
E01021627,EV motorcycles,Number,0,1,1,2,2,3,4,5,6,7,8,9,10,10,11,12,12,13,13,13,13,14,14,14,14,14,14,14,14,14
E01021628,EV motorcycles,Number,0,1,2,4,5,7,9,11,14,16,18,20,22,24,25,27,28,29,30,30,31,31,31,32,32,32,32,32,32,32
E01021629,EV motorcycles,Number,0,1,2,3,5,7,8,10,12,14,16,18,20,21,23,24,25,26,27,27,28,28,28,29,29,29,29,29,29,29
E01021631,EV motorcycles,Number,1,2,3,5,7,10,12,15,18,21,24,27,29,32,34,36,37,39,40,41,41,42,42,42,43,43,43,43,43,43
E01021632,EV motorcycles,Number,1,2,3,5,7,10,12,15,18,21,24,27,29,32,34,36,37,39,40,41,41,42,42,42,43,43,43,43,43,43
E01021633,EV motorcycles,Number,0,1,2,3,4,6,8,9,11,13,15,16,18,19,20,22,23,23,24,25,25,25,25,26,26,26,26,26,26,26
E01021634,EV motorcycles,Number,1,1,2,4,6,8,10,12,15,17,20,22,24,26,28,29,30,31,32,33,34,34,34,34,35,35,35,35,35,35
E01021635,EV motorcycles,Number,1,1,2,4,6,8,11,13,16,18,21,23,25,27,29,31,32,33,34,35,35,36,36,36,37,37,37,37,37,37
E01021636,EV motorcycles,Number,0,1,2,3,4,5,7,8,10,11,13,14,16,17,18,19,20,21,21,22,22,22,23,23,23,23,23,23,23,23
E01021637,EV motorcycles,Number,1,1,2,4,6,9,11,13,16,19,21,24,26,28,30,32,33,34,35,36,36,37,37,37,38,38,38,38,38,38
E01021638,EV motorcycles,Number,1,2,4,6,9,12,16,20,23,27,31,34,38,41,43,46,48,49,51,52,53,53,54,54,54,55,55,55,55,55
E01021639,EV motorcycles,Number,1,2,4,6,9,13,16,20,24,28,31,35,38,41,44,47,49,50,52,53,54,54,55,55,55,56,56,56,56,56
E01021640,EV motorcycles,Number,0,1,2,4,6,7,10,12,14,16,18,21,23,24,26,27,29,30,31,31,32,32,32,33,33,33,33,33,33,33
E01021641,EV motorcycles,Number,1,2,3,5,8,11,14,17,21,24,27,31,33,36,39,41,43,44,45,46,47,48,48,48,48,49,49,49,49,49
E01021642,EV motorcycles,Number,1,2,4,7,10,13,17,21,25,29,33,37,40,44,47,49,51,53,55,56,57,57,58,58,58,59,59,59,59,59
E01021643,EV motorcycles,Number,1,3,5,8,13,17,22,27,32,37,42,47,51,55,59,62,65,67,69,71,72,73,73,74,74,74,75,75,75,75
E01021644,EV motorcycles,Number,1,3,5,8,12,16,21,26,31,36,41,45,50,54,58,61,63,66,67,69,70,71,71,72,72,72,73,73,73,73
E01021645,EV motorcycles,Number,1,2,4,7,10,13,17,21,25,30,34,37,41,44,47,50,52,54,55,57,58,58,59,59,59,60,60,60,60,60
E01021646,EV motorcycles,Number,0,1,2,4,5,7,9,11,14,16,18,20,22,24,25,27,28,29,30,30,31,31,31,32,32,32,32,32,32,32
E01021647,EV motorcycles,Number,1,1,2,4,6,8,10,12,15,17,20,22,24,26,28,29,30,31,32,33,34,34,34,34,35,35,35,35,35,35
E01021648,EV motorcycles,Number,0,1,2,3,4,5,7,8,10,11,13,14,16,17,18,19,20,21,21,22,22,22,23,23,23,23,23,23,23,23
E01021649,EV motorcycles,Number,1,1,2,4,6,9,11,13,16,19,21,24,26,28,30,32,33,34,35,36,36,37,37,37,38,38,38,38,38,38
E01021650,EV motorcycles,Number,1,1,3,4,7,9,11,14,16,19,22,24,27,29,31,32,34,35,36,37,37,38,38,38,39,39,39,39,39,39
E01021651,EV motorcycles,Number,0,1,2,3,5,7,8,10,12,14,16,18,20,21,23,24,25,26,27,27,28,28,28,29,29,29,29,29,29,29
E01021652,EV motorcycles,Number,1,1,2,4,6,8,10,12,15,17,20,22,24,26,28,29,30,31,32,33,34,34,34,34,35,35,35,35,35,35
E01021653,EV motorcycles,Number,0,1,2,3,5,7,9,11,13,15,17,19,21,23,24,26,27,28,29,29,30,30,30,31,31,31,31,31,31,31
E01021654,EV motorcycles,Number,2,4,7,12,19,25,32,39,47,55,62,69,76,82,88,92,96,100,103,105,106,108,109,109,110,110,111,111,111,111
E01021655,EV motorcycles,Number,1,1,2,4,6,8,10,12,15,17,20,22,24,26,28,29,30,31,32,33,34,34,34,34,35,35,35,35,35,35
E01021656,EV motorcycles,Number,1,2,3,6,9,12,15,19,22,26,30,33,36,39,42,44,46,48,49,50,51,51,52,52,52,53,53,53,53,53
E01021657,EV motorcycles,Number,1,3,5,8,12,17,21,26,31,36,41,46,51,55,58,62,64,67,68,70,71,72,72,73,73,73,74,74,74,74
E01021658,EV motorcycles,Number,1,2,3,5,7,10,12,15,18,21,24,27,29,32,34,36,37,39,40,41,41,42,42,42,43,43,43,43,43,43
E01021659,EV motorcycles,Number,1,3,5,9,14,18,23,29,34,40,45,50,55,60,64,67,70,73,75,76,78,79,79,80,80,80,81,81,81,81
E01021660,EV motorcycles,Number,1,2,4,7,10,14,18,22,26,30,35,39,42,46,49,52,54,56,57,59,59,60,61,61,61,62,62,62,62,62
E01021661,EV motorcycles,Number,1,2,3,5,8,11,14,17,21,24,27,31,33,36,39,41,43,44,45,46,47,48,48,48,48,49,49,49,49,49
E01021662,EV motorcycles,Number,1,3,5,9,13,18,23,28,33,39,44,49,54,58,62,66,69,71,73,75,76,77,77,78,78,78,79,79,79,79
E01021663,EV motorcycles,Number,1,2,4,7,10,13,17,21,25,30,34,37,41,44,47,50,52,54,55,57,58,58,59,59,59,60,60,60,60,60
E01021664,EV motorcycles,Number,1,3,6,10,16,21,27,34,40,47,53,59,65,70,75,79,83,85,88,90,91,92,93,94,94,94,95,95,95,95
E01021665,EV motorcycles,Number,1,1,3,4,7,9,12,14,17,20,22,25,27,30,32,33,35,36,37,38,38,39,39,39,40,40,40,40,40,40
E01021666,EV motorcycles,Number,0,1,2,3,5,6,8,10,12,14,16,17,19,21,22,23,24,25,26,26,27,27,27,28,28,28,28,28,28,28
E01021667,EV motorcycles,Number,1,2,3,6,9,11,15,18,22,25,29,32,35,38,40,42,44,46,47,48,49,49,50,50,50,51,51,51,51,51
E01021668,EV motorcycles,Number,1,1,2,4,6,8,11,13,16,18,21,23,25,27,29,31,32,33,34,35,35,36,36,36,37,37,37,37,37,37
E01021669,EV motorcycles,Number,0,1,1,2,3,4,6,7,8,10,11,12,14,15,16,17,17,18,18,19,19,19,20,20,20,20,20,20,20,20
E01021670,EV motorcycles,Number,1,1,3,4,7,9,11,14,16,19,22,24,27,29,31,32,34,35,36,37,37,38,38,38,39,39,39,39,39,39
E01021671,EV motorcycles,Number,1,2,3,5,8,10,13,16,19,22,25,28,31,33,35,37,39,40,42,42,43,44,44,44,45,45,45,45,45,45
E01021673,EV motorcycles,Number,1,1,3,4,7,9,11,14,16,19,22,24,27,29,31,32,34,35,36,37,37,38,38,38,39,39,39,39,39,39
E01021674,EV motorcycles,Number,0,1,2,4,6,8,10,12,14,17,19,21,23,25,27,28,30,31,31,32,33,33,33,33,34,34,34,34,34,34
E01021675,EV motorcycles,Number,0,1,2,3,5,7,9,11,13,15,17,19,21,23,24,26,27,28,29,29,30,30,30,31,31,31,31,31,31,31
E01021676,EV motorcycles,Number,0,1,2,3,5,6,8,10,12,14,16,17,19,21,22,23,24,25,26,26,27,27,27,28,28,28,28,28,28,28
E01021677,EV motorcycles,Number,0,1,2,3,5,7,9,11,13,15,17,19,21,23,24,26,27,28,29,29,30,30,30,31,31,31,31,31,31,31
E01021678,EV motorcycles,Number,1,2,3,5,8,11,14,17,20,23,26,29,32,35,37,39,41,42,43,44,45,46,46,46,47,47,47,47,47,47
E01021679,EV motorcycles,Number,1,1,3,5,7,9,12,15,17,20,23,26,28,30,32,34,36,37,38,39,39,40,40,40,41,41,41,41,41,41
E01021680,EV motorcycles,Number,1,3,6,10,16,21,27,34,40,47,53,59,65,70,75,79,83,85,88,90,91,92,93,94,94,94,95,95,95,95
E01021681,EV motorcycles,Number,1,2,4,7,10,13,17,21,25,30,34,37,41,44,47,50,52,54,55,57,58,58,59,59,59,60,60,60,60,60
E01021682,EV motorcycles,Number,1,2,5,8,12,15,20,25,29,34,39,43,47,51,54,57,60,62,64,65,66,67,68,68,68,69,69,69,69,69
E01021683,EV motorcycles,Number,0,1,1,2,4,5,6,7,9,10,12,13,14,16,17,17,18,19,19,20,20,20,21,21,21,21,21,21,21,21
E01021684,EV motorcycles,Number,0,1,2,3,5,7,8,10,12,14,16,18,20,21,23,24,25,26,27,27,28,28,28,29,29,29,29,29,29,29
E01021685,EV motorcycles,Number,1,3,5,9,13,18,23,28,33,38,44,49,53,58,61,65,68,70,72,74,75,76,76,77,77,77,78,78,78,78
E01021686,EV motorcycles,Number,0,1,2,3,5,6,8,10,11,13,15,17,18,20,21,22,23,24,25,25,26,26,26,27,27,27,27,27,27,27
E01021687,EV motorcycles,Number,0,1,2,3,5,7,9,11,13,15,17,19,21,22,24,25,26,27,28,28,29,29,29,30,30,30,30,30,30,30
E01021688,EV motorcycles,Number,0,1,2,3,4,5,7,9,10,12,13,15,16,18,19,20,21,22,22,23,23,23,23,24,24,24,24,24,24,24
E01021689,EV motorcycles,Number,1,1,2,4,6,8,11,13,16,18,21,23,25,27,29,31,32,33,34,35,35,36,36,36,37,37,37,37,37,37
E01021690,EV motorcycles,Number,0,1,2,4,5,7,9,11,14,16,18,20,22,24,25,27,28,29,30,30,31,31,31,32,32,32,32,32,32,32
E01021691,EV motorcycles,Number,1,1,3,5,7,9,12,15,17,20,23,26,28,30,32,34,36,37,38,39,39,40,40,40,41,41,41,41,41,41
E01021692,EV motorcycles,Number,0,1,2,4,5,7,9,11,14,16,18,20,22,24,25,27,28,29,30,30,31,31,31,32,32,32,32,32,32,32
E01021693,EV motorcycles,Number,1,1,2,4,6,9,11,13,16,19,21,24,26,28,30,32,33,34,35,36,36,37,37,37,38,38,38,38,38,38
E01021694,EV motorcycles,Number,1,3,5,8,13,17,22,27,32,37,42,47,51,55,59,62,65,67,69,71,72,73,73,74,74,74,75,75,75,75
E01021695,EV motorcycles,Number,1,2,4,7,10,13,17,21,25,30,34,37,41,44,47,50,52,54,55,57,58,58,59,59,59,60,60,60,60,60
E01021696,EV motorcycles,Number,0,1,1,2,3,4,6,7,8,10,11,12,14,15,16,17,17,18,18,19,19,19,20,20,20,20,20,20,20,20
E01021697,EV motorcycles,Number,1,1,3,5,7,9,12,15,17,20,23,26,28,30,32,34,36,37,38,39,39,40,40,40,41,41,41,41,41,41
E01021698,EV motorcycles,Number,0,1,1,2,3,4,6,7,8,10,11,12,14,15,16,17,17,18,18,19,19,19,20,20,20,20,20,20,20,20
E01021699,EV motorcycles,Number,0,1,1,2,3,4,5,6,7,8,9,10,11,12,13,13,14,14,15,15,15,16,16,16,16,16,16,16,16,16
E01021700,EV motorcycles,Number,0,1,2,3,4,6,7,9,11,12,14,16,17,18,20,21,22,22,23,24,24,24,24,25,25,25,25,25,25,25
E01021702,EV motorcycles,Number,0,1,2,3,5,7,8,10,12,14,16,18,20,21,23,24,25,26,27,27,28,28,28,29,29,29,29,29,29,29
E01021703,EV motorcycles,Number,0,1,2,4,6,7,10,12,14,16,18,21,23,24,26,27,29,30,31,31,32,32,32,33,33,33,33,33,33,33
E01021704,EV motorcycles,Number,0,1,2,3,5,7,8,10,12,14,16,18,20,21,23,24,25,26,27,27,28,28,28,29,29,29,29,29,29,29
E01021705,EV motorcycles,Number,1,2,3,6,9,11,15,18,22,25,29,32,35,38,40,42,44,46,47,48,49,49,50,50,50,51,51,51,51,51
E01021706,EV motorcycles,Number,1,2,3,5,7,10,13,16,19,22,25,27,30,33,35,37,38,40,41,42,42,43,43,43,44,44,44,44,44,44
E01021707,EV motorcycles,Number,1,2,5,8,12,15,20,25,29,34,39,43,47,51,54,57,60,62,64,65,66,67,68,68,68,69,69,69,69,69
E01021708,EV motorcycles,Number,1,1,2,4,6,8,10,13,15,18,20,22,25,27,28,30,31,32,33,34,35,35,35,35,36,36,36,36,36,36
E01021709,EV motorcycles,Number,1,1,3,5,7,9,12,15,17,20,23,26,28,30,32,34,36,37,38,39,39,40,40,40,41,41,41,41,41,41
E01021710,EV motorcycles,Number,1,2,4,6,10,13,16,20,24,28,32,35,39,42,45,47,50,51,53,54,55,55,56,56,56,57,57,57,57,57
E01021711,EV motorcycles,Number,1,1,2,4,6,9,11,13,16,19,21,24,26,28,30,32,33,34,35,36,36,37,37,37,38,38,38,38,38,38
E01021713,EV motorcycles,Number,0,1,2,4,6,7,10,12,14,16,18,21,23,24,26,27,29,30,31,31,32,32,32,33,33,33,33,33,33,33
E01021714,EV motorcycles,Number,1,2,3,5,8,11,14,17,21,24,27,31,33,36,39,41,43,44,45,46,47,48,48,48,48,49,49,49,49,49
E01021715,EV motorcycles,Number,1,2,3,5,8,10,13,16,19,22,25,28,31,33,35,37,39,40,42,42,43,44,44,44,45,45,45,45,45,45
E01021717,EV motorcycles,Number,1,3,5,8,13,17,22,27,33,38,43,48,53,57,61,64,67,69,71,73,74,75,75,76,76,76,77,77,77,77
E01021718,EV motorcycles,Number,1,1,2,4,6,9,11,13,16,19,21,24,26,28,30,32,33,34,35,36,36,37,37,37,38,38,38,38,38,38
E01021719,EV motorcycles,Number,1,2,4,7,10,14,18,22,26,30,34,38,42,45,48,51,53,55,56,58,58,59,60,60,60,61,61,61,61,61
E01021720,EV motorcycles,Number,0,1,2,3,4,6,7,9,11,12,14,16,17,18,20,21,22,22,23,24,24,24,24,25,25,25,25,25,25,25
E01021721,EV motorcycles,Number,1,2,4,7,11,14,18,22,27,31,35,39,43,47,50,52,55,57,58,59,60,61,62,62,62,63,63,63,63,63
E01021722,EV motorcycles,Number,1,2,4,7,11,15,20,24,29,33,38,42,46,50,54,57,59,61,63,64,65,66,67,67,67,68,68,68,68,68
E01021723,EV motorcycles,Number,1,2,4,7,11,15,19,24,28,33,37,42,46,50,53,56,58,60,62,63,64,65,66,66,66,67,67,67,67,67
E01021724,EV motorcycles,Number,1,2,3,6,8,11,14,18,21,25,28,31,34,37,39,42,43,45,46,47,48,49,49,49,49,50,50,50,50,50
E01021725,EV motorcycles,Number,1,2,3,5,8,11,14,17,20,23,26,29,32,35,37,39,41,42,43,44,45,46,46,46,47,47,47,47,47,47
E01021726,EV motorcycles,Number,1,1,2,4,6,8,11,13,16,18,21,23,25,27,29,31,32,33,34,35,35,36,36,36,37,37,37,37,37,37
E01021727,EV motorcycles,Number,1,1,3,5,7,9,12,15,17,20,23,26,28,30,32,34,36,37,38,39,39,40,40,40,41,41,41,41,41,41
E01021728,EV motorcycles,Number,1,2,3,6,8,11,14,18,21,25,28,31,34,37,39,42,43,45,46,47,48,49,49,49,49,50,50,50,50,50
E01021729,EV motorcycles,Number,1,2,3,5,8,11,14,17,20,24,27,30,33,35,38,40,42,43,44,45,46,47,47,47,48,48,48,48,48,48
E01021730,EV motorcycles,Number,1,2,4,7,10,14,18,22,26,30,34,38,42,45,48,51,53,55,56,58,58,59,60,60,60,61,61,61,61,61
E01021731,EV motorcycles,Number,1,2,4,7,10,14,18,22,26,30,34,38,42,45,48,51,53,55,56,58,58,59,60,60,60,61,61,61,61,61
E01021732,EV motorcycles,Number,1,2,3,5,8,10,13,16,19,23,26,29,31,34,36,38,40,41,43,43,44,45,45,45,46,46,46,46,46,46
E01021733,EV motorcycles,Number,1,1,2,4,6,9,11,13,16,19,21,24,26,28,30,32,33,34,35,36,36,37,37,37,38,38,38,38,38,38
E01021734,EV motorcycles,Number,1,2,3,5,8,10,13,16,19,23,26,29,31,34,36,38,40,41,43,43,44,45,45,45,46,46,46,46,46,46
E01021735,EV motorcycles,Number,1,2,3,6,9,12,15,18,22,26,29,32,36,38,41,43,45,47,48,49,50,50,51,51,51,52,52,52,52,52
E01021736,EV motorcycles,Number,0,1,2,3,4,6,7,9,11,12,14,16,17,18,20,21,22,22,23,24,24,24,24,25,25,25,25,25,25,25
E01021737,EV motorcycles,Number,1,2,3,6,9,11,15,18,22,25,29,32,35,38,40,42,44,46,47,48,49,49,50,50,50,51,51,51,51,51
E01021738,EV motorcycles,Number,1,1,2,4,6,8,11,13,16,18,21,23,25,27,29,31,32,33,34,35,35,36,36,36,37,37,37,37,37,37
E01021739,EV motorcycles,Number,0,1,2,4,6,8,10,12,14,17,19,21,23,25,27,28,30,31,31,32,33,33,33,33,34,34,34,34,34,34
E01021740,EV motorcycles,Number,0,1,2,4,6,8,10,12,14,17,19,21,23,25,27,28,30,31,31,32,33,33,33,33,34,34,34,34,34,34
E01021741,EV motorcycles,Number,1,3,5,9,13,18,23,28,33,39,44,49,54,58,62,66,69,71,73,75,76,77,77,78,78,78,79,79,79,79
E01021742,EV motorcycles,Number,0,0,1,1,2,2,3,3,4,4,5,6,6,7,7,7,8,8,8,8,9,9,9,9,9,9,9,9,9,9
E01021743,EV motorcycles,Number,0,0,1,1,2,2,3,4,4,5,6,6,7,7,8,8,9,9,9,9,10,10,10,10,10,10,10,10,10,10
E01021744,EV motorcycles,Number,0,1,1,2,3,4,6,7,8,10,11,12,14,15,16,17,17,18,18,19,19,19,20,20,20,20,20,20,20,20
E01021745,EV motorcycles,Number,0,1,1,2,2,3,4,5,6,7,8,9,10,10,11,12,12,13,13,13,13,14,14,14,14,14,14,14,14,14
E01021746,EV motorcycles,Number,0,1,1,2,4,5,6,8,9,11,12,14,15,16,17,18,19,20,20,21,21,21,22,22,22,22,22,22,22,22
E01021747,EV motorcycles,Number,0,1,1,2,2,3,4,5,6,7,8,9,10,10,11,12,12,13,13,13,13,14,14,14,14,14,14,14,14,14
E01021748,EV motorcycles,Number,0,1,1,2,3,4,5,6,8,9,10,11,12,13,14,15,16,16,17,17,17,17,18,18,18,18,18,18,18,18
E01021749,EV motorcycles,Number,1,1,3,4,7,9,12,14,17,20,22,25,27,30,32,33,35,36,37,38,38,39,39,39,40,40,40,40,40,40
E01021750,EV motorcycles,Number,0,1,1,2,3,4,5,7,8,9,11,12,13,14,15,16,17,17,18,18,18,18,19,19,19,19,19,19,19,19
E01021751,EV motorcycles,Number,0,0,1,1,2,2,3,3,4,4,5,6,6,7,7,7,8,8,8,8,9,9,9,9,9,9,9,9,9,9
E01021752,EV motorcycles,Number,0,1,1,2,3,3,4,5,6,7,8,9,10,11,12,12,13,13,14,14,14,15,15,15,15,15,15,15,15,15
E01021753,EV motorcycles,Number,0,1,2,3,4,6,8,9,11,13,15,16,18,19,20,22,23,23,24,25,25,25,25,26,26,26,26,26,26,26
E01021754,EV motorcycles,Number,0,1,2,3,4,5,7,8,10,11,13,14,16,17,18,19,20,21,21,22,22,22,23,23,23,23,23,23,23,23
E01021755,EV motorcycles,Number,0,1,2,3,4,5,7,8,10,11,13,14,16,17,18,19,20,21,21,22,22,22,23,23,23,23,23,23,23,23
E01021756,EV motorcycles,Number,1,2,3,6,9,12,15,18,22,26,29,32,36,38,41,43,45,47,48,49,50,50,51,51,51,52,52,52,52,52
E01021757,EV motorcycles,Number,0,1,2,4,5,7,9,11,14,16,18,20,22,24,25,27,28,29,30,30,31,31,31,32,32,32,32,32,32,32
E01021758,EV motorcycles,Number,0,1,2,3,4,5,7,9,10,12,13,15,16,18,19,20,21,22,22,23,23,23,23,24,24,24,24,24,24,24
E01021759,EV motorcycles,Number,0,1,2,3,5,7,9,11,13,15,17,19,21,23,24,26,27,28,29,29,30,30,30,31,31,31,31,31,31,31
E01021760,EV motorcycles,Number,0,1,2,3,4,6,7,9,11,12,14,16,17,18,20,21,22,22,23,24,24,24,24,25,25,25,25,25,25,25
E01021761,EV motorcycles,Number,1,2,4,6,10,13,16,20,24,28,32,35,39,42,45,47,50,51,53,54,55,55,56,56,56,57,57,57,57,57
E01021762,EV motorcycles,Number,0,1,1,2,3,4,6,7,8,10,11,12,14,15,16,17,17,18,18,19,19,19,20,20,20,20,20,20,20,20
E01021763,EV motorcycles,Number,1,2,3,5,8,10,13,16,19,23,26,29,31,34,36,38,40,41,43,43,44,45,45,45,46,46,46,46,46,46
E01021764,EV motorcycles,Number,0,1,2,3,5,7,9,11,13,15,17,19,21,23,24,26,27,28,29,29,30,30,30,31,31,31,31,31,31,31
E01021765,EV motorcycles,Number,0,1,1,2,3,4,5,6,7,8,9,10,11,12,13,13,14,14,15,15,15,16,16,16,16,16,16,16,16,16
E01021766,EV motorcycles,Number,0,0,0,1,1,2,2,2,3,3,4,4,5,5,6,6,6,6,6,7,7,7,7,7,7,7,7,7,7,7
E01021767,EV motorcycles,Number,0,0,1,1,2,3,4,5,5,6,7,8,9,10,10,11,11,12,12,12,12,13,13,13,13,13,13,13,13,13
E01021768,EV motorcycles,Number,1,3,5,8,13,17,22,27,32,37,42,47,51,55,59,62,65,67,69,71,72,73,73,74,74,74,75,75,75,75
E01021769,EV motorcycles,Number,1,4,7,11,17,23,29,36,43,50,57,63,69,75,80,84,88,91,93,95,97,98,99,100,100,100,101,101,101,101
E01021770,EV motorcycles,Number,1,2,3,5,8,11,14,17,21,24,27,31,33,36,39,41,43,44,45,46,47,48,48,48,48,49,49,49,49,49
E01021771,EV motorcycles,Number,0,1,2,3,5,7,8,10,12,14,16,18,20,21,23,24,25,26,27,27,28,28,28,29,29,29,29,29,29,29
E01021772,EV motorcycles,Number,0,1,2,3,4,6,7,9,11,12,14,16,17,18,20,21,22,22,23,24,24,24,24,25,25,25,25,25,25,25
E01021773,EV motorcycles,Number,0,1,2,3,5,6,8,10,12,14,16,17,19,21,22,23,24,25,26,26,27,27,27,28,28,28,28,28,28,28
E01021774,EV motorcycles,Number,0,1,2,3,5,6,8,10,12,14,16,17,19,21,22,23,24,25,26,26,27,27,27,28,28,28,28,28,28,28
E01021775,EV motorcycles,Number,0,1,1,2,3,4,5,6,8,9,10,11,12,13,14,15,16,16,17,17,17,17,18,18,18,18,18,18,18,18
E01021776,EV motorcycles,Number,0,1,1,2,4,5,6,7,9,10,12,13,14,16,17,17,18,19,19,20,20,20,21,21,21,21,21,21,21,21
E01021777,EV motorcycles,Number,0,0,1,1,2,2,3,4,5,5,6,7,8,8,9,9,10,10,10,10,11,11,11,11,11,11,11,11,11,11
E01021778,EV motorcycles,Number,0,1,2,3,5,6,8,10,12,14,16,17,19,21,22,23,24,25,26,26,27,27,27,28,28,28,28,28,28,28
E01021779,EV motorcycles,Number,0,1,2,3,5,6,8,10,11,13,15,17,18,20,21,22,23,24,25,25,26,26,26,27,27,27,27,27,27,27
E01021780,EV motorcycles,Number,0,1,1,2,4,5,6,8,9,11,12,14,15,16,17,18,19,20,20,21,21,21,22,22,22,22,22,22,22,22
E01021781,EV motorcycles,Number,0,1,1,2,3,4,5,6,8,9,10,11,12,13,14,15,16,16,17,17,17,17,18,18,18,18,18,18,18,18
E01021782,EV motorcycles,Number,0,1,2,3,4,5,7,8,10,11,13,14,16,17,18,19,20,21,21,22,22,22,23,23,23,23,23,23,23,23
E01021783,EV motorcycles,Number,0,1,1,2,3,4,6,7,8,10,11,12,14,15,16,17,17,18,18,19,19,19,20,20,20,20,20,20,20,20
E01021784,EV motorcycles,Number,1,1,3,5,7,9,12,15,17,20,23,26,28,30,32,34,36,37,38,39,39,40,40,40,41,41,41,41,41,41
E01021785,EV motorcycles,Number,0,1,2,3,5,7,9,11,13,15,17,19,21,22,24,25,26,27,28,28,29,29,29,30,30,30,30,30,30,30
E01021786,EV motorcycles,Number,0,1,1,2,3,4,5,6,7,8,10,11,12,13,13,14,15,15,16,16,16,16,17,17,17,17,17,17,17,17
E01021787,EV motorcycles,Number,1,1,3,4,7,9,12,14,17,20,22,25,27,30,32,33,35,36,37,38,38,39,39,39,40,40,40,40,40,40
E01021788,EV motorcycles,Number,0,1,2,3,5,7,9,11,13,15,17,19,21,22,24,25,26,27,28,28,29,29,29,30,30,30,30,30,30,30
E01021789,EV motorcycles,Number,0,1,2,3,4,5,7,9,10,12,13,15,16,18,19,20,21,22,22,23,23,23,23,24,24,24,24,24,24,24
E01021790,EV motorcycles,Number,0,1,2,3,4,5,7,9,10,12,13,15,16,18,19,20,21,22,22,23,23,23,23,24,24,24,24,24,24,24
E01021791,EV motorcycles,Number,0,1,2,3,5,6,8,10,11,13,15,17,18,20,21,22,23,24,25,25,26,26,26,27,27,27,27,27,27,27
E01021792,EV motorcycles,Number,0,1,2,4,5,7,9,11,14,16,18,20,22,24,25,27,28,29,30,30,31,31,31,32,32,32,32,32,32,32
E01021793,EV motorcycles,Number,0,1,2,4,5,7,9,11,14,16,18,20,22,24,25,27,28,29,30,30,31,31,31,32,32,32,32,32,32,32
E01021794,EV motorcycles,Number,0,1,2,3,4,6,7,9,11,12,14,16,17,18,20,21,22,22,23,24,24,24,24,25,25,25,25,25,25,25
E01021795,EV motorcycles,Number,1,2,3,6,8,11,14,18,21,25,28,31,34,37,39,42,43,45,46,47,48,49,49,49,49,50,50,50,50,50
E01021796,EV motorcycles,Number,1,2,3,5,8,10,13,16,19,22,25,28,31,33,35,37,39,40,42,42,43,44,44,44,45,45,45,45,45,45
E01021797,EV motorcycles,Number,1,2,3,5,8,10,13,16,19,23,26,29,31,34,36,38,40,41,43,43,44,45,45,45,46,46,46,46,46,46
E01021798,EV motorcycles,Number,1,2,3,5,8,11,14,17,20,24,27,30,33,35,38,40,42,43,44,45,46,47,47,47,48,48,48,48,48,48
E01021799,EV motorcycles,Number,1,2,4,6,9,12,16,19,23,27,30,34,37,40,43,45,47,49,50,51,52,52,53,53,53,54,54,54,54,54
E01021800,EV motorcycles,Number,1,3,5,8,12,16,21,25,30,35,40,44,49,52,56,59,62,64,66,67,68,69,70,70,70,71,71,71,71,71
E01021801,EV motorcycles,Number,1,2,3,6,9,12,15,18,22,26,29,32,36,38,41,43,45,47,48,49,50,50,51,51,51,52,52,52,52,52
E01021802,EV motorcycles,Number,0,1,2,3,5,7,9,11,13,15,17,19,21,23,24,26,27,28,29,29,30,30,30,31,31,31,31,31,31,31
E01021803,EV motorcycles,Number,0,1,2,3,5,6,8,10,12,14,16,17,19,21,22,23,24,25,26,26,27,27,27,28,28,28,28,28,28,28
E01021804,EV motorcycles,Number,0,1,2,3,4,6,7,9,11,12,14,16,17,18,20,21,22,22,23,24,24,24,24,25,25,25,25,25,25,25
E01021805,EV motorcycles,Number,0,1,2,3,5,7,9,11,13,15,17,19,21,23,24,26,27,28,29,29,30,30,30,31,31,31,31,31,31,31
E01021806,EV motorcycles,Number,1,3,6,10,15,20,26,32,38,44,50,56,62,67,71,75,78,81,83,85,86,87,88,89,89,89,90,90,90,90
E01021807,EV motorcycles,Number,0,1,2,3,4,6,7,9,11,12,14,16,17,18,20,21,22,22,23,24,24,24,24,25,25,25,25,25,25,25
E01021808,EV motorcycles,Number,0,1,2,3,4,5,7,8,10,11,13,14,16,17,18,19,20,21,21,22,22,22,23,23,23,23,23,23,23,23
E01021809,EV motorcycles,Number,0,1,2,3,5,7,9,11,13,15,17,19,21,22,24,25,26,27,28,28,29,29,29,30,30,30,30,30,30,30
E01021810,EV motorcycles,Number,0,1,2,3,5,6,8,10,11,13,15,17,18,20,21,22,23,24,25,25,26,26,26,27,27,27,27,27,27,27
E01021811,EV motorcycles,Number,0,1,2,3,4,5,7,8,10,11,13,14,16,17,18,19,20,21,21,22,22,22,23,23,23,23,23,23,23,23
E01021812,EV motorcycles,Number,1,2,3,5,8,11,14,17,20,24,27,30,33,35,38,40,42,43,44,45,46,47,47,47,48,48,48,48,48,48
E01021813,EV motorcycles,Number,0,1,2,3,4,6,8,9,11,13,15,16,18,19,20,22,23,23,24,25,25,25,25,26,26,26,26,26,26,26
E01021814,EV motorcycles,Number,0,1,2,3,5,6,8,10,11,13,15,17,18,20,21,22,23,24,25,25,26,26,26,27,27,27,27,27,27,27
E01021815,EV motorcycles,Number,0,1,2,3,5,6,8,10,11,13,15,17,18,20,21,22,23,24,25,25,26,26,26,27,27,27,27,27,27,27
E01021816,EV motorcycles,Number,0,1,2,3,5,7,8,10,12,14,16,18,20,21,23,24,25,26,27,27,28,28,28,29,29,29,29,29,29,29
E01021817,EV motorcycles,Number,1,2,4,6,10,13,17,21,25,29,32,36,40,43,46,48,50,52,54,55,56,56,57,57,57,58,58,58,58,58
E01021818,EV motorcycles,Number,0,1,2,3,5,6,8,10,12,14,16,17,19,21,22,23,24,25,26,26,27,27,27,28,28,28,28,28,28,28
E01021819,EV motorcycles,Number,1,1,2,4,6,8,10,13,15,18,20,22,25,27,28,30,31,32,33,34,35,35,35,35,36,36,36,36,36,36
E01021820,EV motorcycles,Number,0,1,2,3,4,5,7,8,10,11,13,14,16,17,18,19,20,21,21,22,22,22,23,23,23,23,23,23,23,23
E01021821,EV motorcycles,Number,0,1,1,2,3,4,5,6,7,8,9,10,11,12,13,13,14,14,15,15,15,16,16,16,16,16,16,16,16,16
E01021822,EV motorcycles,Number,0,1,2,3,5,6,8,10,11,13,15,17,18,20,21,22,23,24,25,25,26,26,26,27,27,27,27,27,27,27
E01021823,EV motorcycles,Number,1,1,2,4,6,8,11,13,16,18,21,23,25,27,29,31,32,33,34,35,35,36,36,36,37,37,37,37,37,37
E01021824,EV motorcycles,Number,0,1,2,3,4,6,8,9,11,13,15,16,18,19,20,22,23,23,24,25,25,25,25,26,26,26,26,26,26,26
E01021825,EV motorcycles,Number,0,1,2,3,5,7,8,10,12,14,16,18,20,21,23,24,25,26,27,27,28,28,28,29,29,29,29,29,29,29
E01021826,EV motorcycles,Number,0,1,2,3,5,7,9,11,13,15,17,19,21,22,24,25,26,27,28,28,29,29,29,30,30,30,30,30,30,30
E01021827,EV motorcycles,Number,0,1,1,2,3,4,5,7,8,9,11,12,13,14,15,16,17,17,18,18,18,18,19,19,19,19,19,19,19,19
E01021828,EV motorcycles,Number,1,2,3,5,8,11,14,17,21,24,27,31,33,36,39,41,43,44,45,46,47,48,48,48,48,49,49,49,49,49
E01021829,EV motorcycles,Number,0,1,2,3,5,7,8,10,12,14,16,18,20,21,23,24,25,26,27,27,28,28,28,29,29,29,29,29,29,29
E01021830,EV motorcycles,Number,0,1,2,3,4,6,7,9,11,12,14,16,17,18,20,21,22,22,23,24,24,24,24,25,25,25,25,25,25,25
E01021831,EV motorcycles,Number,0,1,1,2,4,5,6,8,9,11,12,14,15,16,17,18,19,20,20,21,21,21,22,22,22,22,22,22,22,22
E01021832,EV motorcycles,Number,0,1,2,3,4,5,7,8,10,11,13,14,16,17,18,19,20,21,21,22,22,22,23,23,23,23,23,23,23,23
E01021833,EV motorcycles,Number,0,1,2,4,6,7,10,12,14,16,18,21,23,24,26,27,29,30,31,31,32,32,32,33,33,33,33,33,33,33
E01021834,EV motorcycles,Number,0,1,2,3,5,7,8,10,12,14,16,18,20,21,23,24,25,26,27,27,28,28,28,29,29,29,29,29,29,29
E01021835,EV motorcycles,Number,1,1,2,4,6,8,10,12,15,17,20,22,24,26,28,29,30,31,32,33,34,34,34,34,35,35,35,35,35,35
E01021836,EV motorcycles,Number,0,1,1,2,4,5,6,7,9,10,12,13,14,16,17,17,18,19,19,20,20,20,21,21,21,21,21,21,21,21
E01021837,EV motorcycles,Number,1,1,2,4,6,8,10,12,15,17,20,22,24,26,28,29,30,31,32,33,34,34,34,34,35,35,35,35,35,35
E01021838,EV motorcycles,Number,0,1,2,3,5,7,9,11,13,15,17,19,21,23,24,26,27,28,29,29,30,30,30,31,31,31,31,31,31,31
E01021839,EV motorcycles,Number,0,1,2,3,5,6,8,10,12,14,16,17,19,21,22,23,24,25,26,26,27,27,27,28,28,28,28,28,28,28
E01021840,EV motorcycles,Number,0,1,2,3,4,5,7,8,10,11,13,14,16,17,18,19,20,21,21,22,22,22,23,23,23,23,23,23,23,23
E01021841,EV motorcycles,Number,0,1,2,4,6,8,10,12,14,17,19,21,23,25,27,28,30,31,31,32,33,33,33,33,34,34,34,34,34,34
E01021842,EV motorcycles,Number,0,1,2,3,4,5,7,9,10,12,13,15,16,18,19,20,21,22,22,23,23,23,23,24,24,24,24,24,24,24
E01021843,EV motorcycles,Number,0,1,2,4,6,8,10,12,14,17,19,21,23,25,27,28,30,31,31,32,33,33,33,33,34,34,34,34,34,34
E01021844,EV motorcycles,Number,0,1,2,3,5,7,8,10,12,14,16,18,20,21,23,24,25,26,27,27,28,28,28,29,29,29,29,29,29,29
E01021845,EV motorcycles,Number,0,1,1,2,4,5,6,8,9,11,12,14,15,16,17,18,19,20,20,21,21,21,22,22,22,22,22,22,22,22
E01021846,EV motorcycles,Number,0,1,1,2,3,4,6,7,8,10,11,12,14,15,16,17,17,18,18,19,19,19,20,20,20,20,20,20,20,20
E01021847,EV motorcycles,Number,1,1,2,4,6,8,10,13,15,18,20,22,25,27,28,30,31,32,33,34,35,35,35,35,36,36,36,36,36,36
E01021848,EV motorcycles,Number,1,1,3,5,7,9,12,15,17,20,23,26,28,30,32,34,36,37,38,39,39,40,40,40,41,41,41,41,41,41
E01021849,EV motorcycles,Number,0,1,2,3,5,7,9,11,13,15,17,19,21,22,24,25,26,27,28,28,29,29,29,30,30,30,30,30,30,30
E01021850,EV motorcycles,Number,0,1,1,2,4,5,6,8,9,11,12,14,15,16,17,18,19,20,20,21,21,21,22,22,22,22,22,22,22,22
E01021851,EV motorcycles,Number,0,1,2,4,5,7,9,11,14,16,18,20,22,24,25,27,28,29,30,30,31,31,31,32,32,32,32,32,32,32
E01021852,EV motorcycles,Number,0,1,2,3,4,5,7,9,10,12,13,15,16,18,19,20,21,22,22,23,23,23,23,24,24,24,24,24,24,24
E01021853,EV motorcycles,Number,0,1,1,2,4,5,6,8,9,11,12,14,15,16,17,18,19,20,20,21,21,21,22,22,22,22,22,22,22,22
E01021854,EV motorcycles,Number,1,1,3,4,7,9,12,14,17,20,22,25,27,30,32,33,35,36,37,38,38,39,39,39,40,40,40,40,40,40
E01021855,EV motorcycles,Number,0,1,2,3,4,5,7,9,10,12,13,15,16,18,19,20,21,22,22,23,23,23,23,24,24,24,24,24,24,24
E01021856,EV motorcycles,Number,0,1,1,2,4,5,6,8,9,11,12,14,15,16,17,18,19,20,20,21,21,21,22,22,22,22,22,22,22,22
E01021857,EV motorcycles,Number,1,3,5,8,12,16,21,26,30,35,40,45,49,53,57,60,63,65,67,68,69,70,70,71,71,71,72,72,72,72
E01021858,EV motorcycles,Number,0,1,2,3,5,6,8,10,11,13,15,17,18,20,21,22,23,24,25,25,26,26,26,27,27,27,27,27,27,27
E01021859,EV motorcycles,Number,1,1,2,4,6,8,10,12,15,17,20,22,24,26,28,29,30,31,32,33,34,34,34,34,35,35,35,35,35,35
E01021860,EV motorcycles,Number,0,1,2,3,4,5,7,9,10,12,13,15,16,18,19,20,21,22,22,23,23,23,23,24,24,24,24,24,24,24
E01021861,EV motorcycles,Number,0,1,2,3,5,6,8,10,11,13,15,17,18,20,21,22,23,24,25,25,26,26,26,27,27,27,27,27,27,27
E01021862,EV motorcycles,Number,0,1,2,3,5,6,8,10,12,14,16,17,19,21,22,23,24,25,26,26,27,27,27,28,28,28,28,28,28,28
E01021863,EV motorcycles,Number,0,1,2,3,5,6,8,10,11,13,15,17,18,20,21,22,23,24,25,25,26,26,26,27,27,27,27,27,27,27
E01021864,EV motorcycles,Number,1,1,3,4,7,9,12,14,17,20,22,25,27,30,32,33,35,36,37,38,38,39,39,39,40,40,40,40,40,40
E01021865,EV motorcycles,Number,0,1,2,3,5,6,8,10,12,14,16,17,19,21,22,23,24,25,26,26,27,27,27,28,28,28,28,28,28,28
E01021866,EV motorcycles,Number,0,1,2,3,5,7,9,11,13,15,17,19,21,22,24,25,26,27,28,28,29,29,29,30,30,30,30,30,30,30
E01021867,EV motorcycles,Number,1,1,3,5,7,9,12,15,17,20,23,26,28,30,32,34,36,37,38,39,39,40,40,40,41,41,41,41,41,41
E01021868,EV motorcycles,Number,0,1,2,3,4,6,8,9,11,13,15,16,18,19,20,22,23,23,24,25,25,25,25,26,26,26,26,26,26,26
E01021869,EV motorcycles,Number,0,1,1,2,2,3,4,5,6,7,8,9,10,10,11,12,12,13,13,13,13,14,14,14,14,14,14,14,14,14
E01021870,EV motorcycles,Number,0,1,2,3,4,5,7,8,10,11,13,14,16,17,18,19,20,21,21,22,22,22,23,23,23,23,23,23,23,23
E01021871,EV motorcycles,Number,0,1,2,3,5,7,8,10,12,14,16,18,20,21,23,24,25,26,27,27,28,28,28,29,29,29,29,29,29,29
E01021872,EV motorcycles,Number,0,1,2,3,5,6,8,10,11,13,15,17,18,20,21,22,23,24,25,25,26,26,26,27,27,27,27,27,27,27
E01021873,EV motorcycles,Number,1,1,2,4,6,8,10,13,15,18,20,22,25,27,28,30,31,32,33,34,35,35,35,35,36,36,36,36,36,36
E01021874,EV motorcycles,Number,1,2,4,7,10,13,17,21,25,30,34,37,41,44,47,50,52,54,55,57,58,58,59,59,59,60,60,60,60,60
E01021875,EV motorcycles,Number,1,3,5,8,12,16,21,26,31,36,41,45,50,54,58,61,63,66,67,69,70,71,71,72,72,72,73,73,73,73
E01021878,EV motorcycles,Number,1,1,2,4,6,8,10,12,15,17,20,22,24,26,28,29,30,31,32,33,34,34,34,34,35,35,35,35,35,35
E01021879,EV motorcycles,Number,0,1,2,4,6,8,10,12,14,17,19,21,23,25,27,28,30,31,31,32,33,33,33,33,34,34,34,34,34,34
E01021880,EV motorcycles,Number,1,2,4,7,10,14,18,22,26,30,35,39,42,46,49,52,54,56,57,59,59,60,61,61,61,62,62,62,62,62
E01021881,EV motorcycles,Number,0,1,2,3,5,7,8,10,12,14,16,18,20,21,23,24,25,26,27,27,28,28,28,29,29,29,29,29,29,29
E01021882,EV motorcycles,Number,1,3,5,9,14,19,24,29,35,41,46,52,57,61,65,69,72,75,77,78,80,81,81,82,82,82,83,83,83,83
E01021883,EV motorcycles,Number,1,2,3,6,8,11,14,18,21,25,28,31,34,37,39,42,43,45,46,47,48,49,49,49,49,50,50,50,50,50
E01021884,EV motorcycles,Number,1,1,3,5,7,9,12,15,17,20,23,26,28,30,32,34,36,37,38,39,39,40,40,40,41,41,41,41,41,41
E01021885,EV motorcycles,Number,1,1,3,4,7,9,12,14,17,20,22,25,27,30,32,33,35,36,37,38,38,39,39,39,40,40,40,40,40,40
E01021886,EV motorcycles,Number,1,2,4,6,10,13,17,21,25,29,32,36,40,43,46,48,50,52,54,55,56,56,57,57,57,58,58,58,58,58
E01021887,EV motorcycles,Number,1,2,4,6,10,13,16,20,24,28,32,35,39,42,45,47,50,51,53,54,55,55,56,56,56,57,57,57,57,57
E01021888,EV motorcycles,Number,1,2,3,6,8,11,14,18,21,25,28,31,34,37,39,42,43,45,46,47,48,49,49,49,49,50,50,50,50,50
E01021889,EV motorcycles,Number,1,1,2,4,6,8,10,13,15,18,20,22,25,27,28,30,31,32,33,34,35,35,35,35,36,36,36,36,36,36
E01021890,EV motorcycles,Number,1,2,3,5,8,11,14,17,20,24,27,30,33,35,38,40,42,43,44,45,46,47,47,47,48,48,48,48,48,48
E01021891,EV motorcycles,Number,0,1,1,2,4,5,6,7,9,10,12,13,14,16,17,17,18,19,19,20,20,20,21,21,21,21,21,21,21,21
E01021892,EV motorcycles,Number,0,1,2,3,4,6,8,9,11,13,15,16,18,19,20,22,23,23,24,25,25,25,25,26,26,26,26,26,26,26
E01021893,EV motorcycles,Number,1,2,3,5,7,9,12,15,18,21,24,26,29,31,33,35,36,38,39,40,40,41,41,41,42,42,42,42,42,42
E01021894,EV motorcycles,Number,0,1,2,4,6,7,10,12,14,16,18,21,23,24,26,27,29,30,31,31,32,32,32,33,33,33,33,33,33,33
E01021895,EV motorcycles,Number,0,1,2,3,4,6,8,9,11,13,15,16,18,19,20,22,23,23,24,25,25,25,25,26,26,26,26,26,26,26
E01021896,EV motorcycles,Number,1,2,4,7,10,14,18,22,26,30,35,39,42,46,49,52,54,56,57,59,59,60,61,61,61,62,62,62,62,62
E01021897,EV motorcycles,Number,0,1,2,3,5,7,9,11,13,15,17,19,21,22,24,25,26,27,28,28,29,29,29,30,30,30,30,30,30,30
E01021898,EV motorcycles,Number,1,1,2,4,6,9,11,13,16,19,21,24,26,28,30,32,33,34,35,36,36,37,37,37,38,38,38,38,38,38
E01021899,EV motorcycles,Number,1,2,4,6,9,12,16,19,23,27,30,34,37,40,43,45,47,49,50,51,52,52,53,53,53,54,54,54,54,54
E01021900,EV motorcycles,Number,1,2,4,6,10,13,17,21,25,29,32,36,40,43,46,48,50,52,54,55,56,56,57,57,57,58,58,58,58,58
E01021901,EV motorcycles,Number,2,5,9,15,23,31,40,50,59,69,78,87,96,103,110,116,122,126,129,132,134,136,137,138,139,139,140,140,140,140
E01021902,EV motorcycles,Number,1,2,4,7,11,14,18,22,27,31,35,39,43,47,50,52,55,57,58,59,60,61,62,62,62,63,63,63,63,63
E01021903,EV motorcycles,Number,1,2,4,7,10,14,18,22,26,30,35,39,42,46,49,52,54,56,57,59,59,60,61,61,61,62,62,62,62,62
E01021904,EV motorcycles,Number,1,2,4,6,9,13,16,20,24,28,31,35,38,41,44,47,49,50,52,53,54,54,55,55,55,56,56,56,56,56
E01021905,EV motorcycles,Number,1,2,3,5,7,10,13,16,19,22,25,27,30,33,35,37,38,40,41,42,42,43,43,43,44,44,44,44,44,44
E01021906,EV motorcycles,Number,1,2,4,6,10,13,16,20,24,28,32,35,39,42,45,47,50,51,53,54,55,55,56,56,56,57,57,57,57,57
E01021907,EV motorcycles,Number,1,4,7,11,17,22,29,36,42,49,56,62,68,74,79,83,87,90,92,94,96,97,98,99,99,99,100,100,100,100
E01021908,EV motorcycles,Number,1,2,4,6,10,13,17,21,25,29,32,36,40,43,46,48,50,52,54,55,56,56,57,57,57,58,58,58,58,58
E01021909,EV motorcycles,Number,1,2,3,6,9,12,15,18,22,26,29,32,36,38,41,43,45,47,48,49,50,50,51,51,51,52,52,52,52,52
E01021910,EV motorcycles,Number,1,2,4,7,10,14,18,22,26,30,34,38,42,45,48,51,53,55,56,58,58,59,60,60,60,61,61,61,61,61
E01021911,EV motorcycles,Number,1,2,3,6,9,12,15,19,22,26,30,33,36,39,42,44,46,48,49,50,51,51,52,52,52,53,53,53,53,53
E01021912,EV motorcycles,Number,1,3,5,8,13,17,22,27,32,37,42,47,51,55,59,62,65,67,69,71,72,73,73,74,74,74,75,75,75,75
E01021913,EV motorcycles,Number,1,1,2,4,6,8,11,13,16,18,21,23,25,27,29,31,32,33,34,35,35,36,36,36,37,37,37,37,37,37
E01021914,EV motorcycles,Number,1,3,6,10,15,20,26,32,38,44,50,55,61,66,70,74,77,80,82,84,85,86,87,88,88,88,89,89,89,89
E01021915,EV motorcycles,Number,1,2,4,6,10,13,17,21,25,29,32,36,40,43,46,48,50,52,54,55,56,56,57,57,57,58,58,58,58,58
E01021916,EV motorcycles,Number,1,2,3,5,8,10,13,16,19,23,26,29,31,34,36,38,40,41,43,43,44,45,45,45,46,46,46,46,46,46
E01021917,EV motorcycles,Number,1,3,5,8,12,17,21,26,31,36,41,46,51,55,58,62,64,67,68,70,71,72,72,73,73,73,74,74,74,74
E01021918,EV motorcycles,Number,1,1,2,4,6,9,11,13,16,19,21,24,26,28,30,32,33,34,35,36,36,37,37,37,38,38,38,38,38,38
E01021919,EV motorcycles,Number,0,1,2,3,4,6,8,9,11,13,15,16,18,19,20,22,23,23,24,25,25,25,25,26,26,26,26,26,26,26
E01021920,EV motorcycles,Number,1,2,4,7,10,14,18,22,26,30,34,38,42,45,48,51,53,55,56,58,58,59,60,60,60,61,61,61,61,61
E01021921,EV motorcycles,Number,1,1,2,4,6,8,10,13,15,18,20,22,25,27,28,30,31,32,33,34,35,35,35,35,36,36,36,36,36,36
E01021922,EV motorcycles,Number,1,2,4,6,10,13,17,21,25,29,32,36,40,43,46,48,50,52,54,55,56,56,57,57,57,58,58,58,58,58
E01021923,EV motorcycles,Number,1,2,3,5,7,10,13,16,19,22,25,27,30,33,35,37,38,40,41,42,42,43,43,43,44,44,44,44,44,44
E01021924,EV motorcycles,Number,1,2,4,6,10,13,16,20,24,28,32,35,39,42,45,47,50,51,53,54,55,55,56,56,56,57,57,57,57,57
E01021925,EV motorcycles,Number,1,2,3,6,9,12,15,18,22,26,29,32,36,38,41,43,45,47,48,49,50,50,51,51,51,52,52,52,52,52
E01021926,EV motorcycles,Number,1,1,2,4,6,9,11,13,16,19,21,24,26,28,30,32,33,34,35,36,36,37,37,37,38,38,38,38,38,38
E01021927,EV motorcycles,Number,1,2,3,5,8,10,13,16,19,22,25,28,31,33,35,37,39,40,42,42,43,44,44,44,45,45,45,45,45,45
E01021928,EV motorcycles,Number,0,1,2,3,5,7,9,11,13,15,17,19,21,22,24,25,26,27,28,28,29,29,29,30,30,30,30,30,30,30
E01021929,EV motorcycles,Number,1,1,3,4,7,9,12,14,17,20,22,25,27,30,32,33,35,36,37,38,38,39,39,39,40,40,40,40,40,40
E01021930,EV motorcycles,Number,0,1,2,4,5,7,9,11,14,16,18,20,22,24,25,27,28,29,30,30,31,31,31,32,32,32,32,32,32,32
E01021931,EV motorcycles,Number,1,3,5,9,14,19,24,30,36,41,47,52,57,62,66,70,73,76,78,79,81,82,82,83,83,83,84,84,84,84
E01021932,EV motorcycles,Number,1,1,3,4,7,9,12,14,17,20,22,25,27,30,32,33,35,36,37,38,38,39,39,39,40,40,40,40,40,40
E01021933,EV motorcycles,Number,1,2,4,6,10,13,17,21,25,29,32,36,40,43,46,48,50,52,54,55,56,56,57,57,57,58,58,58,58,58
E01021934,EV motorcycles,Number,1,2,3,6,8,11,14,18,21,25,28,31,34,37,39,42,43,45,46,47,48,49,49,49,49,50,50,50,50,50
E01021935,EV motorcycles,Number,1,2,3,5,7,10,13,16,19,22,25,27,30,33,35,37,38,40,41,42,42,43,43,43,44,44,44,44,44,44
E01021936,EV motorcycles,Number,0,1,2,3,5,7,9,11,13,15,17,19,21,22,24,25,26,27,28,28,29,29,29,30,30,30,30,30,30,30
E01021937,EV motorcycles,Number,0,1,1,2,4,5,6,8,9,11,12,14,15,16,17,18,19,20,20,21,21,21,22,22,22,22,22,22,22,22
E01021938,EV motorcycles,Number,0,1,2,3,4,6,7,9,11,12,14,16,17,18,20,21,22,22,23,24,24,24,24,25,25,25,25,25,25,25
E01021939,EV motorcycles,Number,0,1,2,4,5,7,9,11,14,16,18,20,22,24,25,27,28,29,30,30,31,31,31,32,32,32,32,32,32,32
E01021940,EV motorcycles,Number,1,2,3,6,9,12,15,19,22,26,30,33,36,39,42,44,46,48,49,50,51,51,52,52,52,53,53,53,53,53
E01021941,EV motorcycles,Number,1,2,3,5,8,11,14,17,21,24,27,31,33,36,39,41,43,44,45,46,47,48,48,48,48,49,49,49,49,49
E01021942,EV motorcycles,Number,1,1,2,4,6,9,11,13,16,19,21,24,26,28,30,32,33,34,35,36,36,37,37,37,38,38,38,38,38,38
E01021943,EV motorcycles,Number,1,2,3,5,8,10,13,16,19,23,26,29,31,34,36,38,40,41,43,43,44,45,45,45,46,46,46,46,46,46
E01021944,EV motorcycles,Number,1,2,4,7,10,14,18,22,26,30,34,38,42,45,48,51,53,55,56,58,58,59,60,60,60,61,61,61,61,61
E01021945,EV motorcycles,Number,1,2,4,7,11,15,20,24,29,33,38,42,46,50,54,57,59,61,63,64,65,66,67,67,67,68,68,68,68,68
E01021946,EV motorcycles,Number,1,2,4,6,9,12,16,19,23,27,30,34,37,40,43,45,47,49,50,51,52,52,53,53,53,54,54,54,54,54
E01021947,EV motorcycles,Number,0,0,1,1,2,3,4,5,5,6,7,8,9,10,10,11,11,12,12,12,12,13,13,13,13,13,13,13,13,13
E01021948,EV motorcycles,Number,0,1,2,4,6,7,10,12,14,16,18,21,23,24,26,27,29,30,31,31,32,32,32,33,33,33,33,33,33,33
E01021949,EV motorcycles,Number,0,1,2,3,4,6,8,9,11,13,15,16,18,19,20,22,23,23,24,25,25,25,25,26,26,26,26,26,26,26
E01021950,EV motorcycles,Number,1,2,3,5,8,11,14,17,20,23,26,29,32,35,37,39,41,42,43,44,45,46,46,46,47,47,47,47,47,47
E01021951,EV motorcycles,Number,0,1,2,3,5,7,9,11,13,15,17,19,21,23,24,26,27,28,29,29,30,30,30,31,31,31,31,31,31,31
E01021952,EV motorcycles,Number,1,2,3,5,7,10,13,16,19,22,25,27,30,33,35,37,38,40,41,42,42,43,43,43,44,44,44,44,44,44
E01021953,EV motorcycles,Number,1,1,2,4,6,8,10,13,15,18,20,22,25,27,28,30,31,32,33,34,35,35,35,35,36,36,36,36,36,36
E01021954,EV motorcycles,Number,1,2,4,7,11,14,18,22,27,31,35,39,43,47,50,52,55,57,58,59,60,61,62,62,62,63,63,63,63,63
E01021955,EV motorcycles,Number,0,1,2,4,6,8,10,12,14,17,19,21,23,25,27,28,30,31,31,32,33,33,33,33,34,34,34,34,34,34
E01021956,EV motorcycles,Number,1,2,4,7,11,15,19,23,28,32,37,41,45,49,52,55,57,59,61,62,63,64,65,65,65,66,66,66,66,66
E01021957,EV motorcycles,Number,0,1,1,2,3,4,5,6,8,9,10,11,12,13,14,15,16,16,17,17,17,17,18,18,18,18,18,18,18,18
E01021958,EV motorcycles,Number,0,1,1,2,4,5,6,8,9,11,12,14,15,16,17,18,19,20,20,21,21,21,22,22,22,22,22,22,22,22
E01021959,EV motorcycles,Number,1,2,3,5,8,10,13,16,19,22,25,28,31,33,35,37,39,40,42,42,43,44,44,44,45,45,45,45,45,45
E01021960,EV motorcycles,Number,1,1,3,4,7,9,11,14,16,19,22,24,27,29,31,32,34,35,36,37,37,38,38,38,39,39,39,39,39,39
E01021961,EV motorcycles,Number,0,1,1,2,3,4,6,7,8,10,11,12,14,15,16,17,17,18,18,19,19,19,20,20,20,20,20,20,20,20
E01021962,EV motorcycles,Number,0,1,1,2,4,5,6,8,9,11,12,14,15,16,17,18,19,20,20,21,21,21,22,22,22,22,22,22,22,22
E01021963,EV motorcycles,Number,1,1,3,4,7,9,11,14,16,19,22,24,27,29,31,32,34,35,36,37,37,38,38,38,39,39,39,39,39,39
E01021964,EV motorcycles,Number,1,2,3,5,7,10,13,16,19,22,25,27,30,33,35,37,38,40,41,42,42,43,43,43,44,44,44,44,44,44
E01021965,EV motorcycles,Number,1,2,4,7,10,14,18,22,26,30,35,39,42,46,49,52,54,56,57,59,59,60,61,61,61,62,62,62,62,62
E01021966,EV motorcycles,Number,0,1,1,2,3,4,5,6,7,8,9,10,11,12,13,13,14,14,15,15,15,16,16,16,16,16,16,16,16,16
E01021967,EV motorcycles,Number,2,4,7,12,18,24,31,38,46,53,60,67,74,80,85,90,94,97,100,102,104,105,106,106,107,107,108,108,108,108
E01021968,EV motorcycles,Number,1,2,3,5,8,10,13,16,19,22,25,28,31,33,35,37,39,40,42,42,43,44,44,44,45,45,45,45,45,45
E01021969,EV motorcycles,Number,0,1,2,3,4,5,7,8,10,11,13,14,16,17,18,19,20,21,21,22,22,22,23,23,23,23,23,23,23,23
E01021970,EV motorcycles,Number,1,1,2,4,6,8,10,12,15,17,20,22,24,26,28,29,30,31,32,33,34,34,34,34,35,35,35,35,35,35
E01021971,EV motorcycles,Number,1,3,5,9,13,18,23,28,33,38,44,49,53,58,61,65,68,70,72,74,75,76,76,77,77,77,78,78,78,78
E01021972,EV motorcycles,Number,1,2,4,7,11,15,20,24,29,33,38,42,46,50,54,57,59,61,63,64,65,66,67,67,67,68,68,68,68,68
E01021973,EV motorcycles,Number,1,1,3,4,7,9,12,14,17,20,22,25,27,30,32,33,35,36,37,38,38,39,39,39,40,40,40,40,40,40
E01021974,EV motorcycles,Number,1,2,3,6,8,11,14,18,21,25,28,31,34,37,39,42,43,45,46,47,48,49,49,49,49,50,50,50,50,50
E01021975,EV motorcycles,Number,0,1,2,3,4,5,7,8,10,11,13,14,16,17,18,19,20,21,21,22,22,22,23,23,23,23,23,23,23,23
E01021976,EV motorcycles,Number,0,1,2,4,6,8,10,12,14,17,19,21,23,25,27,28,30,31,31,32,33,33,33,33,34,34,34,34,34,34
E01021977,EV motorcycles,Number,1,2,3,6,9,12,15,18,22,26,29,32,36,38,41,43,45,47,48,49,50,50,51,51,51,52,52,52,52,52
E01021978,EV motorcycles,Number,2,4,7,12,18,24,30,37,44,52,59,65,72,78,83,87,91,94,97,99,101,102,103,103,104,104,105,105,105,105
E01021979,EV motorcycles,Number,1,1,3,4,7,9,11,14,16,19,22,24,27,29,31,32,34,35,36,37,37,38,38,38,39,39,39,39,39,39
E01021980,EV motorcycles,Number,1,2,4,7,10,13,17,21,25,30,34,37,41,44,47,50,52,54,55,57,58,58,59,59,59,60,60,60,60,60
E01021981,EV motorcycles,Number,1,2,4,6,9,13,16,20,24,28,31,35,38,41,44,47,49,50,52,53,54,54,55,55,55,56,56,56,56,56
E01021982,EV motorcycles,Number,1,2,4,7,11,14,18,22,27,31,35,39,43,47,50,52,55,57,58,59,60,61,62,62,62,63,63,63,63,63
E01021983,EV motorcycles,Number,1,2,4,7,11,14,18,22,27,31,35,39,43,47,50,52,55,57,58,59,60,61,62,62,62,63,63,63,63,63
E01021984,EV motorcycles,Number,1,2,5,8,12,15,20,25,29,34,39,43,47,51,54,57,60,62,64,65,66,67,68,68,68,69,69,69,69,69
E01021985,EV motorcycles,Number,0,1,2,3,4,6,7,9,11,12,14,16,17,18,20,21,22,22,23,24,24,24,24,25,25,25,25,25,25,25
E01021986,EV motorcycles,Number,0,1,1,2,3,4,5,6,8,9,10,11,12,13,14,15,16,16,17,17,17,17,18,18,18,18,18,18,18,18
E01021987,EV motorcycles,Number,0,1,2,3,4,5,7,8,10,11,13,14,16,17,18,19,20,21,21,22,22,22,23,23,23,23,23,23,23,23
E01021988,EV motorcycles,Number,1,2,4,6,9,12,16,19,23,27,30,34,37,40,43,45,47,49,50,51,52,52,53,53,53,54,54,54,54,54
E01021989,EV motorcycles,Number,1,2,3,6,9,11,15,18,22,25,29,32,35,38,40,42,44,46,47,48,49,49,50,50,50,51,51,51,51,51
E01021990,EV motorcycles,Number,1,1,2,4,6,8,10,12,15,17,20,22,24,26,28,29,30,31,32,33,34,34,34,34,35,35,35,35,35,35
E01021991,EV motorcycles,Number,1,2,3,5,7,9,12,15,18,21,24,26,29,31,33,35,36,38,39,40,40,41,41,41,42,42,42,42,42,42
E01021992,EV motorcycles,Number,1,2,3,5,7,9,12,15,18,21,24,26,29,31,33,35,36,38,39,40,40,41,41,41,42,42,42,42,42,42
E01021993,EV motorcycles,Number,2,5,9,14,22,29,38,47,55,64,73,82,90,97,103,109,114,118,121,124,126,127,128,129,130,130,131,131,131,131
E01021994,EV motorcycles,Number,0,1,1,2,3,4,5,6,8,9,10,11,12,13,14,15,16,16,17,17,17,17,18,18,18,18,18,18,18,18
E01021995,EV motorcycles,Number,0,1,2,4,5,7,9,11,14,16,18,20,22,24,25,27,28,29,30,30,31,31,31,32,32,32,32,32,32,32
E01021996,EV motorcycles,Number,0,1,1,2,3,4,5,7,8,9,11,12,13,14,15,16,17,17,18,18,18,18,19,19,19,19,19,19,19,19
E01021997,EV motorcycles,Number,0,1,2,3,5,6,8,10,11,13,15,17,18,20,21,22,23,24,25,25,26,26,26,27,27,27,27,27,27,27
E01021998,EV motorcycles,Number,1,1,3,5,7,9,12,15,17,20,23,26,28,30,32,34,36,37,38,39,39,40,40,40,41,41,41,41,41,41
E01021999,EV motorcycles,Number,1,2,3,5,8,10,13,16,19,23,26,29,31,34,36,38,40,41,43,43,44,45,45,45,46,46,46,46,46,46
E01022000,EV motorcycles,Number,1,1,2,4,6,8,10,13,15,18,20,22,25,27,28,30,31,32,33,34,35,35,35,35,36,36,36,36,36,36
E01022001,EV motorcycles,Number,1,1,2,4,6,9,11,13,16,19,21,24,26,28,30,32,33,34,35,36,36,37,37,37,38,38,38,38,38,38
E01022002,EV motorcycles,Number,1,2,4,6,10,13,17,21,25,29,32,36,40,43,46,48,50,52,54,55,56,56,57,57,57,58,58,58,58,58
E01022004,EV motorcycles,Number,1,2,4,7,11,15,19,24,28,33,37,42,46,50,53,56,58,60,62,63,64,65,66,66,66,67,67,67,67,67
E01022005,EV motorcycles,Number,1,2,4,7,11,15,19,23,28,32,37,41,45,49,52,55,57,59,61,62,63,64,65,65,65,66,66,66,66,66
E01022006,EV motorcycles,Number,1,2,3,5,7,10,13,16,19,22,25,27,30,33,35,37,38,40,41,42,42,43,43,43,44,44,44,44,44,44
E01022007,EV motorcycles,Number,1,2,3,5,8,10,13,16,19,23,26,29,31,34,36,38,40,41,43,43,44,45,45,45,46,46,46,46,46,46
E01022008,EV motorcycles,Number,1,2,3,5,8,10,13,16,19,22,25,28,31,33,35,37,39,40,42,42,43,44,44,44,45,45,45,45,45,45
E01022009,EV motorcycles,Number,1,1,3,4,7,9,12,14,17,20,22,25,27,30,32,33,35,36,37,38,38,39,39,39,40,40,40,40,40,40
E01022010,EV motorcycles,Number,1,2,3,5,7,10,13,16,19,22,25,27,30,33,35,37,38,40,41,42,42,43,43,43,44,44,44,44,44,44
E01022011,EV motorcycles,Number,1,3,5,9,14,19,24,30,36,41,47,52,57,62,66,70,73,76,78,79,81,82,82,83,83,83,84,84,84,84
E01022012,EV motorcycles,Number,1,2,3,5,8,11,14,17,20,23,26,29,32,35,37,39,41,42,43,44,45,46,46,46,47,47,47,47,47,47
E01022013,EV motorcycles,Number,1,3,5,8,12,16,21,26,30,35,40,45,49,53,57,60,63,65,67,68,69,70,70,71,71,71,72,72,72,72
E01022014,EV motorcycles,Number,1,2,3,6,9,12,15,19,22,26,30,33,36,39,42,44,46,48,49,50,51,51,52,52,52,53,53,53,53,53
E01022015,EV motorcycles,Number,0,1,2,4,6,8,10,12,14,17,19,21,23,25,27,28,30,31,31,32,33,33,33,33,34,34,34,34,34,34
E01022016,EV motorcycles,Number,1,2,4,7,10,13,17,21,25,29,33,37,40,44,47,49,51,53,55,56,57,57,58,58,58,59,59,59,59,59
E01022017,EV motorcycles,Number,1,3,5,9,14,19,24,30,36,41,47,52,57,62,66,70,73,76,78,79,81,82,82,83,83,83,84,84,84,84
E01022018,EV motorcycles,Number,1,3,5,8,13,17,22,27,32,37,43,47,52,56,60,63,66,68,70,72,73,74,74,75,75,75,76,76,76,76
E01022019,EV motorcycles,Number,1,3,5,8,12,16,21,25,30,35,40,44,49,52,56,59,62,64,66,67,68,69,70,70,70,71,71,71,71,71
E01022020,EV motorcycles,Number,1,2,4,6,9,12,16,19,23,27,30,34,37,40,43,45,47,49,50,51,52,52,53,53,53,54,54,54,54,54
E01022021,EV motorcycles,Number,1,2,4,6,9,12,16,19,23,27,30,34,37,40,43,45,47,49,50,51,52,52,53,53,53,54,54,54,54,54
E01022022,EV motorcycles,Number,1,1,3,4,7,9,11,14,16,19,22,24,27,29,31,32,34,35,36,37,37,38,38,38,39,39,39,39,39,39
E01022023,EV motorcycles,Number,1,1,3,5,7,9,12,15,17,20,23,26,28,30,32,34,36,37,38,39,39,40,40,40,41,41,41,41,41,41
E01022024,EV motorcycles,Number,1,2,3,5,7,10,13,16,19,22,25,27,30,33,35,37,38,40,41,42,42,43,43,43,44,44,44,44,44,44
E01022025,EV motorcycles,Number,0,1,1,2,3,4,5,7,8,9,11,12,13,14,15,16,17,17,18,18,18,18,19,19,19,19,19,19,19,19
E01022026,EV motorcycles,Number,0,1,2,3,4,5,7,8,10,11,13,14,16,17,18,19,20,21,21,22,22,22,23,23,23,23,23,23,23,23
E01022027,EV motorcycles,Number,0,1,2,3,4,5,7,9,10,12,13,15,16,18,19,20,21,22,22,23,23,23,23,24,24,24,24,24,24,24
E01022028,EV motorcycles,Number,1,2,3,5,8,10,13,16,19,22,25,28,31,33,35,37,39,40,42,42,43,44,44,44,45,45,45,45,45,45
E01022030,EV motorcycles,Number,1,1,2,4,6,9,11,13,16,19,21,24,26,28,30,32,33,34,35,36,36,37,37,37,38,38,38,38,38,38
E01022031,EV motorcycles,Number,0,1,2,3,4,6,7,9,11,12,14,16,17,18,20,21,22,22,23,24,24,24,24,25,25,25,25,25,25,25
E01022032,EV motorcycles,Number,1,1,3,4,7,9,12,14,17,20,22,25,27,30,32,33,35,36,37,38,38,39,39,39,40,40,40,40,40,40
E01022033,EV motorcycles,Number,0,1,2,3,5,7,8,10,12,14,16,18,20,21,23,24,25,26,27,27,28,28,28,29,29,29,29,29,29,29
E01022034,EV motorcycles,Number,0,1,2,3,5,7,9,11,13,15,17,19,21,22,24,25,26,27,28,28,29,29,29,30,30,30,30,30,30,30
E01022035,EV motorcycles,Number,0,1,1,2,4,5,6,8,9,11,12,14,15,16,17,18,19,20,20,21,21,21,22,22,22,22,22,22,22,22
E01022036,EV motorcycles,Number,0,1,2,3,4,5,7,8,10,11,13,14,16,17,18,19,20,21,21,22,22,22,23,23,23,23,23,23,23,23
E01022037,EV motorcycles,Number,1,2,3,6,8,11,14,18,21,25,28,31,34,37,39,42,43,45,46,47,48,49,49,49,49,50,50,50,50,50
E01022038,EV motorcycles,Number,0,1,2,3,4,5,7,9,10,12,13,15,16,18,19,20,21,22,22,23,23,23,23,24,24,24,24,24,24,24
E01022039,EV motorcycles,Number,0,1,2,4,6,7,10,12,14,16,18,21,23,24,26,27,29,30,31,31,32,32,32,33,33,33,33,33,33,33
E01022040,EV motorcycles,Number,1,2,3,6,9,12,15,19,22,26,30,33,36,39,42,44,46,48,49,50,51,51,52,52,52,53,53,53,53,53
E01022041,EV motorcycles,Number,0,1,2,3,5,6,8,10,11,13,15,17,18,20,21,22,23,24,25,25,26,26,26,27,27,27,27,27,27,27
E01022042,EV motorcycles,Number,0,1,2,3,4,6,8,9,11,13,15,16,18,19,20,22,23,23,24,25,25,25,25,26,26,26,26,26,26,26
E01022043,EV motorcycles,Number,0,1,2,3,5,7,9,11,13,15,17,19,21,23,24,26,27,28,29,29,30,30,30,31,31,31,31,31,31,31
E01022044,EV motorcycles,Number,1,1,3,4,7,9,11,14,16,19,22,24,27,29,31,32,34,35,36,37,37,38,38,38,39,39,39,39,39,39
E01022045,EV motorcycles,Number,1,2,4,6,9,13,16,20,24,28,31,35,38,41,44,47,49,50,52,53,54,54,55,55,55,56,56,56,56,56
E01022046,EV motorcycles,Number,1,3,5,9,13,18,23,28,33,38,44,49,53,58,61,65,68,70,72,74,75,76,76,77,77,77,78,78,78,78
E01022047,EV motorcycles,Number,1,2,3,5,8,11,14,17,20,23,26,29,32,35,37,39,41,42,43,44,45,46,46,46,47,47,47,47,47,47
E01022048,EV motorcycles,Number,0,1,1,2,4,5,6,8,9,11,12,14,15,16,17,18,19,20,20,21,21,21,22,22,22,22,22,22,22,22
E01022049,EV motorcycles,Number,0,1,2,3,5,7,8,10,12,14,16,18,20,21,23,24,25,26,27,27,28,28,28,29,29,29,29,29,29,29
E01022050,EV motorcycles,Number,1,2,3,5,8,10,13,16,19,22,25,28,31,33,35,37,39,40,42,42,43,44,44,44,45,45,45,45,45,45
E01022051,EV motorcycles,Number,1,3,5,8,12,16,20,25,30,34,39,44,48,52,55,58,61,63,65,66,67,68,69,69,69,70,70,70,70,70
E01022052,EV motorcycles,Number,1,2,4,6,9,12,16,20,23,27,31,34,38,41,43,46,48,49,51,52,53,53,54,54,54,55,55,55,55,55
E01022053,EV motorcycles,Number,2,4,7,12,19,25,33,40,48,56,63,70,77,83,89,94,98,102,104,107,108,110,111,111,112,112,113,113,113,113
E01022054,EV motorcycles,Number,0,1,2,4,6,8,10,12,14,17,19,21,23,25,27,28,30,31,31,32,33,33,33,33,34,34,34,34,34,34
E01022055,EV motorcycles,Number,0,1,2,4,6,7,10,12,14,16,18,21,23,24,26,27,29,30,31,31,32,32,32,33,33,33,33,33,33,33
E01022056,EV motorcycles,Number,0,1,2,3,5,6,8,10,12,14,16,17,19,21,22,23,24,25,26,26,27,27,27,28,28,28,28,28,28,28
E01022057,EV motorcycles,Number,1,3,5,8,12,16,21,26,31,36,41,45,50,54,58,61,63,66,67,69,70,71,71,72,72,72,73,73,73,73
E01022058,EV motorcycles,Number,1,2,4,6,10,13,16,20,24,28,32,35,39,42,45,47,50,51,53,54,55,55,56,56,56,57,57,57,57,57
E01022059,EV motorcycles,Number,1,2,3,6,9,12,15,18,22,26,29,32,36,38,41,43,45,47,48,49,50,50,51,51,51,52,52,52,52,52
E01022060,EV motorcycles,Number,1,2,3,5,8,11,14,17,20,23,26,29,32,35,37,39,41,42,43,44,45,46,46,46,47,47,47,47,47,47
E01022061,EV motorcycles,Number,1,2,4,7,10,14,18,22,26,30,34,38,42,45,48,51,53,55,56,58,58,59,60,60,60,61,61,61,61,61
E01022062,EV motorcycles,Number,1,3,5,8,12,16,20,25,30,34,39,44,48,52,55,58,61,63,65,66,67,68,69,69,69,70,70,70,70,70
E01022063,EV motorcycles,Number,1,3,5,8,12,16,21,26,30,35,40,45,49,53,57,60,63,65,67,68,69,70,70,71,71,71,72,72,72,72
E01022064,EV motorcycles,Number,1,2,4,6,9,13,16,20,24,28,31,35,38,41,44,47,49,50,52,53,54,54,55,55,55,56,56,56,56,56
E01022067,EV motorcycles,Number,0,1,2,4,6,7,10,12,14,16,18,21,23,24,26,27,29,30,31,31,32,32,32,33,33,33,33,33,33,33
E01022068,EV motorcycles,Number,1,2,4,6,10,13,16,20,24,28,32,35,39,42,45,47,50,51,53,54,55,55,56,56,56,57,57,57,57,57
E01022069,EV motorcycles,Number,0,1,1,2,4,5,6,8,9,11,12,14,15,16,17,18,19,20,20,21,21,21,22,22,22,22,22,22,22,22
E01022070,EV motorcycles,Number,1,2,3,5,8,11,14,17,20,24,27,30,33,35,38,40,42,43,44,45,46,47,47,47,48,48,48,48,48,48
E01022071,EV motorcycles,Number,1,3,5,8,12,16,21,26,31,36,41,45,50,54,58,61,63,66,67,69,70,71,71,72,72,72,73,73,73,73
E01022072,EV motorcycles,Number,1,3,6,10,15,20,25,31,37,43,49,55,60,65,69,73,76,79,81,83,84,85,86,87,87,87,88,88,88,88
E01022073,EV motorcycles,Number,1,2,4,7,11,15,20,24,29,33,38,42,46,50,54,57,59,61,63,64,65,66,67,67,67,68,68,68,68,68
E01022074,EV motorcycles,Number,1,1,3,4,7,9,12,14,17,20,22,25,27,30,32,33,35,36,37,38,38,39,39,39,40,40,40,40,40,40
E01022075,EV motorcycles,Number,0,1,1,2,3,4,5,7,8,9,11,12,13,14,15,16,17,17,18,18,18,18,19,19,19,19,19,19,19,19
E01022076,EV motorcycles,Number,0,1,2,3,5,7,8,10,12,14,16,18,20,21,23,24,25,26,27,27,28,28,28,29,29,29,29,29,29,29
E01022077,EV motorcycles,Number,0,1,2,4,6,8,10,12,14,17,19,21,23,25,27,28,30,31,31,32,33,33,33,33,34,34,34,34,34,34
E01022078,EV motorcycles,Number,0,1,2,3,5,6,8,10,11,13,15,17,18,20,21,22,23,24,25,25,26,26,26,27,27,27,27,27,27,27
E01022079,EV motorcycles,Number,1,2,3,6,9,12,15,19,22,26,30,33,36,39,42,44,46,48,49,50,51,51,52,52,52,53,53,53,53,53
E01022080,EV motorcycles,Number,1,2,3,5,7,9,12,15,18,21,24,26,29,31,33,35,36,38,39,40,40,41,41,41,42,42,42,42,42,42
E01022081,EV motorcycles,Number,1,2,4,7,11,14,19,23,27,31,36,40,44,47,50,53,56,58,59,60,61,62,63,63,63,64,64,64,64,64
E01022082,EV motorcycles,Number,1,2,4,7,10,14,18,22,26,30,35,39,42,46,49,52,54,56,57,59,59,60,61,61,61,62,62,62,62,62
E01022083,EV motorcycles,Number,1,2,3,5,7,10,13,16,19,22,25,27,30,33,35,37,38,40,41,42,42,43,43,43,44,44,44,44,44,44
E01022084,EV motorcycles,Number,1,2,4,6,9,12,16,20,23,27,31,34,38,41,43,46,48,49,51,52,53,53,54,54,54,55,55,55,55,55
E01022085,EV motorcycles,Number,1,1,3,4,7,9,12,14,17,20,22,25,27,30,32,33,35,36,37,38,38,39,39,39,40,40,40,40,40,40
E01022086,EV motorcycles,Number,0,1,1,2,3,4,5,7,8,9,11,12,13,14,15,16,17,17,18,18,18,18,19,19,19,19,19,19,19,19
E01022087,EV motorcycles,Number,1,3,5,8,12,16,20,25,30,34,39,44,48,52,55,58,61,63,65,66,67,68,69,69,69,70,70,70,70,70
E01022088,EV motorcycles,Number,1,3,5,8,13,17,22,27,33,38,43,48,53,57,61,64,67,69,71,73,74,75,75,76,76,76,77,77,77,77
E01022089,EV motorcycles,Number,0,1,2,3,5,6,8,10,12,14,16,17,19,21,22,23,24,25,26,26,27,27,27,28,28,28,28,28,28,28
E01022090,EV motorcycles,Number,1,3,5,9,13,18,23,28,33,39,44,49,54,58,62,66,69,71,73,75,76,77,77,78,78,78,79,79,79,79
E01022091,EV motorcycles,Number,1,3,5,9,13,18,23,28,33,38,44,49,53,58,61,65,68,70,72,74,75,76,76,77,77,77,78,78,78,78
E01022092,EV motorcycles,Number,1,2,4,7,11,15,19,24,28,33,37,42,46,50,53,56,58,60,62,63,64,65,66,66,66,67,67,67,67,67
E01022093,EV motorcycles,Number,1,2,4,6,10,13,17,21,25,29,32,36,40,43,46,48,50,52,54,55,56,56,57,57,57,58,58,58,58,58
E01022094,EV motorcycles,Number,1,1,2,4,6,9,11,13,16,19,21,24,26,28,30,32,33,34,35,36,36,37,37,37,38,38,38,38,38,38
E01022095,EV motorcycles,Number,1,2,5,8,12,15,20,25,29,34,39,43,47,51,54,57,60,62,64,65,66,67,68,68,68,69,69,69,69,69
E01022096,EV motorcycles,Number,1,3,5,9,14,18,23,29,34,40,45,50,55,60,64,67,70,73,75,76,78,79,79,80,80,80,81,81,81,81
E01022097,EV motorcycles,Number,1,3,5,8,12,16,21,26,31,36,41,45,50,54,58,61,63,66,67,69,70,71,71,72,72,72,73,73,73,73
E01022098,EV motorcycles,Number,1,1,2,4,6,8,11,13,16,18,21,23,25,27,29,31,32,33,34,35,35,36,36,36,37,37,37,37,37,37
E01022099,EV motorcycles,Number,1,2,4,7,11,15,20,24,29,33,38,42,46,50,54,57,59,61,63,64,65,66,67,67,67,68,68,68,68,68
E01023289,EV motorcycles,Number,0,1,1,2,4,5,6,8,9,11,12,14,15,16,17,18,19,20,20,21,21,21,22,22,22,22,22,22,22,22
E01023290,EV motorcycles,Number,0,1,1,2,2,3,4,5,6,7,8,9,10,10,11,12,12,13,13,13,13,14,14,14,14,14,14,14,14,14
E01023291,EV motorcycles,Number,0,1,1,2,3,4,6,7,8,10,11,12,14,15,16,17,17,18,18,19,19,19,20,20,20,20,20,20,20,20
E01023292,EV motorcycles,Number,0,0,1,1,2,2,3,3,4,4,5,6,6,7,7,7,8,8,8,8,9,9,9,9,9,9,9,9,9,9
E01023293,EV motorcycles,Number,1,1,2,4,6,8,10,12,15,17,20,22,24,26,28,29,30,31,32,33,34,34,34,34,35,35,35,35,35,35
E01023294,EV motorcycles,Number,0,1,1,2,2,3,4,5,6,7,8,9,10,10,11,12,12,13,13,13,13,14,14,14,14,14,14,14,14,14
E01023295,EV motorcycles,Number,0,1,2,3,4,5,7,9,10,12,13,15,16,18,19,20,21,22,22,23,23,23,23,24,24,24,24,24,24,24
E01023296,EV motorcycles,Number,0,1,2,4,6,7,10,12,14,16,18,21,23,24,26,27,29,30,31,31,32,32,32,33,33,33,33,33,33,33
E01023297,EV motorcycles,Number,0,1,1,2,4,5,6,7,9,10,12,13,14,16,17,17,18,19,19,20,20,20,21,21,21,21,21,21,21,21
E01023298,EV motorcycles,Number,0,1,1,2,3,4,5,7,8,9,11,12,13,14,15,16,17,17,18,18,18,18,19,19,19,19,19,19,19,19
E01023299,EV motorcycles,Number,1,1,2,4,6,8,10,13,15,18,20,22,25,27,28,30,31,32,33,34,35,35,35,35,36,36,36,36,36,36
E01023300,EV motorcycles,Number,0,0,1,1,2,2,3,4,5,5,6,7,8,8,9,9,10,10,10,10,11,11,11,11,11,11,11,11,11,11
E01023301,EV motorcycles,Number,0,1,1,2,3,4,5,7,8,9,11,12,13,14,15,16,17,17,18,18,18,18,19,19,19,19,19,19,19,19
E01023302,EV motorcycles,Number,0,1,1,2,3,3,4,5,6,7,8,9,10,11,12,12,13,13,14,14,14,15,15,15,15,15,15,15,15,15
E01023303,EV motorcycles,Number,0,1,1,2,4,5,6,7,9,10,12,13,14,16,17,17,18,19,19,20,20,20,21,21,21,21,21,21,21,21
E01023304,EV motorcycles,Number,0,1,1,2,3,4,5,6,7,8,10,11,12,13,13,14,15,15,16,16,16,16,17,17,17,17,17,17,17,17
E01023305,EV motorcycles,Number,0,1,1,2,3,4,5,7,8,9,11,12,13,14,15,16,17,17,18,18,18,18,19,19,19,19,19,19,19,19
E01023306,EV motorcycles,Number,0,0,1,1,2,2,3,4,5,5,6,7,8,8,9,9,10,10,10,10,11,11,11,11,11,11,11,11,11,11
E01023307,EV motorcycles,Number,0,1,2,4,6,8,10,12,14,17,19,21,23,25,27,28,30,31,31,32,33,33,33,33,34,34,34,34,34,34
E01023308,EV motorcycles,Number,0,1,1,2,3,4,6,7,8,10,11,12,14,15,16,17,17,18,18,19,19,19,20,20,20,20,20,20,20,20
E01023309,EV motorcycles,Number,0,1,2,3,5,7,8,10,12,14,16,18,20,21,23,24,25,26,27,27,28,28,28,29,29,29,29,29,29,29
E01023310,EV motorcycles,Number,0,1,2,3,5,7,9,11,13,15,17,19,21,22,24,25,26,27,28,28,29,29,29,30,30,30,30,30,30,30
E01023311,EV motorcycles,Number,1,1,2,4,6,9,11,13,16,19,21,24,26,28,30,32,33,34,35,36,36,37,37,37,38,38,38,38,38,38
E01023312,EV motorcycles,Number,0,1,2,3,4,6,7,9,11,12,14,16,17,18,20,21,22,22,23,24,24,24,24,25,25,25,25,25,25,25
E01023313,EV motorcycles,Number,1,2,3,5,8,11,14,17,20,24,27,30,33,35,38,40,42,43,44,45,46,47,47,47,48,48,48,48,48,48
E01023314,EV motorcycles,Number,0,1,2,3,4,5,7,9,10,12,13,15,16,18,19,20,21,22,22,23,23,23,23,24,24,24,24,24,24,24
E01023315,EV motorcycles,Number,0,1,2,3,5,7,9,11,13,15,17,19,21,22,24,25,26,27,28,28,29,29,29,30,30,30,30,30,30,30
E01023316,EV motorcycles,Number,0,1,1,2,3,3,4,5,6,7,8,9,10,11,12,12,13,13,14,14,14,15,15,15,15,15,15,15,15,15
E01023317,EV motorcycles,Number,0,1,2,3,5,7,9,11,13,15,17,19,21,22,24,25,26,27,28,28,29,29,29,30,30,30,30,30,30,30
E01023318,EV motorcycles,Number,0,1,2,3,4,6,7,9,11,12,14,16,17,18,20,21,22,22,23,24,24,24,24,25,25,25,25,25,25,25
E01023319,EV motorcycles,Number,1,1,2,4,6,8,10,13,15,18,20,22,25,27,28,30,31,32,33,34,35,35,35,35,36,36,36,36,36,36
E01023320,EV motorcycles,Number,1,1,2,4,6,8,10,13,15,18,20,22,25,27,28,30,31,32,33,34,35,35,35,35,36,36,36,36,36,36
E01023321,EV motorcycles,Number,0,1,2,3,5,6,8,10,12,14,16,17,19,21,22,23,24,25,26,26,27,27,27,28,28,28,28,28,28,28
E01023322,EV motorcycles,Number,1,1,3,4,7,9,12,14,17,20,22,25,27,30,32,33,35,36,37,38,38,39,39,39,40,40,40,40,40,40
E01023323,EV motorcycles,Number,0,1,2,3,4,6,8,9,11,13,15,16,18,19,20,22,23,23,24,25,25,25,25,26,26,26,26,26,26,26
E01023324,EV motorcycles,Number,0,1,1,2,4,5,6,8,9,11,12,14,15,16,17,18,19,20,20,21,21,21,22,22,22,22,22,22,22,22
E01023325,EV motorcycles,Number,0,1,1,2,3,3,4,5,6,7,8,9,10,11,12,12,13,13,14,14,14,15,15,15,15,15,15,15,15,15
E01023326,EV motorcycles,Number,0,1,2,3,4,5,7,8,10,11,13,14,16,17,18,19,20,21,21,22,22,22,23,23,23,23,23,23,23,23
E01023327,EV motorcycles,Number,0,1,1,2,3,4,5,6,7,8,9,10,11,12,13,13,14,14,15,15,15,16,16,16,16,16,16,16,16,16
E01023328,EV motorcycles,Number,0,1,1,2,3,4,6,7,8,10,11,12,14,15,16,17,17,18,18,19,19,19,20,20,20,20,20,20,20,20
E01023329,EV motorcycles,Number,0,1,1,2,4,5,6,8,9,11,12,14,15,16,17,18,19,20,20,21,21,21,22,22,22,22,22,22,22,22
E01023330,EV motorcycles,Number,1,2,3,5,7,10,12,15,18,21,24,27,29,32,34,36,37,39,40,41,41,42,42,42,43,43,43,43,43,43
E01023331,EV motorcycles,Number,1,2,3,5,7,9,12,15,18,21,24,26,29,31,33,35,36,38,39,40,40,41,41,41,42,42,42,42,42,42
E01023332,EV motorcycles,Number,1,1,2,4,6,9,11,13,16,19,21,24,26,28,30,32,33,34,35,36,36,37,37,37,38,38,38,38,38,38
E01023333,EV motorcycles,Number,0,1,2,4,6,7,10,12,14,16,18,21,23,24,26,27,29,30,31,31,32,32,32,33,33,33,33,33,33,33
E01023334,EV motorcycles,Number,0,1,2,3,4,5,7,8,10,11,13,14,16,17,18,19,20,21,21,22,22,22,23,23,23,23,23,23,23,23
E01023335,EV motorcycles,Number,1,1,3,5,7,9,12,15,17,20,23,26,28,30,32,34,36,37,38,39,39,40,40,40,41,41,41,41,41,41
E01023336,EV motorcycles,Number,0,1,2,3,5,6,8,10,11,13,15,17,18,20,21,22,23,24,25,25,26,26,26,27,27,27,27,27,27,27
E01023337,EV motorcycles,Number,0,1,2,3,4,5,7,9,10,12,13,15,16,18,19,20,21,22,22,23,23,23,23,24,24,24,24,24,24,24
E01023338,EV motorcycles,Number,0,1,2,4,5,7,9,11,14,16,18,20,22,24,25,27,28,29,30,30,31,31,31,32,32,32,32,32,32,32
E01023339,EV motorcycles,Number,0,0,1,1,2,3,4,5,5,6,7,8,9,10,10,11,11,12,12,12,12,13,13,13,13,13,13,13,13,13
E01023340,EV motorcycles,Number,0,1,2,3,4,5,7,8,10,11,13,14,16,17,18,19,20,21,21,22,22,22,23,23,23,23,23,23,23,23
E01023341,EV motorcycles,Number,1,2,3,6,9,12,15,18,22,26,29,32,36,38,41,43,45,47,48,49,50,50,51,51,51,52,52,52,52,52
E01023342,EV motorcycles,Number,0,1,2,3,4,5,7,8,10,11,13,14,16,17,18,19,20,21,21,22,22,22,23,23,23,23,23,23,23,23
E01023343,EV motorcycles,Number,1,1,3,4,7,9,11,14,16,19,22,24,27,29,31,32,34,35,36,37,37,38,38,38,39,39,39,39,39,39
E01023344,EV motorcycles,Number,0,1,1,2,3,4,5,6,7,8,9,10,11,12,13,13,14,14,15,15,15,16,16,16,16,16,16,16,16,16
E01023345,EV motorcycles,Number,0,1,2,4,6,8,10,12,14,17,19,21,23,25,27,28,30,31,31,32,33,33,33,33,34,34,34,34,34,34
E01023346,EV motorcycles,Number,1,2,3,5,8,10,13,16,19,23,26,29,31,34,36,38,40,41,43,43,44,45,45,45,46,46,46,46,46,46
E01023347,EV motorcycles,Number,0,1,2,3,5,7,9,11,13,15,17,19,21,22,24,25,26,27,28,28,29,29,29,30,30,30,30,30,30,30
E01023348,EV motorcycles,Number,0,1,1,2,3,4,6,7,8,10,11,12,14,15,16,17,17,18,18,19,19,19,20,20,20,20,20,20,20,20
E01023349,EV motorcycles,Number,1,2,3,5,8,11,14,17,20,24,27,30,33,35,38,40,42,43,44,45,46,47,47,47,48,48,48,48,48,48
E01023350,EV motorcycles,Number,0,1,1,2,4,5,6,8,9,11,12,14,15,16,17,18,19,20,20,21,21,21,22,22,22,22,22,22,22,22
E01023351,EV motorcycles,Number,1,2,3,5,7,10,12,15,18,21,24,27,29,32,34,36,37,39,40,41,41,42,42,42,43,43,43,43,43,43
E01023352,EV motorcycles,Number,1,3,5,8,12,16,20,25,30,34,39,44,48,52,55,58,61,63,65,66,67,68,69,69,69,70,70,70,70,70
E01023354,EV motorcycles,Number,1,2,4,6,10,13,16,20,24,28,32,35,39,42,45,47,50,51,53,54,55,55,56,56,56,57,57,57,57,57
E01023355,EV motorcycles,Number,0,1,1,2,4,5,6,8,9,11,12,14,15,16,17,18,19,20,20,21,21,21,22,22,22,22,22,22,22,22
E01023356,EV motorcycles,Number,0,1,2,3,4,5,7,8,10,11,13,14,16,17,18,19,20,21,21,22,22,22,23,23,23,23,23,23,23,23
E01023357,EV motorcycles,Number,0,1,2,3,5,6,8,10,11,13,15,17,18,20,21,22,23,24,25,25,26,26,26,27,27,27,27,27,27,27
E01023358,EV motorcycles,Number,0,1,2,3,4,6,8,9,11,13,15,16,18,19,20,22,23,23,24,25,25,25,25,26,26,26,26,26,26,26
E01023359,EV motorcycles,Number,1,1,2,4,6,8,11,13,16,18,21,23,25,27,29,31,32,33,34,35,35,36,36,36,37,37,37,37,37,37
E01023360,EV motorcycles,Number,0,1,2,3,5,7,9,11,13,15,17,19,21,22,24,25,26,27,28,28,29,29,29,30,30,30,30,30,30,30
E01023361,EV motorcycles,Number,0,1,2,3,5,6,8,10,11,13,15,17,18,20,21,22,23,24,25,25,26,26,26,27,27,27,27,27,27,27
E01023362,EV motorcycles,Number,0,1,1,2,4,5,6,8,9,11,12,14,15,16,17,18,19,20,20,21,21,21,22,22,22,22,22,22,22,22
E01023363,EV motorcycles,Number,1,2,3,5,7,10,13,16,19,22,25,27,30,33,35,37,38,40,41,42,42,43,43,43,44,44,44,44,44,44
E01023364,EV motorcycles,Number,0,1,1,2,4,5,6,8,9,11,12,14,15,16,17,18,19,20,20,21,21,21,22,22,22,22,22,22,22,22
E01023365,EV motorcycles,Number,0,1,1,2,3,4,5,7,8,9,11,12,13,14,15,16,17,17,18,18,18,18,19,19,19,19,19,19,19,19
E01023366,EV motorcycles,Number,0,1,2,3,4,5,7,8,10,11,13,14,16,17,18,19,20,21,21,22,22,22,23,23,23,23,23,23,23,23
E01023367,EV motorcycles,Number,0,1,1,2,3,4,6,7,8,10,11,12,14,15,16,17,17,18,18,19,19,19,20,20,20,20,20,20,20,20
E01023368,EV motorcycles,Number,0,1,1,2,3,4,5,6,7,8,9,10,11,12,13,13,14,14,15,15,15,16,16,16,16,16,16,16,16,16
E01023369,EV motorcycles,Number,0,1,2,3,5,7,8,10,12,14,16,18,20,21,23,24,25,26,27,27,28,28,28,29,29,29,29,29,29,29
E01023370,EV motorcycles,Number,0,1,2,3,4,5,7,8,10,11,13,14,16,17,18,19,20,21,21,22,22,22,23,23,23,23,23,23,23,23
E01023371,EV motorcycles,Number,1,1,3,4,7,9,11,14,16,19,22,24,27,29,31,32,34,35,36,37,37,38,38,38,39,39,39,39,39,39
E01023372,EV motorcycles,Number,0,1,2,3,4,5,7,9,10,12,13,15,16,18,19,20,21,22,22,23,23,23,23,24,24,24,24,24,24,24
E01023373,EV motorcycles,Number,0,1,2,3,4,6,8,9,11,13,15,16,18,19,20,22,23,23,24,25,25,25,25,26,26,26,26,26,26,26
E01023374,EV motorcycles,Number,1,1,2,4,6,8,11,13,16,18,21,23,25,27,29,31,32,33,34,35,35,36,36,36,37,37,37,37,37,37
E01023375,EV motorcycles,Number,1,1,2,4,6,8,10,13,15,18,20,22,25,27,28,30,31,32,33,34,35,35,35,35,36,36,36,36,36,36
E01023376,EV motorcycles,Number,0,1,1,2,4,5,6,7,9,10,12,13,14,16,17,17,18,19,19,20,20,20,21,21,21,21,21,21,21,21
E01023377,EV motorcycles,Number,0,1,2,3,5,7,8,10,12,14,16,18,20,21,23,24,25,26,27,27,28,28,28,29,29,29,29,29,29,29
E01023378,EV motorcycles,Number,1,2,3,6,9,12,15,18,22,26,29,32,36,38,41,43,45,47,48,49,50,50,51,51,51,52,52,52,52,52
E01023379,EV motorcycles,Number,0,1,2,3,5,6,8,10,12,14,16,17,19,21,22,23,24,25,26,26,27,27,27,28,28,28,28,28,28,28
E01023380,EV motorcycles,Number,0,1,1,2,3,4,5,7,8,9,11,12,13,14,15,16,17,17,18,18,18,18,19,19,19,19,19,19,19,19
E01023381,EV motorcycles,Number,0,1,1,2,3,4,5,6,8,9,10,11,12,13,14,15,16,16,17,17,17,17,18,18,18,18,18,18,18,18
E01023382,EV motorcycles,Number,0,1,1,2,3,4,6,7,8,10,11,12,14,15,16,17,17,18,18,19,19,19,20,20,20,20,20,20,20,20
E01023383,EV motorcycles,Number,1,2,3,5,8,10,13,16,19,23,26,29,31,34,36,38,40,41,43,43,44,45,45,45,46,46,46,46,46,46
E01023384,EV motorcycles,Number,0,1,2,3,5,6,8,10,12,14,16,17,19,21,22,23,24,25,26,26,27,27,27,28,28,28,28,28,28,28
E01023385,EV motorcycles,Number,1,1,2,4,6,8,10,13,15,18,20,22,25,27,28,30,31,32,33,34,35,35,35,35,36,36,36,36,36,36
E01023386,EV motorcycles,Number,0,1,2,3,4,6,7,9,11,12,14,16,17,18,20,21,22,22,23,24,24,24,24,25,25,25,25,25,25,25
E01023387,EV motorcycles,Number,0,1,2,3,5,6,8,10,12,14,16,17,19,21,22,23,24,25,26,26,27,27,27,28,28,28,28,28,28,28
E01023388,EV motorcycles,Number,1,1,3,5,7,9,12,15,17,20,23,26,28,30,32,34,36,37,38,39,39,40,40,40,41,41,41,41,41,41
E01023389,EV motorcycles,Number,0,1,2,3,4,6,8,9,11,13,15,16,18,19,20,22,23,23,24,25,25,25,25,26,26,26,26,26,26,26
E01023390,EV motorcycles,Number,1,1,3,4,7,9,12,14,17,20,22,25,27,30,32,33,35,36,37,38,38,39,39,39,40,40,40,40,40,40
E01023391,EV motorcycles,Number,0,1,2,3,5,6,8,10,11,13,15,17,18,20,21,22,23,24,25,25,26,26,26,27,27,27,27,27,27,27
E01023392,EV motorcycles,Number,0,1,2,4,6,7,10,12,14,16,18,21,23,24,26,27,29,30,31,31,32,32,32,33,33,33,33,33,33,33
E01023393,EV motorcycles,Number,0,1,2,3,5,7,9,11,13,15,17,19,21,22,24,25,26,27,28,28,29,29,29,30,30,30,30,30,30,30
E01023394,EV motorcycles,Number,0,1,2,3,5,6,8,10,12,14,16,17,19,21,22,23,24,25,26,26,27,27,27,28,28,28,28,28,28,28
E01023395,EV motorcycles,Number,0,1,2,3,4,6,8,9,11,13,15,16,18,19,20,22,23,23,24,25,25,25,25,26,26,26,26,26,26,26
E01023396,EV motorcycles,Number,0,1,2,4,6,7,10,12,14,16,18,21,23,24,26,27,29,30,31,31,32,32,32,33,33,33,33,33,33,33
E01023397,EV motorcycles,Number,0,1,2,3,4,5,7,8,10,11,13,14,16,17,18,19,20,21,21,22,22,22,23,23,23,23,23,23,23,23
E01023398,EV motorcycles,Number,1,2,4,7,11,14,18,22,27,31,35,39,43,47,50,52,55,57,58,59,60,61,62,62,62,63,63,63,63,63
E01023399,EV motorcycles,Number,0,1,2,3,5,7,8,10,12,14,16,18,20,21,23,24,25,26,27,27,28,28,28,29,29,29,29,29,29,29
E01023400,EV motorcycles,Number,0,1,2,3,4,6,8,9,11,13,15,16,18,19,20,22,23,23,24,25,25,25,25,26,26,26,26,26,26,26
E01023401,EV motorcycles,Number,0,1,2,3,4,5,7,9,10,12,13,15,16,18,19,20,21,22,22,23,23,23,23,24,24,24,24,24,24,24
E01023402,EV motorcycles,Number,1,2,3,5,7,10,12,15,18,21,24,27,29,32,34,36,37,39,40,41,41,42,42,42,43,43,43,43,43,43
E01023403,EV motorcycles,Number,0,1,2,3,4,5,7,9,10,12,13,15,16,18,19,20,21,22,22,23,23,23,23,24,24,24,24,24,24,24
E01023404,EV motorcycles,Number,0,1,1,2,3,4,5,7,8,9,11,12,13,14,15,16,17,17,18,18,18,18,19,19,19,19,19,19,19,19
E01023405,EV motorcycles,Number,0,1,1,2,3,4,5,7,8,9,11,12,13,14,15,16,17,17,18,18,18,18,19,19,19,19,19,19,19,19
E01023406,EV motorcycles,Number,1,2,3,5,7,10,13,16,19,22,25,27,30,33,35,37,38,40,41,42,42,43,43,43,44,44,44,44,44,44
E01023407,EV motorcycles,Number,1,2,3,6,9,12,15,18,22,26,29,32,36,38,41,43,45,47,48,49,50,50,51,51,51,52,52,52,52,52
E01023408,EV motorcycles,Number,0,1,2,4,6,8,10,12,14,17,19,21,23,25,27,28,30,31,31,32,33,33,33,33,34,34,34,34,34,34
E01023409,EV motorcycles,Number,0,1,2,3,4,5,7,9,10,12,13,15,16,18,19,20,21,22,22,23,23,23,23,24,24,24,24,24,24,24
E01023410,EV motorcycles,Number,0,1,2,3,4,5,7,9,10,12,13,15,16,18,19,20,21,22,22,23,23,23,23,24,24,24,24,24,24,24
E01023411,EV motorcycles,Number,0,1,2,3,5,6,8,10,11,13,15,17,18,20,21,22,23,24,25,25,26,26,26,27,27,27,27,27,27,27
E01023412,EV motorcycles,Number,0,1,2,4,6,7,10,12,14,16,18,21,23,24,26,27,29,30,31,31,32,32,32,33,33,33,33,33,33,33
E01023413,EV motorcycles,Number,0,1,2,3,4,6,8,9,11,13,15,16,18,19,20,22,23,23,24,25,25,25,25,26,26,26,26,26,26,26
E01023414,EV motorcycles,Number,1,2,3,6,9,11,15,18,22,25,29,32,35,38,40,42,44,46,47,48,49,49,50,50,50,51,51,51,51,51
E01023415,EV motorcycles,Number,0,1,2,3,5,7,8,10,12,14,16,18,20,21,23,24,25,26,27,27,28,28,28,29,29,29,29,29,29,29
E01023416,EV motorcycles,Number,0,1,2,3,4,6,8,9,11,13,15,16,18,19,20,22,23,23,24,25,25,25,25,26,26,26,26,26,26,26
E01023417,EV motorcycles,Number,0,1,2,3,5,7,8,10,12,14,16,18,20,21,23,24,25,26,27,27,28,28,28,29,29,29,29,29,29,29
E01023418,EV motorcycles,Number,0,1,2,3,4,5,7,8,10,11,13,14,16,17,18,19,20,21,21,22,22,22,23,23,23,23,23,23,23,23
E01023419,EV motorcycles,Number,1,2,4,7,10,14,18,22,26,30,34,38,42,45,48,51,53,55,56,58,58,59,60,60,60,61,61,61,61,61
E01023420,EV motorcycles,Number,0,1,2,3,5,7,9,11,13,15,17,19,21,22,24,25,26,27,28,28,29,29,29,30,30,30,30,30,30,30
E01023421,EV motorcycles,Number,0,1,2,3,4,5,7,9,10,12,13,15,16,18,19,20,21,22,22,23,23,23,23,24,24,24,24,24,24,24
E01023422,EV motorcycles,Number,0,1,2,3,4,5,7,9,10,12,13,15,16,18,19,20,21,22,22,23,23,23,23,24,24,24,24,24,24,24
E01023423,EV motorcycles,Number,0,1,1,2,3,4,6,7,8,10,11,12,14,15,16,17,17,18,18,19,19,19,20,20,20,20,20,20,20,20
E01023424,EV motorcycles,Number,1,2,3,5,7,10,12,15,18,21,24,27,29,32,34,36,37,39,40,41,41,42,42,42,43,43,43,43,43,43
E01023425,EV motorcycles,Number,0,1,2,3,5,7,9,11,13,15,17,19,21,22,24,25,26,27,28,28,29,29,29,30,30,30,30,30,30,30
E01023426,EV motorcycles,Number,1,2,3,5,8,10,13,16,19,22,25,28,31,33,35,37,39,40,42,42,43,44,44,44,45,45,45,45,45,45
E01023427,EV motorcycles,Number,0,1,2,4,5,7,9,11,14,16,18,20,22,24,25,27,28,29,30,30,31,31,31,32,32,32,32,32,32,32
E01023428,EV motorcycles,Number,0,1,2,3,5,7,9,11,13,15,17,19,21,22,24,25,26,27,28,28,29,29,29,30,30,30,30,30,30,30
E01023429,EV motorcycles,Number,0,1,2,3,4,5,7,8,10,11,13,14,16,17,18,19,20,21,21,22,22,22,23,23,23,23,23,23,23,23
E01023430,EV motorcycles,Number,0,1,2,3,5,6,8,10,11,13,15,17,18,20,21,22,23,24,25,25,26,26,26,27,27,27,27,27,27,27
E01023431,EV motorcycles,Number,1,2,3,5,8,10,13,16,19,22,25,28,31,33,35,37,39,40,42,42,43,44,44,44,45,45,45,45,45,45
E01023432,EV motorcycles,Number,1,1,2,4,6,9,11,13,16,19,21,24,26,28,30,32,33,34,35,36,36,37,37,37,38,38,38,38,38,38
E01023433,EV motorcycles,Number,1,1,2,4,6,8,11,13,16,18,21,23,25,27,29,31,32,33,34,35,35,36,36,36,37,37,37,37,37,37
E01023434,EV motorcycles,Number,0,1,2,3,5,7,9,11,13,15,17,19,21,22,24,25,26,27,28,28,29,29,29,30,30,30,30,30,30,30
E01023435,EV motorcycles,Number,0,1,1,2,3,4,5,7,8,9,11,12,13,14,15,16,17,17,18,18,18,18,19,19,19,19,19,19,19,19
E01023436,EV motorcycles,Number,0,1,2,3,5,7,8,10,12,14,16,18,20,21,23,24,25,26,27,27,28,28,28,29,29,29,29,29,29,29
E01023437,EV motorcycles,Number,0,1,2,3,5,6,8,10,11,13,15,17,18,20,21,22,23,24,25,25,26,26,26,27,27,27,27,27,27,27
E01023438,EV motorcycles,Number,0,1,2,3,4,6,7,9,11,12,14,16,17,18,20,21,22,22,23,24,24,24,24,25,25,25,25,25,25,25
E01023439,EV motorcycles,Number,0,1,2,3,5,7,9,11,13,15,17,19,21,22,24,25,26,27,28,28,29,29,29,30,30,30,30,30,30,30
E01023440,EV motorcycles,Number,0,1,2,3,5,7,9,11,13,15,17,19,21,22,24,25,26,27,28,28,29,29,29,30,30,30,30,30,30,30
E01023441,EV motorcycles,Number,0,1,1,2,3,3,4,5,6,7,8,9,10,11,12,12,13,13,14,14,14,15,15,15,15,15,15,15,15,15
E01023442,EV motorcycles,Number,0,1,2,3,4,6,7,9,11,12,14,16,17,18,20,21,22,22,23,24,24,24,24,25,25,25,25,25,25,25
E01023443,EV motorcycles,Number,0,1,1,2,3,4,5,7,8,9,11,12,13,14,15,16,17,17,18,18,18,18,19,19,19,19,19,19,19,19
E01023444,EV motorcycles,Number,0,1,2,3,5,7,9,11,13,15,17,19,21,23,24,26,27,28,29,29,30,30,30,31,31,31,31,31,31,31
E01023445,EV motorcycles,Number,1,2,3,5,8,11,14,17,20,23,26,29,32,35,37,39,41,42,43,44,45,46,46,46,47,47,47,47,47,47
E01023446,EV motorcycles,Number,0,1,1,2,3,3,4,5,6,7,8,9,10,11,12,12,13,13,14,14,14,15,15,15,15,15,15,15,15,15
E01023447,EV motorcycles,Number,0,1,1,2,3,4,6,7,8,10,11,12,14,15,16,17,17,18,18,19,19,19,20,20,20,20,20,20,20,20
E01023448,EV motorcycles,Number,0,1,1,2,4,5,6,8,9,11,12,14,15,16,17,18,19,20,20,21,21,21,22,22,22,22,22,22,22,22
E01023449,EV motorcycles,Number,0,1,2,3,5,6,8,10,12,14,16,17,19,21,22,23,24,25,26,26,27,27,27,28,28,28,28,28,28,28
E01023450,EV motorcycles,Number,1,2,3,5,7,9,12,15,18,21,24,26,29,31,33,35,36,38,39,40,40,41,41,41,42,42,42,42,42,42
E01023451,EV motorcycles,Number,0,1,2,3,5,7,9,11,13,15,17,19,21,22,24,25,26,27,28,28,29,29,29,30,30,30,30,30,30,30
E01023452,EV motorcycles,Number,0,1,1,2,3,4,6,7,8,10,11,12,14,15,16,17,17,18,18,19,19,19,20,20,20,20,20,20,20,20
E01023453,EV motorcycles,Number,0,1,2,3,5,7,9,11,13,15,17,19,21,22,24,25,26,27,28,28,29,29,29,30,30,30,30,30,30,30
E01023454,EV motorcycles,Number,1,1,3,5,7,9,12,15,17,20,23,26,28,30,32,34,36,37,38,39,39,40,40,40,41,41,41,41,41,41
E01023455,EV motorcycles,Number,0,1,1,2,3,4,5,6,8,9,10,11,12,13,14,15,16,16,17,17,17,17,18,18,18,18,18,18,18,18
E01023456,EV motorcycles,Number,0,1,1,2,4,5,6,8,9,11,12,14,15,16,17,18,19,20,20,21,21,21,22,22,22,22,22,22,22,22
E01023457,EV motorcycles,Number,0,1,2,3,4,6,7,9,11,12,14,16,17,18,20,21,22,22,23,24,24,24,24,25,25,25,25,25,25,25
E01023458,EV motorcycles,Number,0,1,2,3,4,5,7,9,10,12,13,15,16,18,19,20,21,22,22,23,23,23,23,24,24,24,24,24,24,24
E01023459,EV motorcycles,Number,0,1,1,2,3,4,5,6,7,8,10,11,12,13,13,14,15,15,16,16,16,16,17,17,17,17,17,17,17,17
E01023460,EV motorcycles,Number,0,1,2,3,5,7,9,11,13,15,17,19,21,23,24,26,27,28,29,29,30,30,30,31,31,31,31,31,31,31
E01023461,EV motorcycles,Number,1,1,3,4,7,9,12,14,17,20,22,25,27,30,32,33,35,36,37,38,38,39,39,39,40,40,40,40,40,40
E01023462,EV motorcycles,Number,1,2,3,5,8,10,13,16,19,23,26,29,31,34,36,38,40,41,43,43,44,45,45,45,46,46,46,46,46,46
E01023463,EV motorcycles,Number,0,1,2,4,5,7,9,11,14,16,18,20,22,24,25,27,28,29,30,30,31,31,31,32,32,32,32,32,32,32
E01023464,EV motorcycles,Number,1,3,6,10,15,21,27,33,39,45,51,57,63,68,73,77,80,83,85,87,88,89,90,91,91,91,92,92,92,92
E01023465,EV motorcycles,Number,1,2,4,6,10,13,17,21,25,29,32,36,40,43,46,48,50,52,54,55,56,56,57,57,57,58,58,58,58,58
E01023466,EV motorcycles,Number,1,2,3,5,8,11,14,17,20,23,26,29,32,35,37,39,41,42,43,44,45,46,46,46,47,47,47,47,47,47
E01023467,EV motorcycles,Number,2,5,9,14,22,29,38,47,55,64,73,82,90,97,103,109,114,118,121,124,126,127,128,129,130,130,131,131,131,131
E01023468,EV motorcycles,Number,0,1,2,3,5,7,9,11,13,15,17,19,21,22,24,25,26,27,28,28,29,29,29,30,30,30,30,30,30,30
E01023469,EV motorcycles,Number,0,1,1,2,3,4,6,7,8,10,11,12,14,15,16,17,17,18,18,19,19,19,20,20,20,20,20,20,20,20
E01023470,EV motorcycles,Number,0,1,2,3,5,6,8,10,12,14,16,17,19,21,22,23,24,25,26,26,27,27,27,28,28,28,28,28,28,28
E01023471,EV motorcycles,Number,1,1,2,4,6,9,11,13,16,19,21,24,26,28,30,32,33,34,35,36,36,37,37,37,38,38,38,38,38,38
E01023472,EV motorcycles,Number,0,1,2,3,4,6,7,9,11,12,14,16,17,18,20,21,22,22,23,24,24,24,24,25,25,25,25,25,25,25
E01023473,EV motorcycles,Number,1,1,2,4,6,8,10,12,15,17,20,22,24,26,28,29,30,31,32,33,34,34,34,34,35,35,35,35,35,35
E01023474,EV motorcycles,Number,0,1,2,3,5,6,8,10,12,14,16,17,19,21,22,23,24,25,26,26,27,27,27,28,28,28,28,28,28,28
E01023475,EV motorcycles,Number,0,1,2,3,4,5,7,8,10,11,13,14,16,17,18,19,20,21,21,22,22,22,23,23,23,23,23,23,23,23
E01023476,EV motorcycles,Number,0,1,2,3,4,5,7,9,10,12,13,15,16,18,19,20,21,22,22,23,23,23,23,24,24,24,24,24,24,24
E01023477,EV motorcycles,Number,1,2,3,6,9,11,15,18,22,25,29,32,35,38,40,42,44,46,47,48,49,49,50,50,50,51,51,51,51,51
E01023478,EV motorcycles,Number,1,1,3,5,7,9,12,15,17,20,23,26,28,30,32,34,36,37,38,39,39,40,40,40,41,41,41,41,41,41
E01023479,EV motorcycles,Number,0,1,2,4,6,7,10,12,14,16,18,21,23,24,26,27,29,30,31,31,32,32,32,33,33,33,33,33,33,33
E01023480,EV motorcycles,Number,0,1,2,3,5,7,9,11,13,15,17,19,21,22,24,25,26,27,28,28,29,29,29,30,30,30,30,30,30,30
E01023481,EV motorcycles,Number,0,1,2,4,5,7,9,11,14,16,18,20,22,24,25,27,28,29,30,30,31,31,31,32,32,32,32,32,32,32
E01023482,EV motorcycles,Number,0,1,2,3,5,6,8,10,11,13,15,17,18,20,21,22,23,24,25,25,26,26,26,27,27,27,27,27,27,27
E01023483,EV motorcycles,Number,0,1,2,3,5,7,9,11,13,15,17,19,21,23,24,26,27,28,29,29,30,30,30,31,31,31,31,31,31,31
E01023484,EV motorcycles,Number,0,1,2,3,4,5,7,8,10,11,13,14,16,17,18,19,20,21,21,22,22,22,23,23,23,23,23,23,23,23
E01023485,EV motorcycles,Number,1,3,6,10,15,20,26,32,38,44,50,55,61,66,70,74,77,80,82,84,85,86,87,88,88,88,89,89,89,89
E01023486,EV motorcycles,Number,1,2,4,6,9,13,16,20,24,28,31,35,38,41,44,47,49,50,52,53,54,54,55,55,55,56,56,56,56,56
E01023487,EV motorcycles,Number,0,1,2,4,5,7,9,11,14,16,18,20,22,24,25,27,28,29,30,30,31,31,31,32,32,32,32,32,32,32
E01023488,EV motorcycles,Number,1,2,3,5,8,10,13,16,19,22,25,28,31,33,35,37,39,40,42,42,43,44,44,44,45,45,45,45,45,45
E01023489,EV motorcycles,Number,0,1,1,2,3,4,5,6,8,9,10,11,12,13,14,15,16,16,17,17,17,17,18,18,18,18,18,18,18,18
E01023490,EV motorcycles,Number,0,1,2,3,4,6,8,9,11,13,15,16,18,19,20,22,23,23,24,25,25,25,25,26,26,26,26,26,26,26
E01023491,EV motorcycles,Number,1,2,3,5,8,10,13,16,19,22,25,28,31,33,35,37,39,40,42,42,43,44,44,44,45,45,45,45,45,45
E01023492,EV motorcycles,Number,1,2,4,6,10,13,17,21,25,29,32,36,40,43,46,48,50,52,54,55,56,56,57,57,57,58,58,58,58,58
E01023493,EV motorcycles,Number,1,3,5,8,13,17,22,27,33,38,43,48,53,57,61,64,67,69,71,73,74,75,75,76,76,76,77,77,77,77
E01023494,EV motorcycles,Number,1,2,4,7,11,14,18,22,27,31,35,39,43,47,50,52,55,57,58,59,60,61,62,62,62,63,63,63,63,63
E01023495,EV motorcycles,Number,1,2,4,7,10,13,17,21,25,29,33,37,40,44,47,49,51,53,55,56,57,57,58,58,58,59,59,59,59,59
E01023496,EV motorcycles,Number,1,2,3,5,8,10,13,16,19,23,26,29,31,34,36,38,40,41,43,43,44,45,45,45,46,46,46,46,46,46
E01023497,EV motorcycles,Number,0,1,2,4,6,7,10,12,14,16,18,21,23,24,26,27,29,30,31,31,32,32,32,33,33,33,33,33,33,33
E01023498,EV motorcycles,Number,1,3,5,8,12,16,20,25,30,34,39,44,48,52,55,58,61,63,65,66,67,68,69,69,69,70,70,70,70,70
E01023499,EV motorcycles,Number,1,2,3,5,7,9,12,15,18,21,24,26,29,31,33,35,36,38,39,40,40,41,41,41,42,42,42,42,42,42
E01023500,EV motorcycles,Number,1,2,3,6,9,12,15,18,22,26,29,32,36,38,41,43,45,47,48,49,50,50,51,51,51,52,52,52,52,52
E01023501,EV motorcycles,Number,0,1,2,3,4,6,8,9,11,13,15,16,18,19,20,22,23,23,24,25,25,25,25,26,26,26,26,26,26,26
E01023502,EV motorcycles,Number,1,2,3,5,8,11,14,17,21,24,27,31,33,36,39,41,43,44,45,46,47,48,48,48,48,49,49,49,49,49
E01023503,EV motorcycles,Number,0,1,1,2,2,3,4,5,6,7,8,9,10,10,11,12,12,13,13,13,13,14,14,14,14,14,14,14,14,14
E01023504,EV motorcycles,Number,0,1,2,4,6,8,10,12,14,17,19,21,23,25,27,28,30,31,31,32,33,33,33,33,34,34,34,34,34,34
E01023505,EV motorcycles,Number,0,1,2,3,4,6,8,9,11,13,15,16,18,19,20,22,23,23,24,25,25,25,25,26,26,26,26,26,26,26
E01023506,EV motorcycles,Number,1,2,3,5,8,11,14,17,20,24,27,30,33,35,38,40,42,43,44,45,46,47,47,47,48,48,48,48,48,48
E01023507,EV motorcycles,Number,1,2,3,6,9,12,15,19,22,26,30,33,36,39,42,44,46,48,49,50,51,51,52,52,52,53,53,53,53,53
E01023508,EV motorcycles,Number,1,2,4,7,10,14,18,22,26,30,35,39,42,46,49,52,54,56,57,59,59,60,61,61,61,62,62,62,62,62
E01023509,EV motorcycles,Number,1,2,3,5,7,10,12,15,18,21,24,27,29,32,34,36,37,39,40,41,41,42,42,42,43,43,43,43,43,43
E01023510,EV motorcycles,Number,1,1,2,4,6,8,11,13,16,18,21,23,25,27,29,31,32,33,34,35,35,36,36,36,37,37,37,37,37,37
E01023511,EV motorcycles,Number,0,1,1,2,3,3,4,5,6,7,8,9,10,11,12,12,13,13,14,14,14,15,15,15,15,15,15,15,15,15
E01023512,EV motorcycles,Number,1,2,3,5,8,11,14,17,20,24,27,30,33,35,38,40,42,43,44,45,46,47,47,47,48,48,48,48,48,48
E01023513,EV motorcycles,Number,0,1,2,3,4,5,7,8,10,11,13,14,16,17,18,19,20,21,21,22,22,22,23,23,23,23,23,23,23,23
E01023514,EV motorcycles,Number,0,1,2,3,4,5,7,8,10,11,13,14,16,17,18,19,20,21,21,22,22,22,23,23,23,23,23,23,23,23
E01023515,EV motorcycles,Number,0,1,1,2,3,4,5,6,8,9,10,11,12,13,14,15,16,16,17,17,17,17,18,18,18,18,18,18,18,18
E01023516,EV motorcycles,Number,1,1,3,4,7,9,11,14,16,19,22,24,27,29,31,32,34,35,36,37,37,38,38,38,39,39,39,39,39,39
E01023517,EV motorcycles,Number,0,1,2,3,5,7,9,11,13,15,17,19,21,22,24,25,26,27,28,28,29,29,29,30,30,30,30,30,30,30
E01023518,EV motorcycles,Number,1,2,4,6,10,13,16,20,24,28,32,35,39,42,45,47,50,51,53,54,55,55,56,56,56,57,57,57,57,57
E01023519,EV motorcycles,Number,1,1,3,4,7,9,11,14,16,19,22,24,27,29,31,32,34,35,36,37,37,38,38,38,39,39,39,39,39,39
E01023520,EV motorcycles,Number,1,1,2,4,6,8,10,12,15,17,20,22,24,26,28,29,30,31,32,33,34,34,34,34,35,35,35,35,35,35
E01023523,EV motorcycles,Number,0,1,1,2,3,4,6,7,8,10,11,12,14,15,16,17,17,18,18,19,19,19,20,20,20,20,20,20,20,20
E01023524,EV motorcycles,Number,0,1,1,2,3,4,5,6,7,8,10,11,12,13,13,14,15,15,16,16,16,16,17,17,17,17,17,17,17,17
E01023525,EV motorcycles,Number,0,1,2,3,5,6,8,10,11,13,15,17,18,20,21,22,23,24,25,25,26,26,26,27,27,27,27,27,27,27
E01023526,EV motorcycles,Number,0,1,1,2,3,3,4,5,6,7,8,9,10,11,12,12,13,13,14,14,14,15,15,15,15,15,15,15,15,15
E01023527,EV motorcycles,Number,0,1,1,2,4,5,6,8,9,11,12,14,15,16,17,18,19,20,20,21,21,21,22,22,22,22,22,22,22,22
E01023528,EV motorcycles,Number,0,1,2,3,4,5,7,9,10,12,13,15,16,18,19,20,21,22,22,23,23,23,23,24,24,24,24,24,24,24
E01023529,EV motorcycles,Number,0,1,2,3,4,5,7,9,10,12,13,15,16,18,19,20,21,22,22,23,23,23,23,24,24,24,24,24,24,24
E01023530,EV motorcycles,Number,0,0,1,1,2,3,4,5,5,6,7,8,9,10,10,11,11,12,12,12,12,13,13,13,13,13,13,13,13,13
E01023531,EV motorcycles,Number,0,1,2,4,6,7,10,12,14,16,18,21,23,24,26,27,29,30,31,31,32,32,32,33,33,33,33,33,33,33
E01023532,EV motorcycles,Number,0,1,1,2,3,3,4,5,6,7,8,9,10,11,12,12,13,13,14,14,14,15,15,15,15,15,15,15,15,15
E01023533,EV motorcycles,Number,0,1,2,3,4,6,8,9,11,13,15,16,18,19,20,22,23,23,24,25,25,25,25,26,26,26,26,26,26,26
E01023534,EV motorcycles,Number,0,1,2,3,5,7,9,11,13,15,17,19,21,22,24,25,26,27,28,28,29,29,29,30,30,30,30,30,30,30
E01023535,EV motorcycles,Number,0,1,2,3,5,6,8,10,12,14,16,17,19,21,22,23,24,25,26,26,27,27,27,28,28,28,28,28,28,28
E01023536,EV motorcycles,Number,0,1,1,2,3,4,5,7,8,9,11,12,13,14,15,16,17,17,18,18,18,18,19,19,19,19,19,19,19,19
E01023537,EV motorcycles,Number,1,1,2,4,6,9,11,13,16,19,21,24,26,28,30,32,33,34,35,36,36,37,37,37,38,38,38,38,38,38
E01023538,EV motorcycles,Number,0,1,2,4,6,7,10,12,14,16,18,21,23,24,26,27,29,30,31,31,32,32,32,33,33,33,33,33,33,33
E01023539,EV motorcycles,Number,1,2,3,5,8,10,13,16,19,23,26,29,31,34,36,38,40,41,43,43,44,45,45,45,46,46,46,46,46,46
E01023540,EV motorcycles,Number,0,1,1,2,3,4,5,6,7,8,10,11,12,13,13,14,15,15,16,16,16,16,17,17,17,17,17,17,17,17
E01023541,EV motorcycles,Number,0,1,2,3,5,7,9,11,13,15,17,19,21,23,24,26,27,28,29,29,30,30,30,31,31,31,31,31,31,31
E01023542,EV motorcycles,Number,0,1,1,2,3,4,5,6,7,8,9,10,11,12,13,13,14,14,15,15,15,16,16,16,16,16,16,16,16,16
E01023543,EV motorcycles,Number,2,4,7,12,19,25,32,39,47,55,62,69,76,82,88,92,96,100,103,105,106,108,109,109,110,110,111,111,111,111
E01023544,EV motorcycles,Number,0,1,1,2,4,5,6,7,9,10,12,13,14,16,17,17,18,19,19,20,20,20,21,21,21,21,21,21,21,21
E01023545,EV motorcycles,Number,0,1,1,2,4,5,6,8,9,11,12,14,15,16,17,18,19,20,20,21,21,21,22,22,22,22,22,22,22,22
E01023546,EV motorcycles,Number,1,2,3,5,8,11,14,17,21,24,27,31,33,36,39,41,43,44,45,46,47,48,48,48,48,49,49,49,49,49
E01023547,EV motorcycles,Number,0,1,2,3,5,7,8,10,12,14,16,18,20,21,23,24,25,26,27,27,28,28,28,29,29,29,29,29,29,29
E01023548,EV motorcycles,Number,0,1,1,2,3,4,5,6,7,8,9,10,11,12,13,13,14,14,15,15,15,16,16,16,16,16,16,16,16,16
E01023549,EV motorcycles,Number,0,1,1,2,3,4,5,6,7,8,10,11,12,13,13,14,15,15,16,16,16,16,17,17,17,17,17,17,17,17
E01023550,EV motorcycles,Number,0,1,1,2,3,4,5,6,7,8,9,10,11,12,13,13,14,14,15,15,15,16,16,16,16,16,16,16,16,16
E01023551,EV motorcycles,Number,0,1,1,2,3,4,5,6,7,8,10,11,12,13,13,14,15,15,16,16,16,16,17,17,17,17,17,17,17,17
E01023552,EV motorcycles,Number,0,1,2,3,4,5,7,8,10,11,13,14,16,17,18,19,20,21,21,22,22,22,23,23,23,23,23,23,23,23
E01023553,EV motorcycles,Number,0,1,2,4,5,7,9,11,14,16,18,20,22,24,25,27,28,29,30,30,31,31,31,32,32,32,32,32,32,32
E01023554,EV motorcycles,Number,0,1,1,2,3,4,5,6,7,8,10,11,12,13,13,14,15,15,16,16,16,16,17,17,17,17,17,17,17,17
E01023555,EV motorcycles,Number,1,2,3,5,8,11,14,17,21,24,27,31,33,36,39,41,43,44,45,46,47,48,48,48,48,49,49,49,49,49
E01023556,EV motorcycles,Number,0,1,2,3,4,6,7,9,11,12,14,16,17,18,20,21,22,22,23,24,24,24,24,25,25,25,25,25,25,25
E01023557,EV motorcycles,Number,0,1,1,2,3,4,6,7,8,10,11,12,14,15,16,17,17,18,18,19,19,19,20,20,20,20,20,20,20,20
E01023558,EV motorcycles,Number,0,1,1,2,3,4,5,7,8,9,11,12,13,14,15,16,17,17,18,18,18,18,19,19,19,19,19,19,19,19
E01023559,EV motorcycles,Number,0,1,2,3,5,6,8,10,12,14,16,17,19,21,22,23,24,25,26,26,27,27,27,28,28,28,28,28,28,28
E01023560,EV motorcycles,Number,0,1,1,2,4,5,6,8,9,11,12,14,15,16,17,18,19,20,20,21,21,21,22,22,22,22,22,22,22,22
E01023561,EV motorcycles,Number,0,1,2,3,5,6,8,10,12,14,16,17,19,21,22,23,24,25,26,26,27,27,27,28,28,28,28,28,28,28
E01023562,EV motorcycles,Number,0,1,2,3,5,7,9,11,13,15,17,19,21,22,24,25,26,27,28,28,29,29,29,30,30,30,30,30,30,30
E01023563,EV motorcycles,Number,0,1,1,2,4,5,6,8,9,11,12,14,15,16,17,18,19,20,20,21,21,21,22,22,22,22,22,22,22,22
E01023564,EV motorcycles,Number,0,1,2,3,5,6,8,10,11,13,15,17,18,20,21,22,23,24,25,25,26,26,26,27,27,27,27,27,27,27
E01023565,EV motorcycles,Number,0,0,1,1,2,3,3,4,5,6,7,7,8,9,9,10,10,11,11,11,12,12,12,12,12,12,12,12,12,12
E01023566,EV motorcycles,Number,0,0,1,1,1,2,2,3,3,4,4,5,5,6,6,7,7,7,7,8,8,8,8,8,8,8,8,8,8,8
E01023567,EV motorcycles,Number,1,2,3,5,8,10,13,16,19,22,25,28,31,33,35,37,39,40,42,42,43,44,44,44,45,45,45,45,45,45
E01023568,EV motorcycles,Number,0,1,2,3,5,7,8,10,12,14,16,18,20,21,23,24,25,26,27,27,28,28,28,29,29,29,29,29,29,29
E01023569,EV motorcycles,Number,0,1,2,3,5,6,8,10,11,13,15,17,18,20,21,22,23,24,25,25,26,26,26,27,27,27,27,27,27,27
E01023570,EV motorcycles,Number,1,1,2,4,6,8,10,12,15,17,20,22,24,26,28,29,30,31,32,33,34,34,34,34,35,35,35,35,35,35
E01023571,EV motorcycles,Number,0,0,1,1,2,3,3,4,5,6,7,7,8,9,9,10,10,11,11,11,12,12,12,12,12,12,12,12,12,12
E01023572,EV motorcycles,Number,0,1,2,3,5,6,8,10,12,14,16,17,19,21,22,23,24,25,26,26,27,27,27,28,28,28,28,28,28,28
E01023573,EV motorcycles,Number,0,1,1,2,3,3,4,5,6,7,8,9,10,11,12,12,13,13,14,14,14,15,15,15,15,15,15,15,15,15
E01023574,EV motorcycles,Number,0,1,2,4,5,7,9,11,14,16,18,20,22,24,25,27,28,29,30,30,31,31,31,32,32,32,32,32,32,32
E01023575,EV motorcycles,Number,1,1,3,5,7,9,12,15,17,20,23,26,28,30,32,34,36,37,38,39,39,40,40,40,41,41,41,41,41,41
E01023576,EV motorcycles,Number,0,1,2,3,4,5,7,9,10,12,13,15,16,18,19,20,21,22,22,23,23,23,23,24,24,24,24,24,24,24
E01023577,EV motorcycles,Number,0,1,2,3,5,6,8,10,11,13,15,17,18,20,21,22,23,24,25,25,26,26,26,27,27,27,27,27,27,27
E01023578,EV motorcycles,Number,0,1,2,3,5,6,8,10,11,13,15,17,18,20,21,22,23,24,25,25,26,26,26,27,27,27,27,27,27,27
E01023579,EV motorcycles,Number,0,1,1,2,3,4,5,6,7,8,10,11,12,13,13,14,15,15,16,16,16,16,17,17,17,17,17,17,17,17
E01023580,EV motorcycles,Number,0,1,1,2,3,4,5,6,8,9,10,11,12,13,14,15,16,16,17,17,17,17,18,18,18,18,18,18,18,18
E01023581,EV motorcycles,Number,0,1,1,2,3,4,6,7,8,10,11,12,14,15,16,17,17,18,18,19,19,19,20,20,20,20,20,20,20,20
E01023582,EV motorcycles,Number,0,1,2,3,4,6,8,9,11,13,15,16,18,19,20,22,23,23,24,25,25,25,25,26,26,26,26,26,26,26
E01023583,EV motorcycles,Number,1,1,2,4,6,8,10,12,15,17,20,22,24,26,28,29,30,31,32,33,34,34,34,34,35,35,35,35,35,35
E01023584,EV motorcycles,Number,0,1,2,3,4,5,7,8,10,11,13,14,16,17,18,19,20,21,21,22,22,22,23,23,23,23,23,23,23,23
E01023585,EV motorcycles,Number,1,1,2,4,6,8,11,13,16,18,21,23,25,27,29,31,32,33,34,35,35,36,36,36,37,37,37,37,37,37
E01023586,EV motorcycles,Number,1,1,2,4,6,8,10,12,15,17,20,22,24,26,28,29,30,31,32,33,34,34,34,34,35,35,35,35,35,35
E01023587,EV motorcycles,Number,0,1,2,3,5,6,8,10,12,14,16,17,19,21,22,23,24,25,26,26,27,27,27,28,28,28,28,28,28,28
E01023588,EV motorcycles,Number,0,1,2,3,4,5,7,8,10,11,13,14,16,17,18,19,20,21,21,22,22,22,23,23,23,23,23,23,23,23
E01023589,EV motorcycles,Number,1,1,2,4,6,9,11,13,16,19,21,24,26,28,30,32,33,34,35,36,36,37,37,37,38,38,38,38,38,38
E01023590,EV motorcycles,Number,0,1,2,3,5,7,9,11,13,15,17,19,21,23,24,26,27,28,29,29,30,30,30,31,31,31,31,31,31,31
E01023591,EV motorcycles,Number,1,2,3,6,9,12,15,19,22,26,30,33,36,39,42,44,46,48,49,50,51,51,52,52,52,53,53,53,53,53
E01023592,EV motorcycles,Number,0,1,2,3,5,7,8,10,12,14,16,18,20,21,23,24,25,26,27,27,28,28,28,29,29,29,29,29,29,29
E01023593,EV motorcycles,Number,1,1,3,4,7,9,11,14,16,19,22,24,27,29,31,32,34,35,36,37,37,38,38,38,39,39,39,39,39,39
E01023594,EV motorcycles,Number,1,2,4,7,11,14,18,22,27,31,35,39,43,47,50,52,55,57,58,59,60,61,62,62,62,63,63,63,63,63
E01023595,EV motorcycles,Number,1,2,3,5,7,10,12,15,18,21,24,27,29,32,34,36,37,39,40,41,41,42,42,42,43,43,43,43,43,43
E01023596,EV motorcycles,Number,0,1,2,3,5,7,8,10,12,14,16,18,20,21,23,24,25,26,27,27,28,28,28,29,29,29,29,29,29,29
E01023597,EV motorcycles,Number,1,2,3,5,7,9,12,15,18,21,24,26,29,31,33,35,36,38,39,40,40,41,41,41,42,42,42,42,42,42
E01023598,EV motorcycles,Number,1,1,3,5,7,9,12,15,17,20,23,26,28,30,32,34,36,37,38,39,39,40,40,40,41,41,41,41,41,41
E01023600,EV motorcycles,Number,1,2,3,5,8,11,14,17,20,24,27,30,33,35,38,40,42,43,44,45,46,47,47,47,48,48,48,48,48,48
E01023601,EV motorcycles,Number,0,1,2,3,5,7,9,11,13,15,17,19,21,22,24,25,26,27,28,28,29,29,29,30,30,30,30,30,30,30
E01023602,EV motorcycles,Number,0,1,1,2,3,4,5,6,7,8,9,10,11,12,13,13,14,14,15,15,15,16,16,16,16,16,16,16,16,16
E01023603,EV motorcycles,Number,0,1,2,3,4,5,7,9,10,12,13,15,16,18,19,20,21,22,22,23,23,23,23,24,24,24,24,24,24,24
E01023604,EV motorcycles,Number,0,1,2,3,4,6,8,9,11,13,15,16,18,19,20,22,23,23,24,25,25,25,25,26,26,26,26,26,26,26
E01023605,EV motorcycles,Number,0,1,2,3,4,5,7,8,10,11,13,14,16,17,18,19,20,21,21,22,22,22,23,23,23,23,23,23,23,23
E01023606,EV motorcycles,Number,0,1,2,4,5,7,9,11,14,16,18,20,22,24,25,27,28,29,30,30,31,31,31,32,32,32,32,32,32,32
E01023607,EV motorcycles,Number,0,0,1,1,2,3,4,5,5,6,7,8,9,10,10,11,11,12,12,12,12,13,13,13,13,13,13,13,13,13
E01023608,EV motorcycles,Number,0,1,2,3,5,7,9,11,13,15,17,19,21,23,24,26,27,28,29,29,30,30,30,31,31,31,31,31,31,31
E01023609,EV motorcycles,Number,0,1,1,2,3,4,5,6,8,9,10,11,12,13,14,15,16,16,17,17,17,17,18,18,18,18,18,18,18,18
E01023610,EV motorcycles,Number,0,0,1,1,2,3,3,4,5,6,7,7,8,9,9,10,10,11,11,11,12,12,12,12,12,12,12,12,12,12
E01023611,EV motorcycles,Number,0,1,2,3,5,7,8,10,12,14,16,18,20,21,23,24,25,26,27,27,28,28,28,29,29,29,29,29,29,29
E01023612,EV motorcycles,Number,1,1,2,4,6,9,11,13,16,19,21,24,26,28,30,32,33,34,35,36,36,37,37,37,38,38,38,38,38,38
E01023613,EV motorcycles,Number,0,1,1,2,3,3,4,5,6,7,8,9,10,11,12,12,13,13,14,14,14,15,15,15,15,15,15,15,15,15
E01023614,EV motorcycles,Number,1,2,4,6,9,12,16,19,23,27,30,34,37,40,43,45,47,49,50,51,52,52,53,53,53,54,54,54,54,54
E01023615,EV motorcycles,Number,0,1,2,3,5,7,9,11,13,15,17,19,21,22,24,25,26,27,28,28,29,29,29,30,30,30,30,30,30,30
E01023616,EV motorcycles,Number,0,1,2,3,4,5,7,8,10,11,13,14,16,17,18,19,20,21,21,22,22,22,23,23,23,23,23,23,23,23
E01023617,EV motorcycles,Number,0,1,2,3,5,6,8,10,11,13,15,17,18,20,21,22,23,24,25,25,26,26,26,27,27,27,27,27,27,27
E01023618,EV motorcycles,Number,0,1,2,3,4,6,8,9,11,13,15,16,18,19,20,22,23,23,24,25,25,25,25,26,26,26,26,26,26,26
E01023619,EV motorcycles,Number,0,1,1,2,4,5,6,8,9,11,12,14,15,16,17,18,19,20,20,21,21,21,22,22,22,22,22,22,22,22
E01023620,EV motorcycles,Number,0,1,2,4,5,7,9,11,14,16,18,20,22,24,25,27,28,29,30,30,31,31,31,32,32,32,32,32,32,32
E01023621,EV motorcycles,Number,0,1,1,2,3,4,6,7,8,10,11,12,14,15,16,17,17,18,18,19,19,19,20,20,20,20,20,20,20,20
E01023622,EV motorcycles,Number,1,2,3,6,9,11,15,18,22,25,29,32,35,38,40,42,44,46,47,48,49,49,50,50,50,51,51,51,51,51
E01023623,EV motorcycles,Number,0,1,2,4,6,7,10,12,14,16,18,21,23,24,26,27,29,30,31,31,32,32,32,33,33,33,33,33,33,33
E01023624,EV motorcycles,Number,0,1,2,4,6,7,10,12,14,16,18,21,23,24,26,27,29,30,31,31,32,32,32,33,33,33,33,33,33,33
E01023625,EV motorcycles,Number,1,1,2,4,6,8,10,13,15,18,20,22,25,27,28,30,31,32,33,34,35,35,35,35,36,36,36,36,36,36
E01023626,EV motorcycles,Number,1,3,6,9,14,19,25,30,36,42,48,53,58,63,67,71,74,76,79,80,82,82,83,84,84,84,85,85,85,85
E01023627,EV motorcycles,Number,1,2,3,5,8,10,13,16,19,23,26,29,31,34,36,38,40,41,43,43,44,45,45,45,46,46,46,46,46,46
E01023628,EV motorcycles,Number,1,2,3,5,7,10,13,16,19,22,25,27,30,33,35,37,38,40,41,42,42,43,43,43,44,44,44,44,44,44
E01023629,EV motorcycles,Number,1,1,2,4,6,8,10,12,15,17,20,22,24,26,28,29,30,31,32,33,34,34,34,34,35,35,35,35,35,35
E01023630,EV motorcycles,Number,0,1,2,3,5,7,8,10,12,14,16,18,20,21,23,24,25,26,27,27,28,28,28,29,29,29,29,29,29,29
E01023631,EV motorcycles,Number,1,1,2,4,6,8,11,13,16,18,21,23,25,27,29,31,32,33,34,35,35,36,36,36,37,37,37,37,37,37
E01023632,EV motorcycles,Number,1,2,3,5,7,10,12,15,18,21,24,27,29,32,34,36,37,39,40,41,41,42,42,42,43,43,43,43,43,43
E01023633,EV motorcycles,Number,1,2,4,7,10,13,17,21,25,30,34,37,41,44,47,50,52,54,55,57,58,58,59,59,59,60,60,60,60,60
E01023634,EV motorcycles,Number,1,2,4,7,10,14,18,22,26,30,35,39,42,46,49,52,54,56,57,59,59,60,61,61,61,62,62,62,62,62
E01023635,EV motorcycles,Number,0,1,2,3,5,7,9,11,13,15,17,19,21,23,24,26,27,28,29,29,30,30,30,31,31,31,31,31,31,31
E01023636,EV motorcycles,Number,1,2,3,6,8,11,14,18,21,25,28,31,34,37,39,42,43,45,46,47,48,49,49,49,49,50,50,50,50,50
E01023637,EV motorcycles,Number,0,1,2,3,5,6,8,10,12,14,16,17,19,21,22,23,24,25,26,26,27,27,27,28,28,28,28,28,28,28
E01023638,EV motorcycles,Number,1,1,2,4,6,8,11,13,16,18,21,23,25,27,29,31,32,33,34,35,35,36,36,36,37,37,37,37,37,37
E01023639,EV motorcycles,Number,0,1,2,4,6,7,10,12,14,16,18,21,23,24,26,27,29,30,31,31,32,32,32,33,33,33,33,33,33,33
E01023640,EV motorcycles,Number,0,1,2,3,4,5,7,8,10,11,13,14,16,17,18,19,20,21,21,22,22,22,23,23,23,23,23,23,23,23
E01023641,EV motorcycles,Number,0,1,1,2,3,4,5,6,7,8,10,11,12,13,13,14,15,15,16,16,16,16,17,17,17,17,17,17,17,17
E01023642,EV motorcycles,Number,0,1,1,2,4,5,6,8,9,11,12,14,15,16,17,18,19,20,20,21,21,21,22,22,22,22,22,22,22,22
E01023643,EV motorcycles,Number,1,2,3,6,8,11,14,18,21,25,28,31,34,37,39,42,43,45,46,47,48,49,49,49,49,50,50,50,50,50
E01023644,EV motorcycles,Number,0,1,2,3,4,5,7,8,10,11,13,14,16,17,18,19,20,21,21,22,22,22,23,23,23,23,23,23,23,23
E01023645,EV motorcycles,Number,1,1,3,4,7,9,11,14,16,19,22,24,27,29,31,32,34,35,36,37,37,38,38,38,39,39,39,39,39,39
E01023646,EV motorcycles,Number,0,1,1,2,3,3,4,5,6,7,8,9,10,11,12,12,13,13,14,14,14,15,15,15,15,15,15,15,15,15
E01023647,EV motorcycles,Number,1,2,3,5,7,10,12,15,18,21,24,27,29,32,34,36,37,39,40,41,41,42,42,42,43,43,43,43,43,43
E01023648,EV motorcycles,Number,0,1,2,3,4,5,7,8,10,11,13,14,16,17,18,19,20,21,21,22,22,22,23,23,23,23,23,23,23,23
E01023649,EV motorcycles,Number,0,1,1,2,3,3,4,5,6,7,8,9,10,11,12,12,13,13,14,14,14,15,15,15,15,15,15,15,15,15
E01023650,EV motorcycles,Number,1,1,3,5,7,9,12,15,17,20,23,26,28,30,32,34,36,37,38,39,39,40,40,40,41,41,41,41,41,41
E01023651,EV motorcycles,Number,0,1,2,3,4,6,7,9,11,12,14,16,17,18,20,21,22,22,23,24,24,24,24,25,25,25,25,25,25,25
E01023652,EV motorcycles,Number,0,1,2,3,4,6,8,9,11,13,15,16,18,19,20,22,23,23,24,25,25,25,25,26,26,26,26,26,26,26
E01023653,EV motorcycles,Number,1,3,5,8,12,16,21,26,31,36,41,45,50,54,58,61,63,66,67,69,70,71,71,72,72,72,73,73,73,73
E01023654,EV motorcycles,Number,1,1,3,4,7,9,11,14,16,19,22,24,27,29,31,32,34,35,36,37,37,38,38,38,39,39,39,39,39,39
E01023655,EV motorcycles,Number,1,1,2,4,6,8,10,12,15,17,20,22,24,26,28,29,30,31,32,33,34,34,34,34,35,35,35,35,35,35
E01023656,EV motorcycles,Number,1,2,3,6,9,12,15,18,22,26,29,32,36,38,41,43,45,47,48,49,50,50,51,51,51,52,52,52,52,52
E01023657,EV motorcycles,Number,1,3,5,9,14,18,24,29,35,40,46,51,56,61,65,68,71,74,76,77,79,80,80,81,81,81,82,82,82,82
E01023658,EV motorcycles,Number,1,1,2,4,6,8,10,12,15,17,20,22,24,26,28,29,30,31,32,33,34,34,34,34,35,35,35,35,35,35
E01023659,EV motorcycles,Number,0,1,2,3,5,7,9,11,13,15,17,19,21,22,24,25,26,27,28,28,29,29,29,30,30,30,30,30,30,30
E01023660,EV motorcycles,Number,1,1,2,4,6,9,11,13,16,19,21,24,26,28,30,32,33,34,35,36,36,37,37,37,38,38,38,38,38,38
E01023661,EV motorcycles,Number,0,1,1,2,4,5,6,8,9,11,12,14,15,16,17,18,19,20,20,21,21,21,22,22,22,22,22,22,22,22
E01023662,EV motorcycles,Number,1,2,3,5,8,11,14,17,21,24,27,31,33,36,39,41,43,44,45,46,47,48,48,48,48,49,49,49,49,49
E01023663,EV motorcycles,Number,1,3,6,10,15,20,26,32,38,44,50,55,61,66,70,74,77,80,82,84,85,86,87,88,88,88,89,89,89,89
E01023664,EV motorcycles,Number,0,1,2,3,5,7,9,11,13,15,17,19,21,22,24,25,26,27,28,28,29,29,29,30,30,30,30,30,30,30
E01023665,EV motorcycles,Number,0,1,1,2,4,5,6,7,9,10,12,13,14,16,17,17,18,19,19,20,20,20,21,21,21,21,21,21,21,21
E01023666,EV motorcycles,Number,0,1,2,3,4,5,7,8,10,11,13,14,16,17,18,19,20,21,21,22,22,22,23,23,23,23,23,23,23,23
E01023667,EV motorcycles,Number,0,0,1,1,2,3,4,5,5,6,7,8,9,10,10,11,11,12,12,12,12,13,13,13,13,13,13,13,13,13
E01023668,EV motorcycles,Number,0,0,1,1,2,2,3,3,4,4,5,6,6,7,7,7,8,8,8,8,9,9,9,9,9,9,9,9,9,9
E01023669,EV motorcycles,Number,0,1,2,3,4,5,7,8,10,11,13,14,16,17,18,19,20,21,21,22,22,22,23,23,23,23,23,23,23,23
E01023670,EV motorcycles,Number,0,1,2,3,5,6,8,10,12,14,16,17,19,21,22,23,24,25,26,26,27,27,27,28,28,28,28,28,28,28
E01023671,EV motorcycles,Number,0,1,2,3,5,7,9,11,13,15,17,19,21,22,24,25,26,27,28,28,29,29,29,30,30,30,30,30,30,30
E01023672,EV motorcycles,Number,0,1,1,2,3,4,5,7,8,9,11,12,13,14,15,16,17,17,18,18,18,18,19,19,19,19,19,19,19,19
E01023673,EV motorcycles,Number,1,2,3,5,7,10,13,16,19,22,25,27,30,33,35,37,38,40,41,42,42,43,43,43,44,44,44,44,44,44
E01023674,EV motorcycles,Number,0,0,1,1,2,3,3,4,5,6,7,7,8,9,9,10,10,11,11,11,12,12,12,12,12,12,12,12,12,12
E01023675,EV motorcycles,Number,0,1,2,3,4,5,7,8,10,11,13,14,16,17,18,19,20,21,21,22,22,22,23,23,23,23,23,23,23,23
E01023676,EV motorcycles,Number,0,1,2,3,5,7,9,11,13,15,17,19,21,22,24,25,26,27,28,28,29,29,29,30,30,30,30,30,30,30
E01023677,EV motorcycles,Number,0,1,1,2,3,4,5,6,7,8,10,11,12,13,13,14,15,15,16,16,16,16,17,17,17,17,17,17,17,17
E01023678,EV motorcycles,Number,1,1,3,4,7,9,11,14,16,19,22,24,27,29,31,32,34,35,36,37,37,38,38,38,39,39,39,39,39,39
E01023679,EV motorcycles,Number,0,1,2,3,5,7,9,11,13,15,17,19,21,22,24,25,26,27,28,28,29,29,29,30,30,30,30,30,30,30
E01023680,EV motorcycles,Number,0,1,2,4,5,7,9,11,14,16,18,20,22,24,25,27,28,29,30,30,31,31,31,32,32,32,32,32,32,32
E01023681,EV motorcycles,Number,0,1,1,2,4,5,6,7,9,10,12,13,14,16,17,17,18,19,19,20,20,20,21,21,21,21,21,21,21,21
E01023682,EV motorcycles,Number,0,1,1,2,4,5,6,7,9,10,12,13,14,16,17,17,18,19,19,20,20,20,21,21,21,21,21,21,21,21
E01023683,EV motorcycles,Number,0,0,1,1,2,2,3,3,4,4,5,6,6,7,7,7,8,8,8,8,9,9,9,9,9,9,9,9,9,9
E01023684,EV motorcycles,Number,0,1,2,3,5,7,8,10,12,14,16,18,20,21,23,24,25,26,27,27,28,28,28,29,29,29,29,29,29,29
E01023685,EV motorcycles,Number,0,1,1,2,4,5,6,8,9,11,12,14,15,16,17,18,19,20,20,21,21,21,22,22,22,22,22,22,22,22
E01023686,EV motorcycles,Number,0,1,2,3,4,5,7,9,10,12,13,15,16,18,19,20,21,22,22,23,23,23,23,24,24,24,24,24,24,24
E01023687,EV motorcycles,Number,0,1,2,3,4,5,7,9,10,12,13,15,16,18,19,20,21,22,22,23,23,23,23,24,24,24,24,24,24,24
E01023688,EV motorcycles,Number,0,1,2,3,4,5,7,9,10,12,13,15,16,18,19,20,21,22,22,23,23,23,23,24,24,24,24,24,24,24
E01023689,EV motorcycles,Number,0,1,1,2,3,3,4,5,6,7,8,9,10,11,12,12,13,13,14,14,14,15,15,15,15,15,15,15,15,15
E01023690,EV motorcycles,Number,0,1,1,2,3,4,6,7,8,10,11,12,14,15,16,17,17,18,18,19,19,19,20,20,20,20,20,20,20,20
E01023691,EV motorcycles,Number,0,1,1,2,3,4,5,6,8,9,10,11,12,13,14,15,16,16,17,17,17,17,18,18,18,18,18,18,18,18
E01023692,EV motorcycles,Number,0,1,1,2,3,4,6,7,8,10,11,12,14,15,16,17,17,18,18,19,19,19,20,20,20,20,20,20,20,20
E01023693,EV motorcycles,Number,0,1,2,3,5,6,8,10,11,13,15,17,18,20,21,22,23,24,25,25,26,26,26,27,27,27,27,27,27,27
E01023694,EV motorcycles,Number,0,1,2,3,5,6,8,10,11,13,15,17,18,20,21,22,23,24,25,25,26,26,26,27,27,27,27,27,27,27
E01023695,EV motorcycles,Number,1,1,2,4,6,8,10,13,15,18,20,22,25,27,28,30,31,32,33,34,35,35,35,35,36,36,36,36,36,36
E01023696,EV motorcycles,Number,0,1,2,3,4,6,8,9,11,13,15,16,18,19,20,22,23,23,24,25,25,25,25,26,26,26,26,26,26,26
E01023697,EV motorcycles,Number,0,1,2,3,5,7,9,11,13,15,17,19,21,23,24,26,27,28,29,29,30,30,30,31,31,31,31,31,31,31
E01023698,EV motorcycles,Number,1,1,2,4,6,8,10,13,15,18,20,22,25,27,28,30,31,32,33,34,35,35,35,35,36,36,36,36,36,36
E01023699,EV motorcycles,Number,0,1,1,2,4,5,6,8,9,11,12,14,15,16,17,18,19,20,20,21,21,21,22,22,22,22,22,22,22,22
E01023700,EV motorcycles,Number,0,1,1,2,3,4,5,6,7,8,9,10,11,12,13,13,14,14,15,15,15,16,16,16,16,16,16,16,16,16
E01023701,EV motorcycles,Number,0,0,1,1,2,3,4,5,5,6,7,8,9,10,10,11,11,12,12,12,12,13,13,13,13,13,13,13,13,13
E01023702,EV motorcycles,Number,0,1,2,3,4,5,7,9,10,12,13,15,16,18,19,20,21,22,22,23,23,23,23,24,24,24,24,24,24,24
E01023703,EV motorcycles,Number,0,0,1,1,2,3,4,5,5,6,7,8,9,10,10,11,11,12,12,12,12,13,13,13,13,13,13,13,13,13
E01023704,EV motorcycles,Number,0,1,1,2,3,4,5,6,8,9,10,11,12,13,14,15,16,16,17,17,17,17,18,18,18,18,18,18,18,18
E01023705,EV motorcycles,Number,1,2,3,5,7,10,12,15,18,21,24,27,29,32,34,36,37,39,40,41,41,42,42,42,43,43,43,43,43,43
E01023706,EV motorcycles,Number,1,1,2,4,6,8,10,12,15,17,20,22,24,26,28,29,30,31,32,33,34,34,34,34,35,35,35,35,35,35
E01023708,EV motorcycles,Number,1,1,2,4,6,8,10,12,15,17,20,22,24,26,28,29,30,31,32,33,34,34,34,34,35,35,35,35,35,35
E01023709,EV motorcycles,Number,0,1,1,2,4,5,6,8,9,11,12,14,15,16,17,18,19,20,20,21,21,21,22,22,22,22,22,22,22,22
E01023710,EV motorcycles,Number,0,1,2,4,6,8,10,12,14,17,19,21,23,25,27,28,30,31,31,32,33,33,33,33,34,34,34,34,34,34
E01023711,EV motorcycles,Number,0,1,2,3,4,6,7,9,11,12,14,16,17,18,20,21,22,22,23,24,24,24,24,25,25,25,25,25,25,25
E01023712,EV motorcycles,Number,1,2,3,5,8,10,13,16,19,22,25,28,31,33,35,37,39,40,42,42,43,44,44,44,45,45,45,45,45,45
E01023713,EV motorcycles,Number,0,1,2,3,5,6,8,10,12,14,16,17,19,21,22,23,24,25,26,26,27,27,27,28,28,28,28,28,28,28
E01023714,EV motorcycles,Number,0,1,1,2,3,4,6,7,8,10,11,12,14,15,16,17,17,18,18,19,19,19,20,20,20,20,20,20,20,20
E01023715,EV motorcycles,Number,0,1,1,2,3,3,4,5,6,7,8,9,10,11,12,12,13,13,14,14,14,15,15,15,15,15,15,15,15,15
E01023716,EV motorcycles,Number,0,1,1,2,3,4,5,6,8,9,10,11,12,13,14,15,16,16,17,17,17,17,18,18,18,18,18,18,18,18
E01023717,EV motorcycles,Number,0,1,2,3,5,7,9,11,13,15,17,19,21,23,24,26,27,28,29,29,30,30,30,31,31,31,31,31,31,31
E01023718,EV motorcycles,Number,0,1,2,4,6,7,10,12,14,16,18,21,23,24,26,27,29,30,31,31,32,32,32,33,33,33,33,33,33,33
E01023719,EV motorcycles,Number,1,1,2,4,6,8,10,12,15,17,20,22,24,26,28,29,30,31,32,33,34,34,34,34,35,35,35,35,35,35
E01023720,EV motorcycles,Number,1,2,3,5,8,11,14,17,20,23,26,29,32,35,37,39,41,42,43,44,45,46,46,46,47,47,47,47,47,47
E01023721,EV motorcycles,Number,0,1,2,3,5,6,8,10,12,14,16,17,19,21,22,23,24,25,26,26,27,27,27,28,28,28,28,28,28,28
E01023722,EV motorcycles,Number,1,2,3,5,7,10,13,16,19,22,25,27,30,33,35,37,38,40,41,42,42,43,43,43,44,44,44,44,44,44
E01023723,EV motorcycles,Number,0,1,2,3,4,5,7,9,10,12,13,15,16,18,19,20,21,22,22,23,23,23,23,24,24,24,24,24,24,24
E01023724,EV motorcycles,Number,1,2,3,6,9,12,15,19,22,26,30,33,36,39,42,44,46,48,49,50,51,51,52,52,52,53,53,53,53,53
E01023725,EV motorcycles,Number,1,1,2,4,6,8,10,12,15,17,20,22,24,26,28,29,30,31,32,33,34,34,34,34,35,35,35,35,35,35
E01023726,EV motorcycles,Number,0,0,1,1,2,3,3,4,5,6,7,7,8,9,9,10,10,11,11,11,12,12,12,12,12,12,12,12,12,12
E01023727,EV motorcycles,Number,0,1,2,3,4,6,7,9,11,12,14,16,17,18,20,21,22,22,23,24,24,24,24,25,25,25,25,25,25,25
E01023728,EV motorcycles,Number,1,2,3,5,7,9,12,15,18,21,24,26,29,31,33,35,36,38,39,40,40,41,41,41,42,42,42,42,42,42
E01023729,EV motorcycles,Number,0,1,1,2,3,4,5,7,8,9,11,12,13,14,15,16,17,17,18,18,18,18,19,19,19,19,19,19,19,19
E01023730,EV motorcycles,Number,1,2,3,5,7,10,12,15,18,21,24,27,29,32,34,36,37,39,40,41,41,42,42,42,43,43,43,43,43,43
E01023731,EV motorcycles,Number,1,1,2,4,6,8,10,12,15,17,20,22,24,26,28,29,30,31,32,33,34,34,34,34,35,35,35,35,35,35
E01023732,EV motorcycles,Number,1,2,3,5,8,10,13,16,19,22,25,28,31,33,35,37,39,40,42,42,43,44,44,44,45,45,45,45,45,45
E01023733,EV motorcycles,Number,1,2,3,5,8,10,13,16,19,22,25,28,31,33,35,37,39,40,42,42,43,44,44,44,45,45,45,45,45,45
E01023734,EV motorcycles,Number,0,1,2,3,5,7,9,11,13,15,17,19,21,22,24,25,26,27,28,28,29,29,29,30,30,30,30,30,30,30
E01023735,EV motorcycles,Number,1,1,2,4,6,8,11,13,16,18,21,23,25,27,29,31,32,33,34,35,35,36,36,36,37,37,37,37,37,37
E01023736,EV motorcycles,Number,1,2,4,6,9,12,16,19,23,27,30,34,37,40,43,45,47,49,50,51,52,52,53,53,53,54,54,54,54,54
E01023737,EV motorcycles,Number,0,1,1,2,3,4,5,6,7,8,10,11,12,13,13,14,15,15,16,16,16,16,17,17,17,17,17,17,17,17
E01023738,EV motorcycles,Number,0,1,2,3,4,6,8,9,11,13,15,16,18,19,20,22,23,23,24,25,25,25,25,26,26,26,26,26,26,26
E01023739,EV motorcycles,Number,0,1,1,2,4,5,6,7,9,10,12,13,14,16,17,17,18,19,19,20,20,20,21,21,21,21,21,21,21,21
E01023740,EV motorcycles,Number,0,1,1,2,3,4,5,7,8,9,11,12,13,14,15,16,17,17,18,18,18,18,19,19,19,19,19,19,19,19
E01023741,EV motorcycles,Number,0,1,2,3,4,5,7,8,10,11,13,14,16,17,18,19,20,21,21,22,22,22,23,23,23,23,23,23,23,23
E01023742,EV motorcycles,Number,0,1,2,3,5,6,8,10,12,14,16,17,19,21,22,23,24,25,26,26,27,27,27,28,28,28,28,28,28,28
E01023743,EV motorcycles,Number,0,1,2,3,5,7,8,10,12,14,16,18,20,21,23,24,25,26,27,27,28,28,28,29,29,29,29,29,29,29
E01023744,EV motorcycles,Number,0,1,2,3,4,6,8,9,11,13,15,16,18,19,20,22,23,23,24,25,25,25,25,26,26,26,26,26,26,26
E01023745,EV motorcycles,Number,0,1,1,2,3,4,5,6,7,8,10,11,12,13,13,14,15,15,16,16,16,16,17,17,17,17,17,17,17,17
E01023746,EV motorcycles,Number,0,1,2,4,6,7,10,12,14,16,18,21,23,24,26,27,29,30,31,31,32,32,32,33,33,33,33,33,33,33
E01023747,EV motorcycles,Number,1,1,2,4,6,8,11,13,16,18,21,23,25,27,29,31,32,33,34,35,35,36,36,36,37,37,37,37,37,37
E01023748,EV motorcycles,Number,1,1,2,4,6,9,11,13,16,19,21,24,26,28,30,32,33,34,35,36,36,37,37,37,38,38,38,38,38,38
E01023749,EV motorcycles,Number,1,2,3,6,9,12,15,19,22,26,30,33,36,39,42,44,46,48,49,50,51,51,52,52,52,53,53,53,53,53
E01023750,EV motorcycles,Number,0,1,2,3,5,7,8,10,12,14,16,18,20,21,23,24,25,26,27,27,28,28,28,29,29,29,29,29,29,29
E01023751,EV motorcycles,Number,0,1,1,2,3,4,6,7,8,10,11,12,14,15,16,17,17,18,18,19,19,19,20,20,20,20,20,20,20,20
E01023752,EV motorcycles,Number,1,1,3,4,7,9,12,14,17,20,22,25,27,30,32,33,35,36,37,38,38,39,39,39,40,40,40,40,40,40
E01023753,EV motorcycles,Number,1,1,2,4,6,8,10,12,15,17,20,22,24,26,28,29,30,31,32,33,34,34,34,34,35,35,35,35,35,35
E01023754,EV motorcycles,Number,0,1,2,3,4,5,7,8,10,11,13,14,16,17,18,19,20,21,21,22,22,22,23,23,23,23,23,23,23,23
E01023755,EV motorcycles,Number,0,1,2,3,5,6,8,10,12,14,16,17,19,21,22,23,24,25,26,26,27,27,27,28,28,28,28,28,28,28
E01023756,EV motorcycles,Number,1,2,3,5,8,11,14,17,20,23,26,29,32,35,37,39,41,42,43,44,45,46,46,46,47,47,47,47,47,47
E01023757,EV motorcycles,Number,0,1,2,3,4,5,7,9,10,12,13,15,16,18,19,20,21,22,22,23,23,23,23,24,24,24,24,24,24,24
E01023758,EV motorcycles,Number,0,1,2,3,4,6,7,9,11,12,14,16,17,18,20,21,22,22,23,24,24,24,24,25,25,25,25,25,25,25
E01023759,EV motorcycles,Number,0,1,2,4,6,8,10,12,14,17,19,21,23,25,27,28,30,31,31,32,33,33,33,33,34,34,34,34,34,34
E01023760,EV motorcycles,Number,1,1,3,4,7,9,11,14,16,19,22,24,27,29,31,32,34,35,36,37,37,38,38,38,39,39,39,39,39,39
E01023761,EV motorcycles,Number,1,2,3,5,8,11,14,17,20,23,26,29,32,35,37,39,41,42,43,44,45,46,46,46,47,47,47,47,47,47
E01023762,EV motorcycles,Number,0,1,1,2,3,4,5,6,7,8,9,10,11,12,13,13,14,14,15,15,15,16,16,16,16,16,16,16,16,16
E01023763,EV motorcycles,Number,0,1,2,3,4,5,7,9,10,12,13,15,16,18,19,20,21,22,22,23,23,23,23,24,24,24,24,24,24,24
E01023764,EV motorcycles,Number,0,1,2,4,6,7,10,12,14,16,18,21,23,24,26,27,29,30,31,31,32,32,32,33,33,33,33,33,33,33
E01023765,EV motorcycles,Number,0,1,2,4,5,7,9,11,14,16,18,20,22,24,25,27,28,29,30,30,31,31,31,32,32,32,32,32,32,32
E01023766,EV motorcycles,Number,0,1,2,3,4,5,7,8,10,11,13,14,16,17,18,19,20,21,21,22,22,22,23,23,23,23,23,23,23,23
E01023767,EV motorcycles,Number,1,2,3,5,8,11,14,17,20,23,26,29,32,35,37,39,41,42,43,44,45,46,46,46,47,47,47,47,47,47
E01023768,EV motorcycles,Number,1,2,4,6,10,13,17,21,25,29,32,36,40,43,46,48,50,52,54,55,56,56,57,57,57,58,58,58,58,58
E01023769,EV motorcycles,Number,0,1,2,3,5,6,8,10,12,14,16,17,19,21,22,23,24,25,26,26,27,27,27,28,28,28,28,28,28,28
E01023770,EV motorcycles,Number,0,1,2,4,5,7,9,11,14,16,18,20,22,24,25,27,28,29,30,30,31,31,31,32,32,32,32,32,32,32
E01023771,EV motorcycles,Number,0,1,2,3,4,5,7,9,10,12,13,15,16,18,19,20,21,22,22,23,23,23,23,24,24,24,24,24,24,24
E01023772,EV motorcycles,Number,0,1,2,4,6,8,10,12,14,17,19,21,23,25,27,28,30,31,31,32,33,33,33,33,34,34,34,34,34,34
E01023773,EV motorcycles,Number,0,1,1,2,3,4,6,7,8,10,11,12,14,15,16,17,17,18,18,19,19,19,20,20,20,20,20,20,20,20
E01023774,EV motorcycles,Number,1,1,2,4,6,8,11,13,16,18,21,23,25,27,29,31,32,33,34,35,35,36,36,36,37,37,37,37,37,37
E01023775,EV motorcycles,Number,0,1,2,3,5,7,9,11,13,15,17,19,21,23,24,26,27,28,29,29,30,30,30,31,31,31,31,31,31,31
E01023776,EV motorcycles,Number,1,2,4,6,9,12,16,19,23,27,30,34,37,40,43,45,47,49,50,51,52,52,53,53,53,54,54,54,54,54
E01023777,EV motorcycles,Number,1,2,3,6,9,11,15,18,22,25,29,32,35,38,40,42,44,46,47,48,49,49,50,50,50,51,51,51,51,51
E01023778,EV motorcycles,Number,0,1,1,2,4,5,6,7,9,10,12,13,14,16,17,17,18,19,19,20,20,20,21,21,21,21,21,21,21,21
E01023779,EV motorcycles,Number,0,1,1,2,4,5,6,7,9,10,12,13,14,16,17,17,18,19,19,20,20,20,21,21,21,21,21,21,21,21
E01023780,EV motorcycles,Number,0,1,1,2,4,5,6,7,9,10,12,13,14,16,17,17,18,19,19,20,20,20,21,21,21,21,21,21,21,21
E01023781,EV motorcycles,Number,0,1,2,4,5,7,9,11,14,16,18,20,22,24,25,27,28,29,30,30,31,31,31,32,32,32,32,32,32,32
E01023782,EV motorcycles,Number,0,1,2,3,4,6,7,9,11,12,14,16,17,18,20,21,22,22,23,24,24,24,24,25,25,25,25,25,25,25
E01023783,EV motorcycles,Number,0,1,2,3,4,6,7,9,11,12,14,16,17,18,20,21,22,22,23,24,24,24,24,25,25,25,25,25,25,25
E01023784,EV motorcycles,Number,1,1,3,4,7,9,12,14,17,20,22,25,27,30,32,33,35,36,37,38,38,39,39,39,40,40,40,40,40,40
E01023785,EV motorcycles,Number,1,2,4,7,10,13,17,21,25,29,33,37,40,44,47,49,51,53,55,56,57,57,58,58,58,59,59,59,59,59
E01023786,EV motorcycles,Number,0,1,2,4,6,7,10,12,14,16,18,21,23,24,26,27,29,30,31,31,32,32,32,33,33,33,33,33,33,33
E01023787,EV motorcycles,Number,1,1,2,4,6,8,11,13,16,18,21,23,25,27,29,31,32,33,34,35,35,36,36,36,37,37,37,37,37,37
E01023788,EV motorcycles,Number,1,1,2,4,6,8,11,13,16,18,21,23,25,27,29,31,32,33,34,35,35,36,36,36,37,37,37,37,37,37
E01023789,EV motorcycles,Number,1,2,3,5,7,10,12,15,18,21,24,27,29,32,34,36,37,39,40,41,41,42,42,42,43,43,43,43,43,43
E01023790,EV motorcycles,Number,0,1,2,3,4,6,8,9,11,13,15,16,18,19,20,22,23,23,24,25,25,25,25,26,26,26,26,26,26,26
E01023791,EV motorcycles,Number,1,2,3,5,7,10,13,16,19,22,25,27,30,33,35,37,38,40,41,42,42,43,43,43,44,44,44,44,44,44
E01023792,EV motorcycles,Number,1,2,3,5,8,11,14,17,20,23,26,29,32,35,37,39,41,42,43,44,45,46,46,46,47,47,47,47,47,47
E01023793,EV motorcycles,Number,0,1,2,3,4,5,7,8,10,11,13,14,16,17,18,19,20,21,21,22,22,22,23,23,23,23,23,23,23,23
E01023794,EV motorcycles,Number,1,1,3,5,7,9,12,15,17,20,23,26,28,30,32,34,36,37,38,39,39,40,40,40,41,41,41,41,41,41
E01023795,EV motorcycles,Number,0,1,1,2,4,5,6,7,9,10,12,13,14,16,17,17,18,19,19,20,20,20,21,21,21,21,21,21,21,21
E01023796,EV motorcycles,Number,0,1,1,2,3,4,5,6,8,9,10,11,12,13,14,15,16,16,17,17,17,17,18,18,18,18,18,18,18,18
E01023797,EV motorcycles,Number,0,1,2,3,4,6,7,9,11,12,14,16,17,18,20,21,22,22,23,24,24,24,24,25,25,25,25,25,25,25
E01023798,EV motorcycles,Number,1,1,2,4,6,8,11,13,16,18,21,23,25,27,29,31,32,33,34,35,35,36,36,36,37,37,37,37,37,37
E01023799,EV motorcycles,Number,0,1,1,2,3,4,5,7,8,9,11,12,13,14,15,16,17,17,18,18,18,18,19,19,19,19,19,19,19,19
E01023800,EV motorcycles,Number,0,1,2,4,5,7,9,11,14,16,18,20,22,24,25,27,28,29,30,30,31,31,31,32,32,32,32,32,32,32
E01023801,EV motorcycles,Number,1,2,4,6,9,12,16,20,23,27,31,34,38,41,43,46,48,49,51,52,53,53,54,54,54,55,55,55,55,55
E01023802,EV motorcycles,Number,0,1,2,3,5,6,8,10,12,14,16,17,19,21,22,23,24,25,26,26,27,27,27,28,28,28,28,28,28,28
E01023803,EV motorcycles,Number,1,1,2,4,6,8,10,12,15,17,20,22,24,26,28,29,30,31,32,33,34,34,34,34,35,35,35,35,35,35
E01023804,EV motorcycles,Number,0,1,1,2,3,4,5,6,7,8,9,10,11,12,13,13,14,14,15,15,15,16,16,16,16,16,16,16,16,16
E01023805,EV motorcycles,Number,0,1,2,3,5,7,9,11,13,15,17,19,21,23,24,26,27,28,29,29,30,30,30,31,31,31,31,31,31,31
E01023806,EV motorcycles,Number,1,2,3,5,8,11,14,17,20,23,26,29,32,35,37,39,41,42,43,44,45,46,46,46,47,47,47,47,47,47
E01023807,EV motorcycles,Number,1,2,3,5,8,11,14,17,21,24,27,31,33,36,39,41,43,44,45,46,47,48,48,48,48,49,49,49,49,49
E01023808,EV motorcycles,Number,1,2,4,7,11,15,19,23,27,32,36,40,44,48,51,54,56,58,60,61,62,63,64,64,64,65,65,65,65,65
E01023809,EV motorcycles,Number,2,4,8,13,20,27,35,43,51,59,67,75,82,89,95,100,104,108,111,113,115,116,117,118,119,119,120,120,120,120
E01023810,EV motorcycles,Number,0,1,2,4,5,7,9,11,14,16,18,20,22,24,25,27,28,29,30,30,31,31,31,32,32,32,32,32,32,32
E01023811,EV motorcycles,Number,1,1,3,5,7,9,12,15,17,20,23,26,28,30,32,34,36,37,38,39,39,40,40,40,41,41,41,41,41,41
E01023812,EV motorcycles,Number,0,1,1,2,4,5,6,8,9,11,12,14,15,16,17,18,19,20,20,21,21,21,22,22,22,22,22,22,22,22
E01023813,EV motorcycles,Number,0,1,2,3,5,6,8,10,11,13,15,17,18,20,21,22,23,24,25,25,26,26,26,27,27,27,27,27,27,27
E01023814,EV motorcycles,Number,0,1,2,3,4,5,7,8,10,11,13,14,16,17,18,19,20,21,21,22,22,22,23,23,23,23,23,23,23,23
E01023815,EV motorcycles,Number,0,1,2,3,5,7,8,10,12,14,16,18,20,21,23,24,25,26,27,27,28,28,28,29,29,29,29,29,29,29
E01023816,EV motorcycles,Number,0,1,1,2,3,4,5,7,8,9,11,12,13,14,15,16,17,17,18,18,18,18,19,19,19,19,19,19,19,19
E01023817,EV motorcycles,Number,0,1,1,2,4,5,6,7,9,10,12,13,14,16,17,17,18,19,19,20,20,20,21,21,21,21,21,21,21,21
E01023818,EV motorcycles,Number,0,0,0,1,1,2,2,3,3,4,4,5,5,6,6,6,7,7,7,7,7,7,7,7,7,7,8,8,8,8
E01023819,EV motorcycles,Number,0,1,2,3,5,7,9,11,13,15,17,19,21,23,24,26,27,28,29,29,30,30,30,31,31,31,31,31,31,31
E01023820,EV motorcycles,Number,0,0,1,1,2,3,3,4,5,6,7,7,8,9,9,10,10,11,11,11,12,12,12,12,12,12,12,12,12,12
E01023821,EV motorcycles,Number,0,1,1,2,3,4,5,7,8,9,11,12,13,14,15,16,17,17,18,18,18,18,19,19,19,19,19,19,19,19
E01023822,EV motorcycles,Number,0,1,2,4,5,7,9,11,14,16,18,20,22,24,25,27,28,29,30,30,31,31,31,32,32,32,32,32,32,32
E01023823,EV motorcycles,Number,0,1,2,3,5,7,9,11,13,15,17,19,21,22,24,25,26,27,28,28,29,29,29,30,30,30,30,30,30,30
E01023824,EV motorcycles,Number,1,1,2,4,6,9,11,13,16,19,21,24,26,28,30,32,33,34,35,36,36,37,37,37,38,38,38,38,38,38
E01023825,EV motorcycles,Number,1,2,4,6,10,13,16,20,24,28,32,35,39,42,45,47,50,51,53,54,55,55,56,56,56,57,57,57,57,57
E01023826,EV motorcycles,Number,0,1,2,3,4,5,7,9,10,12,13,15,16,18,19,20,21,22,22,23,23,23,23,24,24,24,24,24,24,24
E01023827,EV motorcycles,Number,1,2,3,6,9,12,15,19,22,26,30,33,36,39,42,44,46,48,49,50,51,51,52,52,52,53,53,53,53,53
E01023828,EV motorcycles,Number,0,1,1,2,3,4,6,7,8,10,11,12,14,15,16,17,17,18,18,19,19,19,20,20,20,20,20,20,20,20
E01023829,EV motorcycles,Number,0,1,2,4,5,7,9,11,14,16,18,20,22,24,25,27,28,29,30,30,31,31,31,32,32,32,32,32,32,32
E01023830,EV motorcycles,Number,1,1,2,4,6,9,11,13,16,19,21,24,26,28,30,32,33,34,35,36,36,37,37,37,38,38,38,38,38,38
E01023831,EV motorcycles,Number,1,2,3,6,8,11,14,18,21,25,28,31,34,37,39,42,43,45,46,47,48,49,49,49,49,50,50,50,50,50
E01023832,EV motorcycles,Number,0,1,2,4,6,8,10,12,14,17,19,21,23,25,27,28,30,31,31,32,33,33,33,33,34,34,34,34,34,34
E01023833,EV motorcycles,Number,1,3,5,8,12,16,20,25,30,34,39,44,48,52,55,58,61,63,65,66,67,68,69,69,69,70,70,70,70,70
E01023834,EV motorcycles,Number,0,1,2,3,4,6,8,9,11,13,15,16,18,19,20,22,23,23,24,25,25,25,25,26,26,26,26,26,26,26
E01023835,EV motorcycles,Number,0,1,2,4,5,7,9,11,14,16,18,20,22,24,25,27,28,29,30,30,31,31,31,32,32,32,32,32,32,32
E01023836,EV motorcycles,Number,0,1,1,2,3,4,5,7,8,9,11,12,13,14,15,16,17,17,18,18,18,18,19,19,19,19,19,19,19,19
E01023837,EV motorcycles,Number,0,1,1,2,3,4,5,6,7,8,9,10,11,12,13,14,14,15,15,15,16,16,16,16,16,16,16,16,16,16
E01023838,EV motorcycles,Number,0,1,2,3,5,7,9,11,13,15,17,19,21,23,24,26,27,28,29,29,30,30,30,31,31,31,31,31,31,31
E01023839,EV motorcycles,Number,0,0,1,1,2,2,3,3,4,4,5,6,6,7,7,7,8,8,8,8,9,9,9,9,9,9,9,9,9,9
E01023840,EV motorcycles,Number,0,0,1,1,2,3,4,5,5,6,7,8,9,10,10,11,11,12,12,12,12,13,13,13,13,13,13,13,13,13
E01023841,EV motorcycles,Number,0,1,1,2,3,4,6,7,8,10,11,12,14,15,16,17,17,18,18,19,19,19,20,20,20,20,20,20,20,20
E01023842,EV motorcycles,Number,0,1,2,3,5,6,8,10,12,14,16,17,19,21,22,23,24,25,26,26,27,27,27,28,28,28,28,28,28,28
E01023843,EV motorcycles,Number,0,1,2,3,5,6,8,10,11,13,15,17,18,20,21,22,23,24,25,25,26,26,26,27,27,27,27,27,27,27
E01023844,EV motorcycles,Number,0,1,1,2,4,5,6,7,9,10,12,13,14,16,17,17,18,19,19,20,20,20,21,21,21,21,21,21,21,21
E01023845,EV motorcycles,Number,1,1,2,4,6,8,10,12,15,17,20,22,24,26,28,29,30,31,32,33,34,34,34,34,35,35,35,35,35,35
E01023846,EV motorcycles,Number,0,1,2,4,6,8,10,12,14,17,19,21,23,25,27,28,30,31,31,32,33,33,33,33,34,34,34,34,34,34
E01023847,EV motorcycles,Number,0,1,1,2,4,5,6,7,9,10,12,13,14,16,17,17,18,19,19,20,20,20,21,21,21,21,21,21,21,21
E01023848,EV motorcycles,Number,0,1,2,3,4,5,7,9,10,12,13,15,16,18,19,20,21,22,22,23,23,23,23,24,24,24,24,24,24,24
E01023849,EV motorcycles,Number,0,1,2,3,4,6,7,9,11,13,14,16,17,19,20,21,22,23,24,24,25,25,25,25,25,25,26,26,26,26
E01023850,EV motorcycles,Number,0,1,2,3,5,6,8,10,11,13,15,17,18,20,21,22,23,24,25,25,26,26,26,27,27,27,27,27,27,27
E01023851,EV motorcycles,Number,0,1,1,2,4,5,6,8,9,11,12,14,15,16,17,18,19,20,20,21,21,21,22,22,22,22,22,22,22,22
E01023852,EV motorcycles,Number,0,1,1,2,2,3,4,5,6,7,8,9,10,10,11,12,12,13,13,13,13,14,14,14,14,14,14,14,14,14
E01023853,EV motorcycles,Number,0,1,2,4,5,7,9,11,14,16,18,20,22,24,25,27,28,29,30,30,31,31,31,32,32,32,32,32,32,32
E01023854,EV motorcycles,Number,1,2,4,6,10,13,17,21,25,29,32,36,40,43,46,48,50,52,54,55,56,56,57,57,57,58,58,58,58,58
E01023855,EV motorcycles,Number,1,1,2,4,6,8,10,12,15,17,20,22,24,26,28,29,30,31,32,33,34,34,34,34,35,35,35,35,35,35
E01023856,EV motorcycles,Number,0,1,2,3,5,7,9,11,13,15,17,19,21,22,24,25,26,27,28,28,29,29,29,30,30,30,30,30,30,30
E01023857,EV motorcycles,Number,0,1,1,2,4,5,6,8,9,11,12,14,15,16,17,18,19,20,20,21,21,21,22,22,22,22,22,22,22,22
E01023858,EV motorcycles,Number,0,1,2,3,5,6,8,10,11,13,15,17,18,20,21,22,23,24,25,25,26,26,26,27,27,27,27,27,27,27
E01023859,EV motorcycles,Number,0,1,2,4,6,8,10,12,14,17,19,21,23,25,27,28,30,31,31,32,33,33,33,33,34,34,34,34,34,34
E01023860,EV motorcycles,Number,0,1,2,3,5,7,9,11,13,15,17,19,21,22,24,25,26,27,28,28,29,29,29,30,30,30,30,30,30,30
E01023861,EV motorcycles,Number,2,6,11,18,27,37,47,58,69,81,92,102,112,121,129,136,143,147,152,155,157,159,161,162,162,163,164,164,164,164
E01023862,EV motorcycles,Number,0,1,2,3,4,6,8,9,11,13,15,16,18,19,20,22,23,23,24,25,25,25,25,26,26,26,26,26,26,26
E01023863,EV motorcycles,Number,0,1,1,2,3,4,5,6,8,9,10,11,12,13,14,15,16,16,17,17,17,17,18,18,18,18,18,18,18,18
E01023864,EV motorcycles,Number,0,0,1,1,2,2,3,4,5,5,6,7,8,8,9,9,10,10,10,10,11,11,11,11,11,11,11,11,11,11
E01023865,EV motorcycles,Number,0,1,2,3,4,5,7,8,10,11,13,14,16,17,18,19,20,21,21,22,22,22,23,23,23,23,23,23,23,23
E01023866,EV motorcycles,Number,0,0,1,1,2,3,3,4,5,6,7,7,8,9,9,10,10,11,11,11,12,12,12,12,12,12,12,12,12,12
E01023867,EV motorcycles,Number,0,1,2,3,4,6,8,9,11,13,15,16,18,19,20,22,23,23,24,25,25,25,25,26,26,26,26,26,26,26
E01023868,EV motorcycles,Number,1,1,3,5,7,9,12,15,17,20,23,26,28,30,32,34,36,37,38,39,39,40,40,40,41,41,41,41,41,41
E01023869,EV motorcycles,Number,0,1,2,3,4,6,8,9,11,13,15,16,18,19,20,22,23,23,24,25,25,25,25,26,26,26,26,26,26,26
E01023870,EV motorcycles,Number,0,0,1,1,2,3,3,4,5,6,7,7,8,9,9,10,10,11,11,11,12,12,12,12,12,12,12,12,12,12
E01023871,EV motorcycles,Number,0,1,1,2,4,5,6,7,9,10,12,13,14,16,17,17,18,19,19,20,20,20,21,21,21,21,21,21,21,21
E01023872,EV motorcycles,Number,0,1,2,4,5,7,9,11,14,16,18,20,22,24,25,27,28,29,30,30,31,31,31,32,32,32,32,32,32,32
E01023873,EV motorcycles,Number,0,1,1,2,4,5,6,8,9,11,12,14,15,16,17,18,19,20,20,21,21,21,22,22,22,22,22,22,22,22
E01023874,EV motorcycles,Number,0,1,1,2,3,4,6,7,8,10,11,12,14,15,16,17,17,18,18,19,19,19,20,20,20,20,20,20,20,20
E01023875,EV motorcycles,Number,1,2,3,5,8,10,13,16,19,23,26,29,31,34,36,38,40,41,43,43,44,45,45,45,46,46,46,46,46,46
E01023876,EV motorcycles,Number,0,1,2,3,4,6,8,9,11,13,15,16,18,19,20,22,23,23,24,25,25,25,25,26,26,26,26,26,26,26
E01023877,EV motorcycles,Number,0,1,2,3,5,6,8,10,11,13,15,17,18,20,21,22,23,24,25,25,26,26,26,27,27,27,27,27,27,27
E01023878,EV motorcycles,Number,1,1,2,4,6,8,10,13,15,18,20,22,25,27,28,30,31,32,33,34,35,35,35,35,36,36,36,36,36,36
E01023879,EV motorcycles,Number,0,1,2,4,6,8,10,12,14,17,19,21,23,25,27,28,30,31,31,32,33,33,33,33,34,34,34,34,34,34
E01023880,EV motorcycles,Number,0,1,1,2,3,4,5,6,8,9,10,11,12,13,14,15,16,16,17,17,17,17,18,18,18,18,18,18,18,18
E01023881,EV motorcycles,Number,1,2,3,5,7,9,12,15,18,21,24,26,29,31,33,35,36,38,39,40,40,41,41,41,42,42,42,42,42,42
E01023882,EV motorcycles,Number,0,1,2,3,4,5,7,9,10,12,13,15,16,18,19,20,21,22,22,23,23,23,23,24,24,24,24,24,24,24
E01023883,EV motorcycles,Number,0,1,1,2,3,4,5,7,8,9,11,12,13,14,15,16,17,17,18,18,18,18,19,19,19,19,19,19,19,19
E01023884,EV motorcycles,Number,0,1,2,3,5,7,8,10,12,14,16,18,20,21,23,24,25,26,27,27,28,28,28,29,29,29,29,29,29,29
E01023885,EV motorcycles,Number,1,1,3,4,7,9,11,14,16,19,22,24,27,29,31,32,34,35,36,37,37,38,38,38,39,39,39,39,39,39
E01023886,EV motorcycles,Number,0,1,1,2,3,4,5,6,7,8,9,10,11,12,13,13,14,14,15,15,15,16,16,16,16,16,16,16,16,16
E01023887,EV motorcycles,Number,0,1,2,3,5,6,8,10,11,13,15,17,18,20,21,22,23,24,25,25,26,26,26,27,27,27,27,27,27,27
E01023888,EV motorcycles,Number,0,1,1,2,3,3,4,5,6,7,8,9,10,11,12,12,13,13,14,14,14,15,15,15,15,15,15,15,15,15
E01023889,EV motorcycles,Number,0,1,2,3,4,6,7,9,11,12,14,16,17,18,20,21,22,22,23,24,24,24,24,25,25,25,25,25,25,25
E01023890,EV motorcycles,Number,0,1,2,3,4,6,8,9,11,13,15,16,18,19,20,22,23,23,24,25,25,25,25,26,26,26,26,26,26,26
E01023891,EV motorcycles,Number,0,1,2,3,4,6,8,9,11,13,15,16,18,19,20,22,23,23,24,25,25,25,25,26,26,26,26,26,26,26
E01023892,EV motorcycles,Number,0,1,1,2,3,4,5,6,8,9,10,11,12,13,14,15,16,16,17,17,17,17,18,18,18,18,18,18,18,18
E01023893,EV motorcycles,Number,0,1,1,2,3,4,5,7,8,9,11,12,13,14,15,16,17,17,18,18,18,18,19,19,19,19,19,19,19,19
E01023894,EV motorcycles,Number,0,1,2,3,4,6,8,9,11,13,15,16,18,19,20,22,23,23,24,25,25,25,25,26,26,26,26,26,26,26
E01023895,EV motorcycles,Number,0,1,1,2,3,4,6,7,8,10,11,12,14,15,16,17,17,18,18,19,19,19,20,20,20,20,20,20,20,20
E01023896,EV motorcycles,Number,0,1,2,3,4,5,7,8,10,11,13,14,16,17,18,19,20,21,21,22,22,22,23,23,23,23,23,23,23,23
E01023897,EV motorcycles,Number,1,1,2,4,6,8,10,12,15,17,20,22,24,26,28,29,30,31,32,33,34,34,34,34,35,35,35,35,35,35
E01023898,EV motorcycles,Number,0,1,2,3,5,6,8,10,12,14,16,17,19,21,22,23,24,25,26,26,27,27,27,28,28,28,28,28,28,28
E01023899,EV motorcycles,Number,0,1,1,2,3,4,5,6,7,8,10,11,12,13,13,14,15,15,16,16,16,16,17,17,17,17,17,17,17,17
E01023900,EV motorcycles,Number,0,0,1,1,2,2,3,4,5,5,6,7,8,8,9,9,10,10,10,10,11,11,11,11,11,11,11,11,11,11
E01023901,EV motorcycles,Number,0,1,2,3,4,6,7,9,11,12,14,16,17,18,20,21,22,22,23,24,24,24,24,25,25,25,25,25,25,25
E01023902,EV motorcycles,Number,1,2,3,5,8,11,14,17,20,24,27,30,33,35,38,40,42,43,44,45,46,47,47,47,48,48,48,48,48,48
E01023903,EV motorcycles,Number,0,0,1,1,2,2,3,4,4,5,6,6,7,7,8,8,9,9,9,9,10,10,10,10,10,10,10,10,10,10
E01023904,EV motorcycles,Number,0,1,2,3,4,6,7,9,11,12,14,16,17,18,20,21,22,22,23,24,24,24,24,25,25,25,25,25,25,25
E01023905,EV motorcycles,Number,1,2,3,5,8,11,14,17,20,23,26,29,32,35,37,39,41,42,43,44,45,46,46,46,47,47,47,47,47,47
E01023906,EV motorcycles,Number,0,1,2,3,4,5,7,8,10,11,13,14,16,17,18,19,20,21,21,22,22,22,23,23,23,23,23,23,23,23
E01023907,EV motorcycles,Number,1,1,3,4,7,9,12,14,17,20,22,25,27,30,32,33,35,36,37,38,38,39,39,39,40,40,40,40,40,40
E01023908,EV motorcycles,Number,0,1,1,2,3,4,5,7,8,9,11,12,13,14,15,16,17,17,18,18,18,18,19,19,19,19,19,19,19,19
E01023909,EV motorcycles,Number,0,1,1,2,3,4,5,6,8,9,10,11,12,13,14,15,16,16,17,17,17,17,18,18,18,18,18,18,18,18
E01023910,EV motorcycles,Number,0,1,1,2,4,5,6,7,9,10,12,13,14,16,17,17,18,19,19,20,20,20,21,21,21,21,21,21,21,21
E01023911,EV motorcycles,Number,1,1,3,4,7,9,11,14,16,19,22,24,27,29,31,32,34,35,36,37,37,38,38,38,39,39,39,39,39,39
E01023912,EV motorcycles,Number,1,2,4,7,10,14,18,22,26,30,34,38,42,45,48,51,53,55,56,58,58,59,60,60,60,61,61,61,61,61
E01023913,EV motorcycles,Number,0,1,1,2,3,4,5,7,8,9,11,12,13,14,15,16,17,17,18,18,18,18,19,19,19,19,19,19,19,19
E01023914,EV motorcycles,Number,1,1,3,5,7,9,12,15,17,20,23,26,28,30,32,34,36,37,38,39,39,40,40,40,41,41,41,41,41,41
E01023915,EV motorcycles,Number,0,1,1,2,4,5,6,8,9,11,12,14,15,16,17,18,19,20,20,21,21,21,22,22,22,22,22,22,22,22
E01023916,EV motorcycles,Number,0,1,2,4,5,7,9,11,14,16,18,20,22,24,25,27,28,29,30,30,31,31,31,32,32,32,32,32,32,32
E01023917,EV motorcycles,Number,0,1,2,3,5,6,8,10,11,13,15,17,18,20,21,22,23,24,25,25,26,26,26,27,27,27,27,27,27,27
E01023918,EV motorcycles,Number,0,1,2,3,4,5,7,8,10,11,13,14,16,17,18,19,20,21,21,22,22,22,23,23,23,23,23,23,23,23
E01023919,EV motorcycles,Number,0,1,2,3,4,5,7,9,10,12,13,15,16,18,19,20,21,22,22,23,23,23,23,24,24,24,24,24,24,24
E01023920,EV motorcycles,Number,0,1,2,3,5,6,8,10,11,13,15,17,18,20,21,22,23,24,25,25,26,26,26,27,27,27,27,27,27,27
E01023921,EV motorcycles,Number,0,1,1,2,3,4,6,7,8,10,11,12,14,15,16,17,17,18,18,19,19,19,20,20,20,20,20,20,20,20
E01023922,EV motorcycles,Number,1,2,3,5,8,10,13,16,19,22,25,28,31,33,35,37,39,40,42,42,43,44,44,44,45,45,45,45,45,45
E01023923,EV motorcycles,Number,0,1,2,3,5,7,9,11,13,15,17,19,21,23,24,26,27,28,29,29,30,30,30,31,31,31,31,31,31,31
E01023924,EV motorcycles,Number,0,1,1,2,3,3,4,5,6,7,8,9,10,11,12,12,13,13,14,14,14,15,15,15,15,15,15,15,15,15
E01023925,EV motorcycles,Number,1,1,2,4,6,8,10,12,15,17,20,22,24,26,28,29,30,31,32,33,34,34,34,34,35,35,35,35,35,35
E01023926,EV motorcycles,Number,0,1,2,4,6,8,10,12,14,17,19,21,23,25,27,28,30,31,31,32,33,33,33,33,34,34,34,34,34,34
E01023927,EV motorcycles,Number,1,1,3,4,7,9,11,14,16,19,22,24,27,29,31,32,34,35,36,37,37,38,38,38,39,39,39,39,39,39
E01023929,EV motorcycles,Number,1,1,3,4,7,9,12,14,17,20,22,25,27,30,32,33,35,36,37,38,38,39,39,39,40,40,40,40,40,40
E01023930,EV motorcycles,Number,0,1,2,3,5,6,8,10,11,13,15,17,18,20,21,22,23,24,25,25,26,26,26,27,27,27,27,27,27,27
E01023932,EV motorcycles,Number,0,1,2,4,6,7,10,12,14,16,18,21,23,24,26,27,29,30,31,31,32,32,32,33,33,33,33,33,33,33
E01023933,EV motorcycles,Number,0,1,1,2,4,5,6,7,9,10,12,13,14,16,17,17,18,19,19,20,20,20,21,21,21,21,21,21,21,21
E01023934,EV motorcycles,Number,0,1,1,2,2,3,4,5,6,7,8,9,10,10,11,12,12,13,13,13,13,14,14,14,14,14,14,14,14,14
E01023935,EV motorcycles,Number,0,1,1,2,2,3,4,5,6,7,8,9,10,10,11,12,12,13,13,13,13,14,14,14,14,14,14,14,14,14
E01023936,EV motorcycles,Number,0,1,2,3,5,7,9,11,13,15,17,19,21,22,24,25,26,27,28,28,29,29,29,30,30,30,30,30,30,30
E01023937,EV motorcycles,Number,0,0,0,1,1,2,2,2,3,3,4,4,5,5,6,6,6,6,6,7,7,7,7,7,7,7,7,7,7,7
E01023938,EV motorcycles,Number,0,1,1,2,3,4,5,6,7,8,10,11,12,13,13,14,15,15,16,16,16,16,17,17,17,17,17,17,17,17
E01023939,EV motorcycles,Number,0,0,1,1,2,2,3,4,5,5,6,7,8,8,9,9,10,10,10,10,11,11,11,11,11,11,11,11,11,11
E01023940,EV motorcycles,Number,0,1,2,3,4,6,7,9,11,12,14,16,17,18,20,21,22,22,23,24,24,24,24,25,25,25,25,25,25,25
E01023941,EV motorcycles,Number,1,2,3,5,7,10,12,15,18,21,24,27,29,32,34,36,37,39,40,41,41,42,42,42,43,43,43,43,43,43
E01023942,EV motorcycles,Number,1,1,2,4,6,8,11,13,16,18,21,23,25,27,29,31,32,33,34,35,35,36,36,36,37,37,37,37,37,37
E01023943,EV motorcycles,Number,0,1,1,2,3,4,6,7,8,10,11,12,14,15,16,17,17,18,18,19,19,19,20,20,20,20,20,20,20,20
E01023944,EV motorcycles,Number,1,2,3,5,8,11,14,17,20,23,26,29,32,35,37,39,41,42,43,44,45,46,46,46,47,47,47,47,47,47
E01023945,EV motorcycles,Number,0,1,2,4,6,7,10,12,14,16,18,21,23,24,26,27,29,30,31,31,32,32,32,33,33,33,33,33,33,33
E01023946,EV motorcycles,Number,1,1,2,4,6,8,10,13,15,18,20,22,25,27,28,30,31,32,33,34,35,35,35,35,36,36,36,36,36,36
E01023947,EV motorcycles,Number,1,1,2,4,6,9,11,13,16,19,21,24,26,28,30,32,33,34,35,36,36,37,37,37,38,38,38,38,38,38
E01023948,EV motorcycles,Number,1,1,2,4,6,8,10,13,15,18,20,22,25,27,28,30,31,32,33,34,35,35,35,35,36,36,36,36,36,36
E01023949,EV motorcycles,Number,0,1,1,2,3,4,6,7,8,10,11,12,14,15,16,17,17,18,18,19,19,19,20,20,20,20,20,20,20,20
E01023950,EV motorcycles,Number,0,1,1,2,3,4,5,7,8,9,11,12,13,14,15,16,17,17,18,18,18,18,19,19,19,19,19,19,19,19
E01023951,EV motorcycles,Number,0,1,2,3,4,6,7,9,11,12,14,16,17,18,20,21,22,22,23,24,24,24,24,25,25,25,25,25,25,25
E01023952,EV motorcycles,Number,0,1,2,3,5,6,8,10,12,14,16,17,19,21,22,23,24,25,26,26,27,27,27,28,28,28,28,28,28,28
E01023953,EV motorcycles,Number,0,1,2,3,5,7,9,11,13,15,17,19,21,23,24,26,27,28,29,29,30,30,30,31,31,31,31,31,31,31
E01023954,EV motorcycles,Number,1,1,2,4,6,9,11,13,16,19,21,24,26,28,30,32,33,34,35,36,36,37,37,37,38,38,38,38,38,38
E01023955,EV motorcycles,Number,0,1,2,3,5,6,8,10,11,13,15,17,18,20,21,22,23,24,25,25,26,26,26,27,27,27,27,27,27,27
E01023956,EV motorcycles,Number,0,1,2,3,4,5,7,8,10,11,13,14,16,17,18,19,20,21,21,22,22,22,23,23,23,23,23,23,23,23
E01023957,EV motorcycles,Number,0,1,2,3,5,7,9,11,13,15,17,19,21,23,24,26,27,28,29,29,30,30,30,31,31,31,31,31,31,31
E01023958,EV motorcycles,Number,1,2,3,5,7,9,12,15,18,21,24,26,29,31,33,35,36,38,39,40,40,41,41,41,42,42,42,42,42,42
E01023959,EV motorcycles,Number,0,1,1,2,4,5,6,8,9,11,12,14,15,16,17,18,19,20,20,21,21,21,22,22,22,22,22,22,22,22
E01023960,EV motorcycles,Number,0,1,2,3,5,7,8,10,12,14,16,18,20,21,23,24,25,26,27,27,28,28,28,29,29,29,29,29,29,29
E01023961,EV motorcycles,Number,0,1,2,4,5,7,9,11,14,16,18,20,22,24,25,27,28,29,30,30,31,31,31,32,32,32,32,32,32,32
E01023962,EV motorcycles,Number,0,1,2,3,5,6,8,10,12,14,16,17,19,21,22,23,24,25,26,26,27,27,27,28,28,28,28,28,28,28
E01023963,EV motorcycles,Number,1,1,2,4,6,8,10,12,15,17,20,22,24,26,28,29,30,31,32,33,34,34,34,34,35,35,35,35,35,35
E01023964,EV motorcycles,Number,1,2,3,6,9,12,15,19,22,26,30,33,36,39,42,44,46,48,49,50,51,51,52,52,52,53,53,53,53,53
E01023965,EV motorcycles,Number,1,1,2,4,6,8,10,12,15,17,20,22,24,26,28,29,30,31,32,33,34,34,34,34,35,35,35,35,35,35
E01023966,EV motorcycles,Number,1,2,3,5,7,10,13,16,19,22,25,27,30,33,35,37,38,40,41,42,42,43,43,43,44,44,44,44,44,44
E01023967,EV motorcycles,Number,0,1,2,3,5,7,8,10,12,14,16,18,20,21,23,24,25,26,27,27,28,28,28,29,29,29,29,29,29,29
E01023968,EV motorcycles,Number,0,1,2,3,5,7,9,11,13,15,17,19,21,22,24,25,26,27,28,28,29,29,29,30,30,30,30,30,30,30
E01023969,EV motorcycles,Number,0,1,2,3,5,7,9,11,13,15,17,19,21,23,24,26,27,28,29,29,30,30,30,31,31,31,31,31,31,31
E01023970,EV motorcycles,Number,1,1,3,4,7,9,12,14,17,20,22,25,27,30,32,33,35,36,37,38,38,39,39,39,40,40,40,40,40,40
E01023971,EV motorcycles,Number,0,1,2,3,5,7,9,11,13,15,17,19,21,22,24,25,26,27,28,28,29,29,29,30,30,30,30,30,30,30
E01023972,EV motorcycles,Number,1,1,2,4,6,8,11,13,16,18,21,23,25,27,29,31,32,33,34,35,35,36,36,36,37,37,37,37,37,37
E01023973,EV motorcycles,Number,0,1,2,3,4,6,7,9,11,12,14,16,17,18,20,21,22,22,23,24,24,24,24,25,25,25,25,25,25,25
E01023974,EV motorcycles,Number,0,1,2,3,5,7,9,11,13,15,17,19,21,23,24,26,27,28,29,29,30,30,30,31,31,31,31,31,31,31
E01023975,EV motorcycles,Number,0,1,2,3,5,7,9,11,13,15,17,19,21,23,24,26,27,28,29,29,30,30,30,31,31,31,31,31,31,31
E01023976,EV motorcycles,Number,0,1,2,3,4,6,8,9,11,13,15,16,18,19,20,22,23,23,24,25,25,25,25,26,26,26,26,26,26,26
E01023977,EV motorcycles,Number,1,2,4,6,10,13,16,20,24,28,32,35,39,42,45,47,50,51,53,54,55,55,56,56,56,57,57,57,57,57
E01023978,EV motorcycles,Number,0,1,2,3,5,6,8,10,12,14,16,17,19,21,22,23,24,25,26,26,27,27,27,28,28,28,28,28,28,28
E01023979,EV motorcycles,Number,1,1,2,4,6,8,11,13,16,18,21,23,25,27,29,31,32,33,34,35,35,36,36,36,37,37,37,37,37,37
E01023980,EV motorcycles,Number,0,1,2,3,5,6,8,10,11,13,15,17,18,20,21,22,23,24,25,25,26,26,26,27,27,27,27,27,27,27
E01023981,EV motorcycles,Number,0,1,2,3,5,7,9,11,13,15,17,19,21,23,24,26,27,28,29,29,30,30,30,31,31,31,31,31,31,31
E01023983,EV motorcycles,Number,1,2,3,5,8,10,13,16,19,22,25,28,31,33,35,37,39,40,42,42,43,44,44,44,45,45,45,45,45,45
E01023984,EV motorcycles,Number,0,1,1,2,3,4,5,6,7,8,9,10,11,12,13,13,14,14,15,15,15,16,16,16,16,16,16,16,16,16
E01023985,EV motorcycles,Number,1,3,5,8,12,16,20,25,30,34,39,44,48,52,55,58,61,63,65,66,67,68,69,69,69,70,70,70,70,70
E01023986,EV motorcycles,Number,1,2,4,7,10,13,17,21,25,30,34,37,41,44,47,50,52,54,55,57,58,58,59,59,59,60,60,60,60,60
E01023987,EV motorcycles,Number,1,1,3,4,7,9,12,14,17,20,22,25,27,30,32,33,35,36,37,38,38,39,39,39,40,40,40,40,40,40
E01023988,EV motorcycles,Number,1,2,4,6,9,12,16,19,23,27,30,34,37,40,43,45,47,49,50,51,52,52,53,53,53,54,54,54,54,54
E01023989,EV motorcycles,Number,1,2,4,6,9,13,16,20,24,28,31,35,38,41,44,47,49,50,52,53,54,54,55,55,55,56,56,56,56,56
E01023990,EV motorcycles,Number,1,2,3,6,8,11,14,18,21,25,28,31,34,37,39,42,43,45,46,47,48,49,49,49,49,50,50,50,50,50
E01023992,EV motorcycles,Number,0,1,2,3,4,6,8,9,11,13,15,16,18,19,20,22,23,23,24,25,25,25,25,26,26,26,26,26,26,26
E01023993,EV motorcycles,Number,1,1,2,4,6,8,10,12,15,17,20,22,24,26,28,29,30,31,32,33,34,34,34,34,35,35,35,35,35,35
E01023995,EV motorcycles,Number,0,1,1,2,4,5,6,7,9,10,12,13,14,16,17,17,18,19,19,20,20,20,21,21,21,21,21,21,21,21
E01023996,EV motorcycles,Number,0,1,1,2,4,5,6,8,9,11,12,14,15,16,17,18,19,20,20,21,21,21,22,22,22,22,22,22,22,22
E01023997,EV motorcycles,Number,1,2,4,6,9,12,16,20,23,27,31,34,38,41,43,46,48,49,51,52,53,53,54,54,54,55,55,55,55,55
E01023998,EV motorcycles,Number,1,2,3,5,8,11,14,17,20,24,27,30,33,35,38,40,42,43,44,45,46,47,47,47,48,48,48,48,48,48
E01023999,EV motorcycles,Number,1,2,4,7,10,14,18,22,26,30,34,38,42,45,48,51,53,55,56,58,58,59,60,60,60,61,61,61,61,61
E01024001,EV motorcycles,Number,1,1,2,4,6,8,11,13,16,18,21,23,25,27,29,31,32,33,34,35,35,36,36,36,37,37,37,37,37,37
E01024002,EV motorcycles,Number,0,1,2,3,4,5,7,9,10,12,13,15,16,18,19,20,21,22,22,23,23,23,23,24,24,24,24,24,24,24
E01024003,EV motorcycles,Number,1,2,3,5,7,10,13,16,19,22,25,27,30,33,35,37,38,40,41,42,42,43,43,43,44,44,44,44,44,44
E01024004,EV motorcycles,Number,1,2,4,6,9,13,16,20,24,28,31,35,38,41,44,47,49,50,52,53,54,54,55,55,55,56,56,56,56,56
E01024005,EV motorcycles,Number,1,2,3,5,7,10,13,16,19,22,25,27,30,33,35,37,38,40,41,42,42,43,43,43,44,44,44,44,44,44
E01024006,EV motorcycles,Number,1,1,2,4,6,8,10,12,15,17,20,22,24,26,28,29,30,31,32,33,34,34,34,34,35,35,35,35,35,35
E01024008,EV motorcycles,Number,1,2,3,5,8,11,14,17,20,24,27,30,33,35,38,40,42,43,44,45,46,47,47,47,48,48,48,48,48,48
E01024009,EV motorcycles,Number,1,1,2,4,6,8,11,13,16,18,21,23,25,27,29,31,32,33,34,35,35,36,36,36,37,37,37,37,37,37
E01024010,EV motorcycles,Number,1,3,5,8,13,17,22,27,33,38,43,48,53,57,61,64,67,69,71,73,74,75,75,76,76,76,77,77,77,77
E01024011,EV motorcycles,Number,1,1,2,4,6,8,11,13,16,18,21,23,25,27,29,31,32,33,34,35,35,36,36,36,37,37,37,37,37,37
E01024012,EV motorcycles,Number,1,2,4,6,10,13,17,21,25,29,32,36,40,43,46,48,50,52,54,55,56,56,57,57,57,58,58,58,58,58
E01024013,EV motorcycles,Number,1,2,4,7,10,14,18,22,26,30,34,38,42,45,48,51,53,55,56,58,58,59,60,60,60,61,61,61,61,61
E01024014,EV motorcycles,Number,1,2,4,6,10,13,17,21,25,29,32,36,40,43,46,48,50,52,54,55,56,56,57,57,57,58,58,58,58,58
E01024015,EV motorcycles,Number,1,2,4,7,11,15,19,23,27,32,36,40,44,48,51,54,56,58,60,61,62,63,64,64,64,65,65,65,65,65
E01024016,EV motorcycles,Number,1,1,2,4,6,8,11,13,16,18,21,23,25,27,29,31,32,33,34,35,35,36,36,36,37,37,37,37,37,37
E01024017,EV motorcycles,Number,0,1,2,3,5,7,8,10,12,14,16,18,20,21,23,24,25,26,27,27,28,28,28,29,29,29,29,29,29,29
E01024019,EV motorcycles,Number,0,1,2,3,5,6,8,10,12,14,16,17,19,21,22,23,24,25,26,26,27,27,27,28,28,28,28,28,28,28
E01024020,EV motorcycles,Number,0,1,2,4,6,7,10,12,14,16,18,21,23,24,26,27,29,30,31,31,32,32,32,33,33,33,33,33,33,33
E01024021,EV motorcycles,Number,0,1,2,4,6,7,10,12,14,16,18,21,23,24,26,27,29,30,31,31,32,32,32,33,33,33,33,33,33,33
E01024022,EV motorcycles,Number,0,1,2,3,4,5,7,8,10,11,13,14,16,17,18,19,20,21,21,22,22,22,23,23,23,23,23,23,23,23
E01024023,EV motorcycles,Number,1,2,4,7,11,14,19,23,27,31,36,40,44,47,50,53,56,58,59,60,61,62,63,63,63,64,64,64,64,64
E01024024,EV motorcycles,Number,0,1,2,3,5,7,9,11,13,15,17,19,21,23,24,26,27,28,29,29,30,30,30,31,31,31,31,31,31,31
E01024025,EV motorcycles,Number,0,1,2,3,4,5,7,9,10,12,13,15,16,18,19,20,21,22,22,23,23,23,23,24,24,24,24,24,24,24
E01024026,EV motorcycles,Number,1,2,3,5,8,10,13,16,19,23,26,29,31,34,36,38,40,41,43,43,44,45,45,45,46,46,46,46,46,46
E01024027,EV motorcycles,Number,1,2,3,5,8,11,14,17,20,23,26,29,32,35,37,39,41,42,43,44,45,46,46,46,47,47,47,47,47,47
E01024028,EV motorcycles,Number,0,1,2,3,5,7,9,11,13,15,17,19,21,23,24,26,27,28,29,29,30,30,30,31,31,31,31,31,31,31
E01024029,EV motorcycles,Number,1,2,4,7,11,15,19,23,27,32,36,40,44,48,51,54,56,58,60,61,62,63,64,64,64,65,65,65,65,65
E01024031,EV motorcycles,Number,1,3,5,8,12,17,21,26,31,36,41,46,51,55,58,62,64,67,68,70,71,72,72,73,73,73,74,74,74,74
E01024032,EV motorcycles,Number,1,2,4,7,10,13,17,21,25,30,34,37,41,44,47,50,52,54,55,57,58,58,59,59,59,60,60,60,60,60
E01024033,EV motorcycles,Number,1,2,4,7,11,14,18,22,27,31,35,39,43,47,50,52,55,57,58,59,60,61,62,62,62,63,63,63,63,63
E01024034,EV motorcycles,Number,2,4,8,13,20,26,34,42,50,58,66,73,81,87,93,98,103,106,109,111,113,114,116,116,117,117,118,118,118,118
E01024035,EV motorcycles,Number,0,1,2,3,4,5,7,8,10,11,13,14,16,17,18,19,20,21,21,22,22,22,23,23,23,23,23,23,23,23
E01024036,EV motorcycles,Number,1,2,4,7,10,14,18,22,26,30,34,38,42,45,48,51,53,55,56,58,58,59,60,60,60,61,61,61,61,61
E01024037,EV motorcycles,Number,1,2,4,7,10,14,18,22,26,30,35,39,42,46,49,52,54,56,57,59,59,60,61,61,61,62,62,62,62,62
E01024038,EV motorcycles,Number,1,3,5,8,13,17,22,27,32,37,43,47,52,56,60,63,66,68,70,72,73,74,74,75,75,75,76,76,76,76
E01024039,EV motorcycles,Number,1,3,5,8,12,16,20,25,30,34,39,44,48,52,55,58,61,63,65,66,67,68,69,69,69,70,70,70,70,70
E01024040,EV motorcycles,Number,0,1,1,2,3,4,5,6,8,9,10,11,12,13,14,15,16,16,17,17,17,17,18,18,18,18,18,18,18,18
E01024041,EV motorcycles,Number,1,1,2,4,6,8,11,13,16,18,21,23,25,27,29,31,32,33,34,35,35,36,36,36,37,37,37,37,37,37
E01024042,EV motorcycles,Number,1,4,6,11,16,22,28,35,41,48,55,61,67,72,77,82,85,88,91,93,94,95,96,97,97,97,98,98,98,98
E01024043,EV motorcycles,Number,1,1,3,4,7,9,12,14,17,20,22,25,27,30,32,33,35,36,37,38,38,39,39,39,40,40,40,40,40,40
E01024044,EV motorcycles,Number,0,1,2,3,5,7,9,11,13,15,17,19,21,22,24,25,26,27,28,28,29,29,29,30,30,30,30,30,30,30
E01024045,EV motorcycles,Number,0,1,2,3,5,6,8,10,11,13,15,17,18,20,21,22,23,24,25,25,26,26,26,27,27,27,27,27,27,27
E01024046,EV motorcycles,Number,0,1,2,3,5,6,8,10,11,13,15,17,18,20,21,22,23,24,25,25,26,26,26,27,27,27,27,27,27,27
E01024047,EV motorcycles,Number,0,1,2,4,6,7,10,12,14,16,18,21,23,24,26,27,29,30,31,31,32,32,32,33,33,33,33,33,33,33
E01024048,EV motorcycles,Number,0,0,1,1,2,3,3,4,5,6,7,7,8,9,9,10,10,11,11,11,12,12,12,12,12,12,12,12,12,12
E01024049,EV motorcycles,Number,0,1,2,3,4,6,8,9,11,13,15,16,18,19,20,22,23,23,24,25,25,25,25,26,26,26,26,26,26,26
E01024052,EV motorcycles,Number,1,2,4,6,9,12,16,19,23,27,30,34,37,40,43,45,47,49,50,51,52,52,53,53,53,54,54,54,54,54
E01024053,EV motorcycles,Number,1,2,5,8,12,15,20,25,29,34,39,43,47,51,54,57,60,62,64,65,66,67,68,68,68,69,69,69,69,69
E01024054,EV motorcycles,Number,1,2,4,6,10,13,17,21,25,29,32,36,40,43,46,48,50,52,54,55,56,56,57,57,57,58,58,58,58,58
E01024055,EV motorcycles,Number,1,2,3,6,8,11,14,18,21,25,28,31,34,37,39,42,43,45,46,47,48,49,49,49,49,50,50,50,50,50
E01024056,EV motorcycles,Number,1,2,4,6,9,12,16,20,23,27,31,34,38,41,43,46,48,49,51,52,53,53,54,54,54,55,55,55,55,55
E01024057,EV motorcycles,Number,1,2,3,5,7,10,13,16,19,22,25,27,30,33,35,37,38,40,41,42,42,43,43,43,44,44,44,44,44,44
E01024058,EV motorcycles,Number,1,1,2,4,6,9,11,13,16,19,21,24,26,28,30,32,33,34,35,36,36,37,37,37,38,38,38,38,38,38
E01024059,EV motorcycles,Number,0,1,2,4,6,8,10,12,14,17,19,21,23,25,27,28,30,31,31,32,33,33,33,33,34,34,34,34,34,34
E01024060,EV motorcycles,Number,1,2,3,6,9,11,15,18,22,25,29,32,35,38,40,42,44,46,47,48,49,49,50,50,50,51,51,51,51,51
E01024061,EV motorcycles,Number,0,1,2,3,4,5,7,8,10,11,13,14,16,17,18,19,20,21,21,22,22,22,23,23,23,23,23,23,23,23
E01024062,EV motorcycles,Number,1,2,3,6,9,11,15,18,22,25,29,32,35,38,40,42,44,46,47,48,49,49,50,50,50,51,51,51,51,51
E01024063,EV motorcycles,Number,1,2,3,5,8,10,13,16,19,22,25,28,31,33,35,37,39,40,42,42,43,44,44,44,45,45,45,45,45,45
E01024064,EV motorcycles,Number,1,3,5,8,12,17,21,26,31,36,41,46,51,55,58,62,64,67,68,70,71,72,72,73,73,73,74,74,74,74
E01024065,EV motorcycles,Number,1,3,5,9,13,18,23,28,33,38,44,49,53,58,61,65,68,70,72,74,75,76,76,77,77,77,78,78,78,78
E01024066,EV motorcycles,Number,1,1,2,4,6,8,10,13,15,18,20,22,25,27,28,30,31,32,33,34,35,35,35,35,36,36,36,36,36,36
E01024067,EV motorcycles,Number,1,1,2,4,6,8,10,13,15,18,20,22,25,27,28,30,31,32,33,34,35,35,35,35,36,36,36,36,36,36
E01024068,EV motorcycles,Number,0,1,2,3,4,6,8,9,11,13,15,16,18,19,20,22,23,23,24,25,25,25,25,26,26,26,26,26,26,26
E01024069,EV motorcycles,Number,0,1,2,4,6,8,10,12,14,17,19,21,23,25,27,28,30,31,31,32,33,33,33,33,34,34,34,34,34,34
E01024070,EV motorcycles,Number,0,1,2,3,5,6,8,10,11,13,15,17,18,20,21,22,23,24,25,25,26,26,26,27,27,27,27,27,27,27
E01024071,EV motorcycles,Number,0,1,2,4,6,7,10,12,14,16,18,21,23,24,26,27,29,30,31,31,32,32,32,33,33,33,33,33,33,33
E01024072,EV motorcycles,Number,0,1,2,3,5,7,9,11,13,15,17,19,21,23,24,26,27,28,29,29,30,30,30,31,31,31,31,31,31,31
E01024073,EV motorcycles,Number,1,2,4,7,11,15,19,23,27,32,36,40,44,48,51,54,56,58,60,61,62,63,64,64,64,65,65,65,65,65
E01024074,EV motorcycles,Number,1,2,3,5,8,11,14,17,20,24,27,30,33,35,38,40,42,43,44,45,46,47,47,47,48,48,48,48,48,48
E01024075,EV motorcycles,Number,0,1,2,4,5,7,9,11,14,16,18,20,22,24,25,27,28,29,30,30,31,31,31,32,32,32,32,32,32,32
E01024076,EV motorcycles,Number,1,2,4,7,11,15,19,24,28,33,37,42,46,50,53,56,58,60,62,63,64,65,66,66,66,67,67,67,67,67
E01024077,EV motorcycles,Number,1,2,4,6,10,13,16,20,24,28,32,35,39,42,45,47,50,51,53,54,55,55,56,56,56,57,57,57,57,57
E01024078,EV motorcycles,Number,0,0,1,1,2,3,4,5,5,6,7,8,9,10,10,11,11,12,12,12,12,13,13,13,13,13,13,13,13,13
E01024079,EV motorcycles,Number,1,2,3,5,8,10,13,16,19,23,26,29,31,34,36,38,40,41,43,43,44,45,45,45,46,46,46,46,46,46
E01024080,EV motorcycles,Number,0,1,2,3,4,6,7,9,11,12,14,16,17,18,20,21,22,22,23,24,24,24,24,25,25,25,25,25,25,25
E01024081,EV motorcycles,Number,1,1,2,4,6,9,11,13,16,19,21,24,26,28,30,32,33,34,35,36,36,37,37,37,38,38,38,38,38,38
E01024082,EV motorcycles,Number,0,1,2,3,4,5,7,8,10,11,13,14,16,17,18,19,20,21,21,22,22,22,23,23,23,23,23,23,23,23
E01024083,EV motorcycles,Number,0,1,2,3,4,5,7,8,10,11,13,14,16,17,18,19,20,21,21,22,22,22,23,23,23,23,23,23,23,23
E01024084,EV motorcycles,Number,1,2,3,5,8,10,13,16,19,22,25,28,31,33,35,37,39,40,42,42,43,44,44,44,45,45,45,45,45,45
E01024085,EV motorcycles,Number,1,3,5,8,13,17,22,27,32,37,43,47,52,56,60,63,66,68,70,72,73,74,74,75,75,75,76,76,76,76
E01024086,EV motorcycles,Number,1,2,4,7,11,14,18,22,27,31,35,39,43,47,50,52,55,57,58,59,60,61,62,62,62,63,63,63,63,63
E01024087,EV motorcycles,Number,1,3,5,8,12,16,21,25,30,35,40,44,49,52,56,59,62,64,66,67,68,69,70,70,70,71,71,71,71,71
E01024088,EV motorcycles,Number,0,1,2,3,5,7,9,11,13,15,17,19,21,22,24,25,26,27,28,28,29,29,29,30,30,30,30,30,30,30
E01024089,EV motorcycles,Number,0,1,2,3,4,5,7,8,10,11,13,14,16,17,18,19,20,21,21,22,22,22,23,23,23,23,23,23,23,23
E01024090,EV motorcycles,Number,1,2,3,5,7,10,13,16,19,22,25,27,30,33,35,37,38,40,41,42,42,43,43,43,44,44,44,44,44,44
E01024091,EV motorcycles,Number,1,1,3,4,7,9,12,14,17,20,22,25,27,30,32,33,35,36,37,38,38,39,39,39,40,40,40,40,40,40
E01024092,EV motorcycles,Number,0,1,1,2,4,5,6,8,9,11,12,14,15,16,17,18,19,20,20,21,21,21,22,22,22,22,22,22,22,22
E01024093,EV motorcycles,Number,0,0,1,1,2,3,4,5,5,6,7,8,9,10,10,11,11,12,12,12,12,13,13,13,13,13,13,13,13,13
E01024094,EV motorcycles,Number,1,3,5,9,14,18,24,29,35,40,46,51,56,61,65,68,71,74,76,77,79,80,80,81,81,81,82,82,82,82
E01024095,EV motorcycles,Number,0,1,2,3,5,6,8,10,12,14,16,17,19,21,22,23,24,25,26,26,27,27,27,28,28,28,28,28,28,28
E01024096,EV motorcycles,Number,1,2,4,7,10,14,18,22,26,30,35,39,42,46,49,52,54,56,57,59,59,60,61,61,61,62,62,62,62,62
E01024097,EV motorcycles,Number,1,1,3,4,7,9,11,14,16,19,22,24,27,29,31,32,34,35,36,37,37,38,38,38,39,39,39,39,39,39
E01024098,EV motorcycles,Number,1,2,4,6,9,12,16,19,23,27,30,34,37,40,43,45,47,49,50,51,52,52,53,53,53,54,54,54,54,54
E01024099,EV motorcycles,Number,0,1,2,3,4,5,7,8,10,11,13,14,16,17,18,19,20,21,21,22,22,22,23,23,23,23,23,23,23,23
E01024100,EV motorcycles,Number,0,0,1,1,2,3,4,5,5,6,7,8,9,10,10,11,11,12,12,12,12,13,13,13,13,13,13,13,13,13
E01024101,EV motorcycles,Number,1,2,3,5,7,10,12,15,18,21,24,27,29,32,34,36,37,39,40,41,41,42,42,42,43,43,43,43,43,43
E01024102,EV motorcycles,Number,0,1,1,2,3,4,5,7,8,9,11,12,13,14,15,16,17,17,18,18,18,18,19,19,19,19,19,19,19,19
E01024103,EV motorcycles,Number,0,0,1,1,2,2,3,4,5,5,6,7,8,8,9,9,10,10,10,10,11,11,11,11,11,11,11,11,11,11
E01024104,EV motorcycles,Number,0,1,1,2,2,3,4,5,6,7,8,9,10,10,11,12,12,13,13,13,13,14,14,14,14,14,14,14,14,14
E01024105,EV motorcycles,Number,1,2,3,5,8,10,13,16,19,23,26,29,31,34,36,38,40,41,43,43,44,45,45,45,46,46,46,46,46,46
E01024106,EV motorcycles,Number,1,1,2,4,6,9,11,13,16,19,21,24,26,28,30,32,33,34,35,36,36,37,37,37,38,38,38,38,38,38
E01024107,EV motorcycles,Number,1,2,4,6,9,12,16,20,23,27,31,34,38,41,43,46,48,49,51,52,53,53,54,54,54,55,55,55,55,55
E01024108,EV motorcycles,Number,1,2,4,7,11,14,19,23,27,31,36,40,44,47,50,53,56,58,59,60,61,62,63,63,63,64,64,64,64,64
E01024109,EV motorcycles,Number,1,3,5,8,12,16,21,25,30,35,40,44,49,52,56,59,62,64,66,67,68,69,70,70,70,71,71,71,71,71
E01024110,EV motorcycles,Number,1,1,2,4,6,8,11,13,16,18,21,23,25,27,29,31,32,33,34,35,35,36,36,36,37,37,37,37,37,37
E01024111,EV motorcycles,Number,1,2,3,5,7,10,13,16,19,22,25,27,30,33,35,37,38,40,41,42,42,43,43,43,44,44,44,44,44,44
E01024112,EV motorcycles,Number,1,1,3,4,7,9,11,14,16,19,22,24,27,29,31,32,34,35,36,37,37,38,38,38,39,39,39,39,39,39
E01024113,EV motorcycles,Number,0,1,2,3,5,7,9,11,13,15,17,19,21,22,24,25,26,27,28,28,29,29,29,30,30,30,30,30,30,30
E01024114,EV motorcycles,Number,1,2,3,6,8,11,14,18,21,25,28,31,34,37,39,42,43,45,46,47,48,49,49,49,49,50,50,50,50,50
E01024115,EV motorcycles,Number,1,1,2,4,6,9,11,13,16,19,21,24,26,28,30,32,33,34,35,36,36,37,37,37,38,38,38,38,38,38
E01024116,EV motorcycles,Number,0,1,2,3,5,6,8,10,12,14,16,17,19,21,22,23,24,25,26,26,27,27,27,28,28,28,28,28,28,28
E01024117,EV motorcycles,Number,1,2,3,5,8,10,13,16,19,22,25,28,31,33,35,37,39,40,42,42,43,44,44,44,45,45,45,45,45,45
E01024118,EV motorcycles,Number,1,2,3,5,8,11,14,17,20,23,26,29,32,35,37,39,41,42,43,44,45,46,46,46,47,47,47,47,47,47
E01024119,EV motorcycles,Number,1,1,3,4,7,9,12,14,17,20,22,25,27,30,32,33,35,36,37,38,38,39,39,39,40,40,40,40,40,40
E01024120,EV motorcycles,Number,1,3,5,8,12,16,21,26,31,36,41,45,50,54,58,61,63,66,67,69,70,71,71,72,72,72,73,73,73,73
E01024121,EV motorcycles,Number,0,1,1,2,3,4,5,6,8,9,10,11,12,13,14,15,16,16,17,17,17,17,18,18,18,18,18,18,18,18
E01024122,EV motorcycles,Number,0,1,1,2,3,4,5,7,8,9,11,12,13,14,15,16,17,17,18,18,18,18,19,19,19,19,19,19,19,19
E01024123,EV motorcycles,Number,0,1,2,3,5,7,9,11,13,15,17,19,21,22,24,25,26,27,28,28,29,29,29,30,30,30,30,30,30,30
E01024124,EV motorcycles,Number,0,0,0,1,1,1,2,2,3,3,3,4,4,4,5,5,5,5,6,6,6,6,6,6,6,6,6,6,6,6
E01024126,EV motorcycles,Number,1,1,3,4,7,9,12,14,17,20,22,25,27,30,32,33,35,36,37,38,38,39,39,39,40,40,40,40,40,40
E01024127,EV motorcycles,Number,1,2,4,6,10,13,17,21,25,29,32,36,40,43,46,48,50,52,54,55,56,56,57,57,57,58,58,58,58,58
E01024128,EV motorcycles,Number,1,1,2,4,6,9,11,13,16,19,21,24,26,28,30,32,33,34,35,36,36,37,37,37,38,38,38,38,38,38
E01024129,EV motorcycles,Number,0,1,1,2,2,3,4,5,6,7,8,9,10,10,11,12,12,13,13,13,13,14,14,14,14,14,14,14,14,14
E01024130,EV motorcycles,Number,1,2,3,5,8,11,14,17,20,23,26,29,32,35,37,39,41,42,43,44,45,46,46,46,47,47,47,47,47,47
E01024131,EV motorcycles,Number,0,1,1,2,3,4,5,6,8,9,10,11,12,13,14,15,16,16,17,17,17,17,18,18,18,18,18,18,18,18
E01024132,EV motorcycles,Number,1,1,2,4,6,9,11,13,16,19,21,24,26,28,30,32,33,34,35,36,36,37,37,37,38,38,38,38,38,38
E01024133,EV motorcycles,Number,0,1,2,3,5,6,8,10,11,13,15,17,18,20,21,22,23,24,25,25,26,26,26,27,27,27,27,27,27,27
E01024134,EV motorcycles,Number,1,2,3,6,9,11,15,18,22,25,29,32,35,38,40,42,44,46,47,48,49,49,50,50,50,51,51,51,51,51
E01024135,EV motorcycles,Number,1,2,3,5,8,10,13,16,19,22,25,28,31,33,35,37,39,40,42,42,43,44,44,44,45,45,45,45,45,45
E01024136,EV motorcycles,Number,0,1,1,2,3,4,5,6,7,8,10,11,12,13,13,14,15,15,16,16,16,16,17,17,17,17,17,17,17,17
E01024137,EV motorcycles,Number,0,1,2,4,6,8,10,12,14,17,19,21,23,25,27,28,30,31,31,32,33,33,33,33,34,34,34,34,34,34
E01024138,EV motorcycles,Number,0,1,2,3,5,7,8,10,12,14,16,18,20,21,23,24,25,26,27,27,28,28,28,29,29,29,29,29,29,29
E01024139,EV motorcycles,Number,1,2,3,6,9,12,15,19,22,26,30,33,36,39,42,44,46,48,49,50,51,51,52,52,52,53,53,53,53,53
E01024140,EV motorcycles,Number,1,1,3,5,7,9,12,15,17,20,23,26,28,30,32,34,36,37,38,39,39,40,40,40,41,41,41,41,41,41
E01024141,EV motorcycles,Number,1,2,4,7,10,14,18,22,26,30,35,39,42,46,49,52,54,56,57,59,59,60,61,61,61,62,62,62,62,62
E01024142,EV motorcycles,Number,1,2,4,6,10,13,17,21,25,29,32,36,40,43,46,48,50,52,54,55,56,56,57,57,57,58,58,58,58,58
E01024143,EV motorcycles,Number,1,2,3,6,9,11,15,18,22,25,29,32,35,38,40,42,44,46,47,48,49,49,50,50,50,51,51,51,51,51
E01024144,EV motorcycles,Number,1,2,3,5,8,11,14,17,20,23,26,29,32,35,37,39,41,42,43,44,45,46,46,46,47,47,47,47,47,47
E01024145,EV motorcycles,Number,1,1,3,4,7,9,12,14,17,20,22,25,27,30,32,33,35,36,37,38,38,39,39,39,40,40,40,40,40,40
E01024146,EV motorcycles,Number,0,1,2,4,6,8,10,12,14,17,19,21,23,25,27,28,30,31,31,32,33,33,33,33,34,34,34,34,34,34
E01024147,EV motorcycles,Number,1,2,4,6,9,12,16,19,23,27,30,34,37,40,43,45,47,49,50,51,52,52,53,53,53,54,54,54,54,54
E01024148,EV motorcycles,Number,0,1,2,3,5,7,9,11,13,15,17,19,21,23,24,26,27,28,29,29,30,30,30,31,31,31,31,31,31,31
E01024149,EV motorcycles,Number,1,3,6,10,15,20,25,31,37,43,49,55,60,65,69,73,76,79,81,83,84,85,86,87,87,87,88,88,88,88
E01024150,EV motorcycles,Number,1,1,2,4,6,9,11,13,16,19,21,24,26,28,30,32,33,34,35,36,36,37,37,37,38,38,38,38,38,38
E01024151,EV motorcycles,Number,1,2,4,6,10,13,16,20,24,28,32,35,39,42,45,47,50,51,53,54,55,55,56,56,56,57,57,57,57,57
E01024152,EV motorcycles,Number,1,2,3,5,8,10,13,16,19,22,25,28,31,33,35,37,39,40,42,42,43,44,44,44,45,45,45,45,45,45
E01024153,EV motorcycles,Number,0,1,2,3,5,7,9,11,13,15,17,19,21,22,24,25,26,27,28,28,29,29,29,30,30,30,30,30,30,30
E01024154,EV motorcycles,Number,0,1,2,3,4,6,7,9,11,12,14,16,17,18,20,21,22,22,23,24,24,24,24,25,25,25,25,25,25,25
E01024155,EV motorcycles,Number,0,1,1,2,3,4,5,6,8,9,10,11,12,13,14,15,16,16,17,17,17,17,18,18,18,18,18,18,18,18
E01024156,EV motorcycles,Number,0,1,1,2,4,5,6,8,9,11,12,14,15,16,17,18,19,20,20,21,21,21,22,22,22,22,22,22,22,22
E01024157,EV motorcycles,Number,1,2,3,6,9,12,15,18,22,26,29,32,36,38,41,43,45,47,48,49,50,50,51,51,51,52,52,52,52,52
E01024158,EV motorcycles,Number,1,1,3,5,7,9,12,15,17,20,23,26,28,30,32,34,36,37,38,39,39,40,40,40,41,41,41,41,41,41
E01024159,EV motorcycles,Number,1,3,5,8,12,16,21,25,30,35,40,44,49,52,56,59,62,64,66,67,68,69,70,70,70,71,71,71,71,71
E01024160,EV motorcycles,Number,1,3,5,8,13,17,22,27,32,37,42,47,51,55,59,62,65,67,69,71,72,73,73,74,74,74,75,75,75,75
E01024161,EV motorcycles,Number,0,1,2,3,5,7,9,11,13,15,17,19,21,23,24,26,27,28,29,29,30,30,30,31,31,31,31,31,31,31
E01024162,EV motorcycles,Number,1,1,2,4,6,8,10,13,15,18,20,22,25,27,28,30,31,32,33,34,35,35,35,35,36,36,36,36,36,36
E01024163,EV motorcycles,Number,0,1,2,4,6,7,10,12,14,16,18,21,23,24,26,27,29,30,31,31,32,32,32,33,33,33,33,33,33,33
E01024164,EV motorcycles,Number,0,1,1,2,4,5,6,7,9,10,12,13,14,16,17,17,18,19,19,20,20,20,21,21,21,21,21,21,21,21
E01024165,EV motorcycles,Number,0,1,1,2,4,5,6,8,9,11,12,14,15,16,17,18,19,20,20,21,21,21,22,22,22,22,22,22,22,22
E01024166,EV motorcycles,Number,0,1,2,3,5,7,9,11,13,15,17,19,21,23,24,26,27,28,29,29,30,30,30,31,31,31,31,31,31,31
E01024167,EV motorcycles,Number,1,2,4,6,9,12,16,20,23,27,31,34,38,41,43,46,48,49,51,52,53,53,54,54,54,55,55,55,55,55
E01024168,EV motorcycles,Number,1,2,3,6,9,11,15,18,22,25,29,32,35,38,40,42,44,46,47,48,49,49,50,50,50,51,51,51,51,51
E01024169,EV motorcycles,Number,1,2,4,6,10,13,16,20,24,28,32,35,39,42,45,47,50,51,53,54,55,55,56,56,56,57,57,57,57,57
E01024170,EV motorcycles,Number,0,1,2,3,4,5,7,9,10,12,13,15,16,18,19,20,21,22,22,23,23,23,23,24,24,24,24,24,24,24
E01024171,EV motorcycles,Number,0,1,2,3,5,6,8,10,12,14,16,17,19,21,22,23,24,25,26,26,27,27,27,28,28,28,28,28,28,28
E01024172,EV motorcycles,Number,1,1,3,5,7,9,12,15,17,20,23,26,28,30,32,34,36,37,38,39,39,40,40,40,41,41,41,41,41,41
E01024173,EV motorcycles,Number,1,1,3,5,7,9,12,15,17,20,23,26,28,30,32,34,36,37,38,39,39,40,40,40,41,41,41,41,41,41
E01024174,EV motorcycles,Number,1,1,2,4,6,8,11,13,16,18,21,23,25,27,29,31,32,33,34,35,35,36,36,36,37,37,37,37,37,37
E01024175,EV motorcycles,Number,1,2,3,6,8,11,14,18,21,25,28,31,34,37,39,42,43,45,46,47,48,49,49,49,49,50,50,50,50,50
E01024176,EV motorcycles,Number,0,1,2,4,6,7,10,12,14,16,18,21,23,24,26,27,29,30,31,31,32,32,32,33,33,33,33,33,33,33
E01024177,EV motorcycles,Number,1,1,2,4,6,8,11,13,16,18,21,23,25,27,29,31,32,33,34,35,35,36,36,36,37,37,37,37,37,37
E01024178,EV motorcycles,Number,1,2,3,5,7,9,12,15,18,21,24,26,29,31,33,35,36,38,39,40,40,41,41,41,42,42,42,42,42,42
E01024179,EV motorcycles,Number,1,2,4,6,9,13,16,20,24,28,31,35,38,41,44,47,49,50,52,53,54,54,55,55,55,56,56,56,56,56
E01024180,EV motorcycles,Number,1,2,3,5,8,11,14,17,20,24,27,30,33,35,38,40,42,43,44,45,46,47,47,47,48,48,48,48,48,48
E01024181,EV motorcycles,Number,0,1,2,3,4,5,7,8,10,11,13,14,16,17,18,19,20,21,21,22,22,22,23,23,23,23,23,23,23,23
E01024182,EV motorcycles,Number,1,1,2,4,6,9,11,13,16,19,21,24,26,28,30,32,33,34,35,36,36,37,37,37,38,38,38,38,38,38
E01024183,EV motorcycles,Number,0,1,1,2,3,4,5,6,8,9,10,11,12,13,14,15,16,16,17,17,17,17,18,18,18,18,18,18,18,18
E01024184,EV motorcycles,Number,0,1,2,3,5,7,9,11,13,15,17,19,21,22,24,25,26,27,28,28,29,29,29,30,30,30,30,30,30,30
E01024185,EV motorcycles,Number,1,1,3,4,7,9,12,14,17,20,22,25,27,30,32,33,35,36,37,38,38,39,39,39,40,40,40,40,40,40
E01024186,EV motorcycles,Number,1,1,3,4,7,9,11,14,16,19,22,24,27,29,31,32,34,35,36,37,37,38,38,38,39,39,39,39,39,39
E01024187,EV motorcycles,Number,0,1,2,3,5,6,8,10,12,14,16,17,19,21,22,23,24,25,26,26,27,27,27,28,28,28,28,28,28,28
E01024188,EV motorcycles,Number,1,2,3,5,7,10,12,15,18,21,24,27,29,32,34,36,37,39,40,41,41,42,42,42,43,43,43,43,43,43
E01024189,EV motorcycles,Number,0,1,2,3,4,6,7,9,11,12,14,16,17,18,20,21,22,22,23,24,24,24,24,25,25,25,25,25,25,25
E01024190,EV motorcycles,Number,1,1,2,4,6,8,10,13,15,18,20,22,25,27,28,30,31,32,33,34,35,35,35,35,36,36,36,36,36,36
E01024191,EV motorcycles,Number,1,3,5,9,14,19,24,29,35,41,46,52,57,61,65,69,72,75,77,78,80,81,81,82,82,82,83,83,83,83
E01024192,EV motorcycles,Number,0,1,1,2,4,5,6,8,9,11,12,14,15,16,17,18,19,20,20,21,21,21,22,22,22,22,22,22,22,22
E01024193,EV motorcycles,Number,0,1,1,2,2,3,4,5,6,7,8,9,10,10,11,12,12,13,13,13,13,14,14,14,14,14,14,14,14,14
E01024194,EV motorcycles,Number,1,1,2,4,6,8,10,12,15,17,20,22,24,26,28,29,30,31,32,33,34,34,34,34,35,35,35,35,35,35
E01024195,EV motorcycles,Number,0,1,2,3,5,7,8,10,12,14,16,18,20,21,23,24,25,26,27,27,28,28,28,29,29,29,29,29,29,29
E01024196,EV motorcycles,Number,1,1,3,4,7,9,11,14,16,19,22,24,27,29,31,32,34,35,36,37,37,38,38,38,39,39,39,39,39,39
E01024197,EV motorcycles,Number,0,1,2,4,6,8,10,12,14,17,19,21,23,25,27,28,30,31,31,32,33,33,33,33,34,34,34,34,34,34
E01024198,EV motorcycles,Number,1,3,6,10,15,20,25,31,37,43,49,55,60,65,69,73,76,79,81,83,84,85,86,87,87,87,88,88,88,88
E01024200,EV motorcycles,Number,1,3,6,11,16,22,28,34,41,47,54,60,66,71,76,80,83,86,89,91,92,93,94,95,95,95,96,96,96,96
E01024201,EV motorcycles,Number,1,2,4,7,10,13,17,21,25,30,34,37,41,44,47,50,52,54,55,57,58,58,59,59,59,60,60,60,60,60
E01024202,EV motorcycles,Number,1,3,5,9,14,19,24,30,36,41,47,52,57,62,66,70,73,76,78,79,81,82,82,83,83,83,84,84,84,84
E01024203,EV motorcycles,Number,1,3,5,9,13,18,23,28,34,39,45,50,55,59,63,67,70,72,74,76,77,78,78,79,79,79,80,80,80,80
E01024204,EV motorcycles,Number,1,3,5,8,12,16,21,26,30,35,40,45,49,53,57,60,63,65,67,68,69,70,70,71,71,71,72,72,72,72
E01024205,EV motorcycles,Number,1,3,6,9,14,19,25,31,36,42,48,54,59,64,68,72,75,77,79,81,82,83,84,85,85,85,86,86,86,86
E01024206,EV motorcycles,Number,1,3,5,9,14,18,24,29,35,40,46,51,56,61,65,68,71,74,76,77,79,80,80,81,81,81,82,82,82,82
E01024207,EV motorcycles,Number,1,3,5,8,12,16,20,25,30,34,39,44,48,52,55,58,61,63,65,66,67,68,69,69,69,70,70,70,70,70
E01024208,EV motorcycles,Number,1,2,4,6,10,13,17,21,25,29,32,36,40,43,46,48,50,52,54,55,56,56,57,57,57,58,58,58,58,58
E01024209,EV motorcycles,Number,1,2,5,8,12,15,20,25,29,34,39,43,47,51,54,57,60,62,64,65,66,67,68,68,68,69,69,69,69,69
E01024212,EV motorcycles,Number,1,1,2,4,6,8,10,12,15,17,20,22,24,26,28,29,30,31,32,33,34,34,34,34,35,35,35,35,35,35
E01024213,EV motorcycles,Number,0,1,2,4,6,7,10,12,14,16,18,21,23,24,26,27,29,30,31,31,32,32,32,33,33,33,33,33,33,33
E01024214,EV motorcycles,Number,0,1,2,3,5,6,8,10,12,14,16,17,19,21,22,23,24,25,26,26,27,27,27,28,28,28,28,28,28,28
E01024215,EV motorcycles,Number,0,1,2,3,5,6,8,10,12,14,16,17,19,21,22,23,24,25,26,26,27,27,27,28,28,28,28,28,28,28
E01024216,EV motorcycles,Number,0,1,2,3,4,5,7,9,10,12,13,15,16,18,19,20,21,22,22,23,23,23,23,24,24,24,24,24,24,24
E01024217,EV motorcycles,Number,1,2,4,7,10,14,18,22,26,30,35,39,42,46,49,52,54,56,57,59,59,60,61,61,61,62,62,62,62,62
E01024218,EV motorcycles,Number,0,1,2,3,5,7,8,10,12,14,16,18,20,21,23,24,25,26,27,27,28,28,28,29,29,29,29,29,29,29
E01024219,EV motorcycles,Number,1,2,3,6,9,11,15,18,22,25,29,32,35,38,40,42,44,46,47,48,49,49,50,50,50,51,51,51,51,51
E01024220,EV motorcycles,Number,1,2,3,6,9,11,15,18,22,25,29,32,35,38,40,42,44,46,47,48,49,49,50,50,50,51,51,51,51,51
E01024221,EV motorcycles,Number,1,2,3,5,8,11,14,17,20,23,26,29,32,35,37,39,41,42,43,44,45,46,46,46,47,47,47,47,47,47
E01024222,EV motorcycles,Number,1,2,3,5,7,9,12,15,18,21,24,26,29,31,33,35,36,38,39,40,40,41,41,41,42,42,42,42,42,42
E01024223,EV motorcycles,Number,1,1,2,4,6,8,11,13,16,18,21,23,25,27,29,31,32,33,34,35,35,36,36,36,37,37,37,37,37,37
E01024224,EV motorcycles,Number,1,1,3,5,7,9,12,15,17,20,23,26,28,30,32,34,36,37,38,39,39,40,40,40,41,41,41,41,41,41
E01024225,EV motorcycles,Number,1,1,3,5,7,9,12,15,17,20,23,26,28,30,32,34,36,37,38,39,39,40,40,40,41,41,41,41,41,41
E01024226,EV motorcycles,Number,1,1,3,5,7,9,12,15,17,20,23,26,28,30,32,34,36,37,38,39,39,40,40,40,41,41,41,41,41,41
E01024227,EV motorcycles,Number,1,2,3,5,8,11,14,17,20,24,27,30,33,35,38,40,42,43,44,45,46,47,47,47,48,48,48,48,48,48
E01024228,EV motorcycles,Number,0,1,2,3,4,5,7,9,10,12,13,15,16,18,19,20,21,22,22,23,23,23,23,24,24,24,24,24,24,24
E01024229,EV motorcycles,Number,0,1,2,3,5,7,9,11,13,15,17,19,21,22,24,25,26,27,28,28,29,29,29,30,30,30,30,30,30,30
E01024230,EV motorcycles,Number,0,1,2,3,5,6,8,10,12,14,16,17,19,21,22,23,24,25,26,26,27,27,27,28,28,28,28,28,28,28
E01024231,EV motorcycles,Number,0,1,2,3,4,6,7,9,11,12,14,16,17,18,20,21,22,22,23,24,24,24,24,25,25,25,25,25,25,25
E01024232,EV motorcycles,Number,1,3,5,8,12,16,21,26,31,36,41,45,50,54,58,61,63,66,67,69,70,71,71,72,72,72,73,73,73,73
E01024233,EV motorcycles,Number,1,2,3,5,7,10,12,15,18,21,24,27,29,32,34,36,37,39,40,41,41,42,42,42,43,43,43,43,43,43
E01024234,EV motorcycles,Number,0,1,2,3,5,6,8,10,11,13,15,17,18,20,21,22,23,24,25,25,26,26,26,27,27,27,27,27,27,27
E01024235,EV motorcycles,Number,1,2,4,6,9,12,16,20,23,27,31,34,38,41,43,46,48,49,51,52,53,53,54,54,54,55,55,55,55,55
E01024236,EV motorcycles,Number,1,3,6,10,15,20,26,32,38,44,50,55,61,66,70,74,77,80,82,84,85,86,87,88,88,88,89,89,89,89
E01024237,EV motorcycles,Number,1,1,2,4,6,8,10,12,15,17,20,22,24,26,28,29,30,31,32,33,34,34,34,34,35,35,35,35,35,35
E01024238,EV motorcycles,Number,0,1,2,4,5,7,9,11,14,16,18,20,22,24,25,27,28,29,30,30,31,31,31,32,32,32,32,32,32,32
E01024239,EV motorcycles,Number,0,1,2,3,5,7,9,11,13,15,17,19,21,22,24,25,26,27,28,28,29,29,29,30,30,30,30,30,30,30
E01024240,EV motorcycles,Number,1,2,3,5,7,10,12,15,18,21,24,27,29,32,34,36,37,39,40,41,41,42,42,42,43,43,43,43,43,43
E01024241,EV motorcycles,Number,1,2,3,5,8,10,13,16,19,23,26,29,31,34,36,38,40,41,43,43,44,45,45,45,46,46,46,46,46,46
E01024242,EV motorcycles,Number,1,3,6,10,15,20,26,32,38,44,50,56,62,67,71,75,78,81,83,85,86,87,88,89,89,89,90,90,90,90
E01024243,EV motorcycles,Number,1,2,3,5,7,10,12,15,18,21,24,27,29,32,34,36,37,39,40,41,41,42,42,42,43,43,43,43,43,43
E01024244,EV motorcycles,Number,1,2,3,5,8,11,14,17,21,24,27,31,33,36,39,41,43,44,45,46,47,48,48,48,48,49,49,49,49,49
E01024245,EV motorcycles,Number,1,3,6,10,15,20,26,32,38,44,50,56,62,67,71,75,78,81,83,85,86,87,88,89,89,89,90,90,90,90
E01024246,EV motorcycles,Number,0,1,2,4,5,7,9,11,14,16,18,20,22,24,25,27,28,29,30,30,31,31,31,32,32,32,32,32,32,32
E01024247,EV motorcycles,Number,0,1,2,3,5,7,9,11,13,15,17,19,21,23,24,26,27,28,29,29,30,30,30,31,31,31,31,31,31,31
E01024248,EV motorcycles,Number,1,2,3,6,9,12,15,18,22,26,29,32,36,38,41,43,45,47,48,49,50,50,51,51,51,52,52,52,52,52
E01024249,EV motorcycles,Number,1,2,3,5,7,10,13,16,19,22,25,27,30,33,35,37,38,40,41,42,42,43,43,43,44,44,44,44,44,44
E01024250,EV motorcycles,Number,1,2,3,6,8,11,14,18,21,25,28,31,34,37,39,42,43,45,46,47,48,49,49,49,49,50,50,50,50,50
E01024251,EV motorcycles,Number,0,1,2,3,4,6,8,9,11,13,15,16,18,19,20,22,23,23,24,25,25,25,25,26,26,26,26,26,26,26
E01024252,EV motorcycles,Number,1,1,2,4,6,8,10,13,15,18,20,22,25,27,28,30,31,32,33,34,35,35,35,35,36,36,36,36,36,36
E01024253,EV motorcycles,Number,1,1,3,5,7,9,12,15,17,20,23,26,28,30,32,34,36,37,38,39,39,40,40,40,41,41,41,41,41,41
E01024254,EV motorcycles,Number,1,3,5,9,13,18,23,28,34,39,45,50,55,59,63,67,70,72,74,76,77,78,78,79,79,79,80,80,80,80
E01024255,EV motorcycles,Number,1,2,4,6,9,13,16,20,24,28,31,35,38,41,44,47,49,50,52,53,54,54,55,55,55,56,56,56,56,56
E01024256,EV motorcycles,Number,1,2,4,6,9,13,16,20,24,28,31,35,38,41,44,47,49,50,52,53,54,54,55,55,55,56,56,56,56,56
E01024257,EV motorcycles,Number,0,1,1,2,3,4,5,7,8,9,11,12,13,14,15,16,17,17,18,18,18,18,19,19,19,19,19,19,19,19
E01024258,EV motorcycles,Number,1,2,3,6,9,11,15,18,22,25,29,32,35,38,40,42,44,46,47,48,49,49,50,50,50,51,51,51,51,51
E01024259,EV motorcycles,Number,0,1,2,4,6,7,10,12,14,16,18,21,23,24,26,27,29,30,31,31,32,32,32,33,33,33,33,33,33,33
E01024260,EV motorcycles,Number,0,1,2,3,5,6,8,10,11,13,15,17,18,20,21,22,23,24,25,25,26,26,26,27,27,27,27,27,27,27
E01024261,EV motorcycles,Number,1,2,4,7,11,15,19,23,28,32,37,41,45,49,52,55,57,59,61,62,63,64,65,65,65,66,66,66,66,66
E01024262,EV motorcycles,Number,0,1,1,2,3,4,6,7,8,10,11,12,14,15,16,17,17,18,18,19,19,19,20,20,20,20,20,20,20,20
E01024263,EV motorcycles,Number,0,1,2,4,6,7,10,12,14,16,18,21,23,24,26,27,29,30,31,31,32,32,32,33,33,33,33,33,33,33
E01024264,EV motorcycles,Number,1,2,3,5,8,10,13,16,19,23,26,29,31,34,36,38,40,41,43,43,44,45,45,45,46,46,46,46,46,46
E01024265,EV motorcycles,Number,1,3,6,10,16,21,27,34,40,47,53,59,65,70,75,79,83,85,88,90,91,92,93,94,94,94,95,95,95,95
E01024266,EV motorcycles,Number,0,1,2,4,6,8,10,12,14,17,19,21,23,25,27,28,30,31,31,32,33,33,33,33,34,34,34,34,34,34
E01024267,EV motorcycles,Number,1,3,5,8,12,16,20,25,30,34,39,44,48,52,55,58,61,63,65,66,67,68,69,69,69,70,70,70,70,70
E01024268,EV motorcycles,Number,1,2,3,5,8,11,14,17,21,24,27,31,33,36,39,41,43,44,45,46,47,48,48,48,48,49,49,49,49,49
E01024269,EV motorcycles,Number,1,2,4,7,10,13,17,21,25,29,33,37,40,44,47,49,51,53,55,56,57,57,58,58,58,59,59,59,59,59
E01024270,EV motorcycles,Number,1,2,3,6,9,12,15,18,22,26,29,32,36,38,41,43,45,47,48,49,50,50,51,51,51,52,52,52,52,52
E01024271,EV motorcycles,Number,1,2,4,7,10,13,17,21,25,30,34,37,41,44,47,50,52,54,55,57,58,58,59,59,59,60,60,60,60,60
E01024272,EV motorcycles,Number,1,2,3,5,8,11,14,17,20,24,27,30,33,35,38,40,42,43,44,45,46,47,47,47,48,48,48,48,48,48
E01024273,EV motorcycles,Number,1,3,5,9,14,18,23,29,34,40,45,50,55,60,64,67,70,73,75,76,78,79,79,80,80,80,81,81,81,81
E01024274,EV motorcycles,Number,1,2,4,6,9,13,16,20,24,28,31,35,38,41,44,47,49,50,52,53,54,54,55,55,55,56,56,56,56,56
E01024275,EV motorcycles,Number,1,2,4,6,10,13,17,21,25,29,32,36,40,43,46,48,50,52,54,55,56,56,57,57,57,58,58,58,58,58
E01024276,EV motorcycles,Number,1,1,3,4,7,9,11,14,16,19,22,24,27,29,31,32,34,35,36,37,37,38,38,38,39,39,39,39,39,39
E01024277,EV motorcycles,Number,0,1,2,3,4,6,7,9,11,12,14,16,17,18,20,21,22,22,23,24,24,24,24,25,25,25,25,25,25,25
E01024278,EV motorcycles,Number,1,1,2,4,6,8,10,13,15,18,20,22,25,27,28,30,31,32,33,34,35,35,35,35,36,36,36,36,36,36
E01024279,EV motorcycles,Number,0,1,2,4,6,7,10,12,14,16,18,21,23,24,26,27,29,30,31,31,32,32,32,33,33,33,33,33,33,33
E01024280,EV motorcycles,Number,1,2,4,7,11,15,19,23,27,32,36,40,44,48,51,54,56,58,60,61,62,63,64,64,64,65,65,65,65,65
E01024281,EV motorcycles,Number,1,1,2,4,6,8,11,13,16,18,21,23,25,27,29,31,32,33,34,35,35,36,36,36,37,37,37,37,37,37
E01024282,EV motorcycles,Number,0,1,2,3,4,5,7,8,10,11,13,14,16,17,18,19,20,21,21,22,22,22,23,23,23,23,23,23,23,23
E01024283,EV motorcycles,Number,1,1,2,4,6,8,10,12,15,17,20,22,24,26,28,29,30,31,32,33,34,34,34,34,35,35,35,35,35,35
E01024284,EV motorcycles,Number,0,1,2,3,4,5,7,9,10,12,13,15,16,18,19,20,21,22,22,23,23,23,23,24,24,24,24,24,24,24
E01024285,EV motorcycles,Number,0,1,2,3,5,7,8,10,12,14,16,18,20,21,23,24,25,26,27,27,28,28,28,29,29,29,29,29,29,29
E01024286,EV motorcycles,Number,1,1,3,5,7,9,12,15,17,20,23,26,28,30,32,34,36,37,38,39,39,40,40,40,41,41,41,41,41,41
E01024287,EV motorcycles,Number,1,1,2,4,6,8,11,13,16,18,21,23,25,27,29,31,32,33,34,35,35,36,36,36,37,37,37,37,37,37
E01024288,EV motorcycles,Number,0,1,2,3,5,7,9,11,13,15,17,19,21,23,24,26,27,28,29,29,30,30,30,31,31,31,31,31,31,31
E01024290,EV motorcycles,Number,0,1,1,2,4,5,6,8,9,11,12,14,15,16,17,18,19,20,20,21,21,21,22,22,22,22,22,22,22,22
E01024291,EV motorcycles,Number,0,1,1,2,3,4,5,6,7,8,10,11,12,13,13,14,15,15,16,16,16,16,17,17,17,17,17,17,17,17
E01024292,EV motorcycles,Number,0,0,1,1,2,2,3,4,5,5,6,7,8,8,9,9,10,10,10,10,11,11,11,11,11,11,11,11,11,11
E01024293,EV motorcycles,Number,1,1,3,5,7,9,12,15,17,20,23,26,28,30,32,34,36,37,38,39,39,40,40,40,41,41,41,41,41,41
E01024294,EV motorcycles,Number,0,1,2,4,5,7,9,11,14,16,18,20,22,24,25,27,28,29,30,30,31,31,31,32,32,32,32,32,32,32
E01024295,EV motorcycles,Number,0,1,2,3,4,6,7,9,11,12,14,16,17,18,20,21,22,22,23,24,24,24,24,25,25,25,25,25,25,25
E01024296,EV motorcycles,Number,1,2,3,5,7,10,12,15,18,21,24,27,29,32,34,36,37,39,40,41,41,42,42,42,43,43,43,43,43,43
E01024297,EV motorcycles,Number,1,2,3,5,8,10,13,16,19,23,26,29,31,34,36,38,40,41,43,43,44,45,45,45,46,46,46,46,46,46
E01024298,EV motorcycles,Number,0,1,2,4,6,8,10,12,14,17,19,21,23,25,27,28,30,31,31,32,33,33,33,33,34,34,34,34,34,34
E01024299,EV motorcycles,Number,0,1,2,4,6,7,10,12,14,16,18,21,23,24,26,27,29,30,31,31,32,32,32,33,33,33,33,33,33,33
E01024300,EV motorcycles,Number,1,2,3,5,7,10,12,15,18,21,24,27,29,32,34,36,37,39,40,41,41,42,42,42,43,43,43,43,43,43
E01024301,EV motorcycles,Number,1,1,2,4,6,8,10,13,15,18,20,22,25,27,28,30,31,32,33,34,35,35,35,35,36,36,36,36,36,36
E01024302,EV motorcycles,Number,1,2,4,6,10,13,16,20,24,28,32,35,39,42,45,47,50,51,53,54,55,55,56,56,56,57,57,57,57,57
E01024303,EV motorcycles,Number,1,1,3,4,7,9,11,14,16,19,22,24,27,29,31,32,34,35,36,37,37,38,38,38,39,39,39,39,39,39
E01024304,EV motorcycles,Number,1,2,3,5,7,10,12,15,18,21,24,27,29,32,34,36,37,39,40,41,41,42,42,42,43,43,43,43,43,43
E01024305,EV motorcycles,Number,0,1,1,2,4,5,6,8,9,11,12,14,15,16,17,18,19,20,20,21,21,21,22,22,22,22,22,22,22,22
E01024306,EV motorcycles,Number,1,1,2,4,6,8,10,13,15,18,20,22,25,27,28,30,31,32,33,34,35,35,35,35,36,36,36,36,36,36
E01024307,EV motorcycles,Number,0,1,2,4,6,7,10,12,14,16,18,21,23,24,26,27,29,30,31,31,32,32,32,33,33,33,33,33,33,33
E01024308,EV motorcycles,Number,0,1,2,3,4,6,7,9,11,12,14,16,17,18,20,21,22,22,23,24,24,24,24,25,25,25,25,25,25,25
E01024309,EV motorcycles,Number,0,1,2,3,4,6,8,9,11,13,15,16,18,19,20,22,23,23,24,25,25,25,25,26,26,26,26,26,26,26
E01024310,EV motorcycles,Number,0,1,2,4,6,7,10,12,14,16,18,21,23,24,26,27,29,30,31,31,32,32,32,33,33,33,33,33,33,33
E01024311,EV motorcycles,Number,0,1,1,2,3,4,5,7,8,9,11,12,13,14,15,16,17,17,18,18,18,18,19,19,19,19,19,19,19,19
E01024312,EV motorcycles,Number,0,1,2,3,4,5,7,9,10,12,13,15,16,18,19,20,21,22,22,23,23,23,23,24,24,24,24,24,24,24
E01024313,EV motorcycles,Number,0,1,2,4,6,7,10,12,14,16,18,21,23,24,26,27,29,30,31,31,32,32,32,33,33,33,33,33,33,33
E01024314,EV motorcycles,Number,1,1,3,5,7,9,12,15,17,20,23,26,28,30,32,34,36,37,38,39,39,40,40,40,41,41,41,41,41,41
E01024315,EV motorcycles,Number,0,1,2,3,5,7,9,11,13,15,17,19,21,22,24,25,26,27,28,28,29,29,29,30,30,30,30,30,30,30
E01024316,EV motorcycles,Number,1,2,4,6,9,12,16,19,23,27,30,34,37,40,43,45,47,49,50,51,52,52,53,53,53,54,54,54,54,54
E01024317,EV motorcycles,Number,0,1,2,4,6,8,10,12,14,17,19,21,23,25,27,28,30,31,31,32,33,33,33,33,34,34,34,34,34,34
E01024318,EV motorcycles,Number,1,1,3,4,7,9,11,14,16,19,22,24,27,29,31,32,34,35,36,37,37,38,38,38,39,39,39,39,39,39
E01024319,EV motorcycles,Number,0,1,1,2,3,4,6,7,8,10,11,12,14,15,16,17,17,18,18,19,19,19,20,20,20,20,20,20,20,20
E01024320,EV motorcycles,Number,1,2,3,5,7,10,12,15,18,21,24,27,29,32,34,36,37,39,40,41,41,42,42,42,43,43,43,43,43,43
E01024321,EV motorcycles,Number,1,2,4,6,9,13,16,20,24,28,31,35,38,41,44,47,49,50,52,53,54,54,55,55,55,56,56,56,56,56
E01024322,EV motorcycles,Number,0,1,2,3,5,7,9,11,13,15,17,19,21,23,24,26,27,28,29,29,30,30,30,31,31,31,31,31,31,31
E01024323,EV motorcycles,Number,1,2,3,5,8,10,13,16,19,22,25,28,31,33,35,37,39,40,42,42,43,44,44,44,45,45,45,45,45,45
E01024324,EV motorcycles,Number,1,1,2,4,6,8,10,13,15,18,20,22,25,27,28,30,31,32,33,34,35,35,35,35,36,36,36,36,36,36
E01024325,EV motorcycles,Number,1,2,4,6,9,12,16,20,23,27,31,34,38,41,43,46,48,49,51,52,53,53,54,54,54,55,55,55,55,55
E01024326,EV motorcycles,Number,1,2,3,6,9,12,15,19,22,26,30,33,36,39,42,44,46,48,49,50,51,51,52,52,52,53,53,53,53,53
E01024327,EV motorcycles,Number,0,1,2,3,5,7,9,11,13,15,17,19,21,22,24,25,26,27,28,28,29,29,29,30,30,30,30,30,30,30
E01024328,EV motorcycles,Number,0,1,2,3,5,7,8,10,12,14,16,18,20,21,23,24,25,26,27,27,28,28,28,29,29,29,29,29,29,29
E01024329,EV motorcycles,Number,0,1,2,4,6,7,10,12,14,16,18,21,23,24,26,27,29,30,31,31,32,32,32,33,33,33,33,33,33,33
E01024330,EV motorcycles,Number,0,1,2,4,6,7,10,12,14,16,18,21,23,24,26,27,29,30,31,31,32,32,32,33,33,33,33,33,33,33
E01024331,EV motorcycles,Number,1,2,3,6,8,11,14,18,21,25,28,31,34,37,39,42,43,45,46,47,48,49,49,49,49,50,50,50,50,50
E01024332,EV motorcycles,Number,1,2,3,5,8,11,14,17,21,24,27,31,33,36,39,41,43,44,45,46,47,48,48,48,48,49,49,49,49,49
E01024333,EV motorcycles,Number,0,1,2,4,6,7,10,12,14,16,18,21,23,24,26,27,29,30,31,31,32,32,32,33,33,33,33,33,33,33
E01024334,EV motorcycles,Number,0,0,1,1,2,2,3,4,5,5,6,7,8,8,9,9,10,10,10,10,11,11,11,11,11,11,11,11,11,11
E01024335,EV motorcycles,Number,1,2,4,7,10,14,18,22,26,30,35,39,42,46,49,52,54,56,57,59,59,60,61,61,61,62,62,62,62,62
E01024336,EV motorcycles,Number,0,1,2,3,5,6,8,10,11,13,15,17,18,20,21,22,23,24,25,25,26,26,26,27,27,27,27,27,27,27
E01024337,EV motorcycles,Number,1,2,3,5,7,9,12,15,18,21,24,26,29,31,33,35,36,38,39,40,40,41,41,41,42,42,42,42,42,42
E01024338,EV motorcycles,Number,1,1,2,4,6,8,11,13,16,18,21,23,25,27,29,31,32,33,34,35,35,36,36,36,37,37,37,37,37,37
E01024339,EV motorcycles,Number,0,1,2,3,5,7,9,11,13,15,17,19,21,22,24,25,26,27,28,28,29,29,29,30,30,30,30,30,30,30
E01024340,EV motorcycles,Number,1,3,5,8,12,16,20,25,30,34,39,44,48,52,55,58,61,63,65,66,67,68,69,69,69,70,70,70,70,70
E01024341,EV motorcycles,Number,1,1,2,4,6,8,11,13,16,18,21,23,25,27,29,31,32,33,34,35,35,36,36,36,37,37,37,37,37,37
E01024342,EV motorcycles,Number,1,2,4,6,9,12,16,19,23,27,30,34,37,40,43,45,47,49,50,51,52,52,53,53,53,54,54,54,54,54
E01024343,EV motorcycles,Number,1,2,3,6,9,12,15,19,22,26,30,33,36,39,42,44,46,48,49,50,51,51,52,52,52,53,53,53,53,53
E01024344,EV motorcycles,Number,1,2,4,6,9,12,16,20,23,27,31,34,38,41,43,46,48,49,51,52,53,53,54,54,54,55,55,55,55,55
E01024345,EV motorcycles,Number,1,2,3,5,8,11,14,17,21,24,27,31,33,36,39,41,43,44,45,46,47,48,48,48,48,49,49,49,49,49
E01024346,EV motorcycles,Number,1,2,3,6,9,12,15,19,22,26,30,33,36,39,42,44,46,48,49,50,51,51,52,52,52,53,53,53,53,53
E01024347,EV motorcycles,Number,1,2,4,7,11,14,18,22,27,31,35,39,43,47,50,52,55,57,58,59,60,61,62,62,62,63,63,63,63,63
E01024348,EV motorcycles,Number,1,1,2,4,6,8,10,12,15,17,20,22,24,26,28,29,30,31,32,33,34,34,34,34,35,35,35,35,35,35
E01024349,EV motorcycles,Number,0,1,2,3,5,7,8,10,12,14,16,18,20,21,23,24,25,26,27,27,28,28,28,29,29,29,29,29,29,29
E01024350,EV motorcycles,Number,1,2,3,5,7,10,13,16,19,22,25,27,30,33,35,37,38,40,41,42,42,43,43,43,44,44,44,44,44,44
E01024351,EV motorcycles,Number,0,1,2,3,5,7,8,10,12,14,16,18,20,21,23,24,25,26,27,27,28,28,28,29,29,29,29,29,29,29
E01024352,EV motorcycles,Number,0,1,2,3,4,6,8,9,11,13,15,16,18,19,20,22,23,23,24,25,25,25,25,26,26,26,26,26,26,26
E01024353,EV motorcycles,Number,1,1,3,4,7,9,12,14,17,20,22,25,27,30,32,33,35,36,37,38,38,39,39,39,40,40,40,40,40,40
E01024354,EV motorcycles,Number,0,1,2,4,6,8,10,12,14,17,19,21,23,25,27,28,30,31,31,32,33,33,33,33,34,34,34,34,34,34
E01024355,EV motorcycles,Number,0,1,2,3,5,7,9,11,13,15,17,19,21,23,24,26,27,28,29,29,30,30,30,31,31,31,31,31,31,31
E01024356,EV motorcycles,Number,1,1,2,4,6,8,10,12,15,17,20,22,24,26,28,29,30,31,32,33,34,34,34,34,35,35,35,35,35,35
E01024357,EV motorcycles,Number,0,1,2,3,4,5,7,8,10,11,13,14,16,17,18,19,20,21,21,22,22,22,23,23,23,23,23,23,23,23
E01024358,EV motorcycles,Number,0,1,2,3,5,6,8,10,12,14,16,17,19,21,22,23,24,25,26,26,27,27,27,28,28,28,28,28,28,28
E01024360,EV motorcycles,Number,0,1,2,4,6,8,10,12,14,17,19,21,23,25,27,28,30,31,31,32,33,33,33,33,34,34,34,34,34,34
E01024361,EV motorcycles,Number,1,1,3,5,7,9,12,15,17,20,23,26,28,30,32,34,36,37,38,39,39,40,40,40,41,41,41,41,41,41
E01024362,EV motorcycles,Number,2,4,7,12,18,24,30,37,44,52,59,65,72,78,83,87,91,94,97,99,101,102,103,103,104,104,105,105,105,105
E01024363,EV motorcycles,Number,1,3,5,9,14,18,24,29,35,40,46,51,56,61,65,68,71,74,76,77,79,80,80,81,81,81,82,82,82,82
E01024364,EV motorcycles,Number,1,2,4,6,9,13,16,20,24,28,31,35,38,41,44,47,49,50,52,53,54,54,55,55,55,56,56,56,56,56
E01024365,EV motorcycles,Number,1,1,3,4,7,9,11,14,16,19,22,24,27,29,31,32,34,35,36,37,37,38,38,38,39,39,39,39,39,39
E01024366,EV motorcycles,Number,1,2,4,7,11,15,20,24,29,33,38,42,46,50,54,57,59,61,63,64,65,66,67,67,67,68,68,68,68,68
E01024367,EV motorcycles,Number,1,2,3,6,9,12,15,19,22,26,30,33,36,39,42,44,46,48,49,50,51,51,52,52,52,53,53,53,53,53
E01024369,EV motorcycles,Number,1,1,2,4,6,8,10,13,15,18,20,22,25,27,28,30,31,32,33,34,35,35,35,35,36,36,36,36,36,36
E01024371,EV motorcycles,Number,0,1,2,3,5,6,8,10,12,14,16,17,19,21,22,23,24,25,26,26,27,27,27,28,28,28,28,28,28,28
E01024372,EV motorcycles,Number,1,2,3,5,8,10,13,16,19,22,25,28,31,33,35,37,39,40,42,42,43,44,44,44,45,45,45,45,45,45
E01024373,EV motorcycles,Number,1,1,2,4,6,8,10,13,15,18,20,22,25,27,28,30,31,32,33,34,35,35,35,35,36,36,36,36,36,36
E01024374,EV motorcycles,Number,0,1,2,3,4,5,7,8,10,11,13,14,16,17,18,19,20,21,21,22,22,22,23,23,23,23,23,23,23,23
E01024375,EV motorcycles,Number,1,4,6,11,17,22,29,35,42,49,55,62,68,73,78,82,86,89,92,93,95,96,97,98,98,98,99,99,99,99
E01024376,EV motorcycles,Number,1,2,4,6,10,13,17,21,25,29,32,36,40,43,46,48,50,52,54,55,56,56,57,57,57,58,58,58,58,58
E01024377,EV motorcycles,Number,1,2,3,5,8,10,13,16,19,23,26,29,31,34,36,38,40,41,43,43,44,45,45,45,46,46,46,46,46,46
E01024378,EV motorcycles,Number,1,3,5,9,14,18,24,29,35,40,46,51,56,61,65,68,71,74,76,77,79,80,80,81,81,81,82,82,82,82
E01024379,EV motorcycles,Number,1,2,3,5,8,10,13,16,19,22,25,28,31,33,35,37,39,40,42,42,43,44,44,44,45,45,45,45,45,45
E01024380,EV motorcycles,Number,1,2,3,5,8,11,14,17,21,24,27,31,33,36,39,41,43,44,45,46,47,48,48,48,48,49,49,49,49,49
E01024381,EV motorcycles,Number,1,2,3,6,9,11,15,18,22,25,29,32,35,38,40,42,44,46,47,48,49,49,50,50,50,51,51,51,51,51
E01024382,EV motorcycles,Number,0,1,1,2,3,4,5,6,8,9,10,11,12,13,14,15,16,16,17,17,17,17,18,18,18,18,18,18,18,18
E01024383,EV motorcycles,Number,0,1,2,3,4,5,7,9,10,12,13,15,16,18,19,20,21,22,22,23,23,23,23,24,24,24,24,24,24,24
E01024384,EV motorcycles,Number,1,2,3,6,9,12,15,19,22,26,30,33,36,39,42,44,46,48,49,50,51,51,52,52,52,53,53,53,53,53
E01024385,EV motorcycles,Number,1,2,3,6,9,12,15,18,22,26,29,32,36,38,41,43,45,47,48,49,50,50,51,51,51,52,52,52,52,52
E01024386,EV motorcycles,Number,1,2,3,5,8,10,13,16,19,23,26,29,31,34,36,38,40,41,43,43,44,45,45,45,46,46,46,46,46,46
E01024387,EV motorcycles,Number,1,4,7,11,17,22,29,36,42,49,56,62,68,74,79,83,87,90,92,94,96,97,98,99,99,99,100,100,100,100
E01024388,EV motorcycles,Number,2,4,7,12,18,24,30,37,44,52,59,65,72,78,83,87,91,94,97,99,101,102,103,103,104,104,105,105,105,105
E01024389,EV motorcycles,Number,0,1,2,4,6,8,10,12,14,17,19,21,23,25,27,28,30,31,31,32,33,33,33,33,34,34,34,34,34,34
E01024390,EV motorcycles,Number,0,1,2,4,5,7,9,11,14,16,18,20,22,24,25,27,28,29,30,30,31,31,31,32,32,32,32,32,32,32
E01024391,EV motorcycles,Number,0,1,2,3,4,6,8,9,11,13,15,16,18,19,20,22,23,23,24,25,25,25,25,26,26,26,26,26,26,26
E01024392,EV motorcycles,Number,0,1,2,4,6,7,10,12,14,16,18,21,23,24,26,27,29,30,31,31,32,32,32,33,33,33,33,33,33,33
E01024393,EV motorcycles,Number,1,1,2,4,6,9,11,13,16,19,21,24,26,28,30,32,33,34,35,36,36,37,37,37,38,38,38,38,38,38
E01024394,EV motorcycles,Number,1,1,2,4,6,8,11,13,16,18,21,23,25,27,29,31,32,33,34,35,35,36,36,36,37,37,37,37,37,37
E01024395,EV motorcycles,Number,1,2,4,7,11,15,19,23,28,32,37,41,45,49,52,55,57,59,61,62,63,64,65,65,65,66,66,66,66,66
E01024396,EV motorcycles,Number,0,1,2,4,6,8,10,12,14,17,19,21,23,25,27,28,30,31,31,32,33,33,33,33,34,34,34,34,34,34
E01024397,EV motorcycles,Number,0,1,2,3,5,7,9,11,13,15,17,19,21,23,24,26,27,28,29,29,30,30,30,31,31,31,31,31,31,31
E01024398,EV motorcycles,Number,1,1,3,4,7,9,11,14,16,19,22,24,27,29,31,32,34,35,36,37,37,38,38,38,39,39,39,39,39,39
E01024399,EV motorcycles,Number,0,1,2,3,5,7,9,11,13,15,17,19,21,23,24,26,27,28,29,29,30,30,30,31,31,31,31,31,31,31
E01024400,EV motorcycles,Number,1,2,3,5,8,11,14,17,21,24,27,31,33,36,39,41,43,44,45,46,47,48,48,48,48,49,49,49,49,49
E01024401,EV motorcycles,Number,1,2,3,5,7,10,13,16,19,22,25,27,30,33,35,37,38,40,41,42,42,43,43,43,44,44,44,44,44,44
E01024402,EV motorcycles,Number,2,5,10,16,25,33,43,52,62,72,82,92,100,109,116,122,128,132,136,139,141,143,144,145,145,146,147,147,147,147
E01024403,EV motorcycles,Number,1,2,3,5,8,11,14,17,20,24,27,30,33,35,38,40,42,43,44,45,46,47,47,47,48,48,48,48,48,48
E01024404,EV motorcycles,Number,0,1,2,3,4,5,7,8,10,11,13,14,16,17,18,19,20,21,21,22,22,22,23,23,23,23,23,23,23,23
E01024405,EV motorcycles,Number,1,2,4,6,10,13,16,20,24,28,32,35,39,42,45,47,50,51,53,54,55,55,56,56,56,57,57,57,57,57
E01024406,EV motorcycles,Number,1,2,3,5,8,11,14,17,21,24,27,31,33,36,39,41,43,44,45,46,47,48,48,48,48,49,49,49,49,49
E01024407,EV motorcycles,Number,1,2,5,8,12,15,20,25,29,34,39,43,47,51,54,57,60,62,64,65,66,67,68,68,68,69,69,69,69,69
E01024408,EV motorcycles,Number,1,1,2,4,6,9,11,13,16,19,21,24,26,28,30,32,33,34,35,36,36,37,37,37,38,38,38,38,38,38
E01024409,EV motorcycles,Number,0,1,2,4,5,7,9,11,14,16,18,20,22,24,25,27,28,29,30,30,31,31,31,32,32,32,32,32,32,32
E01024410,EV motorcycles,Number,1,3,5,9,14,19,24,30,36,41,47,52,57,62,66,70,73,76,78,79,81,82,82,83,83,83,84,84,84,84
E01024411,EV motorcycles,Number,1,1,2,4,6,8,11,13,16,18,21,23,25,27,29,31,32,33,34,35,35,36,36,36,37,37,37,37,37,37
E01024413,EV motorcycles,Number,1,1,2,4,6,8,10,12,15,17,20,22,24,26,28,29,30,31,32,33,34,34,34,34,35,35,35,35,35,35
E01024414,EV motorcycles,Number,1,2,3,5,8,10,13,16,19,22,25,28,31,33,35,37,39,40,42,42,43,44,44,44,45,45,45,45,45,45
E01024415,EV motorcycles,Number,0,1,2,3,4,6,7,9,11,12,14,16,17,18,20,21,22,22,23,24,24,24,24,25,25,25,25,25,25,25
E01024416,EV motorcycles,Number,1,2,4,6,9,12,16,19,23,27,30,34,37,40,43,45,47,49,50,51,52,52,53,53,53,54,54,54,54,54
E01024417,EV motorcycles,Number,1,2,4,7,11,14,19,23,27,31,36,40,44,47,50,53,56,58,59,60,61,62,63,63,63,64,64,64,64,64
E01024418,EV motorcycles,Number,0,1,2,4,6,7,10,12,14,16,18,21,23,24,26,27,29,30,31,31,32,32,32,33,33,33,33,33,33,33
E01024419,EV motorcycles,Number,1,2,3,5,8,11,14,17,20,24,27,30,33,35,38,40,42,43,44,45,46,47,47,47,48,48,48,48,48,48
E01024420,EV motorcycles,Number,1,3,5,9,14,19,24,29,35,41,46,52,57,61,65,69,72,75,77,78,80,81,81,82,82,82,83,83,83,83
E01024421,EV motorcycles,Number,1,3,5,8,13,17,22,27,32,37,43,47,52,56,60,63,66,68,70,72,73,74,74,75,75,75,76,76,76,76
E01024422,EV motorcycles,Number,1,3,5,8,12,16,21,26,31,36,41,45,50,54,58,61,63,66,67,69,70,71,71,72,72,72,73,73,73,73
E01024423,EV motorcycles,Number,0,1,2,4,5,7,9,11,14,16,18,20,22,24,25,27,28,29,30,30,31,31,31,32,32,32,32,32,32,32
E01024424,EV motorcycles,Number,0,1,2,3,4,5,7,9,10,12,13,15,16,18,19,20,21,22,22,23,23,23,23,24,24,24,24,24,24,24
E01024425,EV motorcycles,Number,1,2,3,5,7,10,12,15,18,21,24,27,29,32,34,36,37,39,40,41,41,42,42,42,43,43,43,43,43,43
E01024426,EV motorcycles,Number,1,2,4,7,11,15,20,24,29,33,38,42,46,50,54,57,59,61,63,64,65,66,67,67,67,68,68,68,68,68
E01024427,EV motorcycles,Number,1,2,3,5,7,9,12,15,18,21,24,26,29,31,33,35,36,38,39,40,40,41,41,41,42,42,42,42,42,42
E01024428,EV motorcycles,Number,0,1,2,3,5,6,8,10,12,14,16,17,19,21,22,23,24,25,26,26,27,27,27,28,28,28,28,28,28,28
E01024429,EV motorcycles,Number,1,2,3,5,7,9,12,15,18,21,24,26,29,31,33,35,36,38,39,40,40,41,41,41,42,42,42,42,42,42
E01024430,EV motorcycles,Number,1,2,4,7,10,13,17,21,25,30,34,37,41,44,47,50,52,54,55,57,58,58,59,59,59,60,60,60,60,60
E01024431,EV motorcycles,Number,1,3,5,8,12,16,21,26,30,35,40,45,49,53,57,60,63,65,67,68,69,70,70,71,71,71,72,72,72,72
E01024432,EV motorcycles,Number,1,2,3,5,7,10,13,16,19,22,25,27,30,33,35,37,38,40,41,42,42,43,43,43,44,44,44,44,44,44
E01024433,EV motorcycles,Number,1,2,4,6,9,12,16,20,23,27,31,34,38,41,43,46,48,49,51,52,53,53,54,54,54,55,55,55,55,55
E01024434,EV motorcycles,Number,1,2,3,5,8,10,13,16,19,23,26,29,31,34,36,38,40,41,43,43,44,45,45,45,46,46,46,46,46,46
E01024435,EV motorcycles,Number,1,2,5,8,12,15,20,25,29,34,39,43,47,51,54,57,60,62,64,65,66,67,68,68,68,69,69,69,69,69
E01024436,EV motorcycles,Number,1,2,4,7,11,14,19,23,27,31,36,40,44,47,50,53,56,58,59,60,61,62,63,63,63,64,64,64,64,64
E01024437,EV motorcycles,Number,1,3,5,9,14,18,24,29,35,40,46,51,56,61,65,68,71,74,76,77,79,80,80,81,81,81,82,82,82,82
E01024438,EV motorcycles,Number,1,3,6,10,15,20,26,32,38,45,51,57,62,67,72,76,79,82,84,86,87,88,89,90,90,90,91,91,91,91
E01024439,EV motorcycles,Number,1,2,3,6,9,12,15,19,22,26,30,33,36,39,42,44,46,48,49,50,51,51,52,52,52,53,53,53,53,53
E01024440,EV motorcycles,Number,1,3,5,9,13,18,23,28,33,39,44,49,54,58,62,66,69,71,73,75,76,77,77,78,78,78,79,79,79,79
E01024441,EV motorcycles,Number,1,2,3,5,8,10,13,16,19,22,25,28,31,33,35,37,39,40,42,42,43,44,44,44,45,45,45,45,45,45
E01024442,EV motorcycles,Number,1,2,3,6,9,11,15,18,22,25,29,32,35,38,40,42,44,46,47,48,49,49,50,50,50,51,51,51,51,51
E01024443,EV motorcycles,Number,0,1,2,4,6,8,10,12,14,17,19,21,23,25,27,28,30,31,31,32,33,33,33,33,34,34,34,34,34,34
E01024444,EV motorcycles,Number,0,1,1,2,4,5,6,8,9,11,12,14,15,16,17,18,19,20,20,21,21,21,22,22,22,22,22,22,22,22
E01024445,EV motorcycles,Number,0,1,2,3,5,6,8,10,11,13,15,17,18,20,21,22,23,24,25,25,26,26,26,27,27,27,27,27,27,27
E01024446,EV motorcycles,Number,1,2,3,5,7,10,12,15,18,21,24,27,29,32,34,36,37,39,40,41,41,42,42,42,43,43,43,43,43,43
E01024447,EV motorcycles,Number,1,1,2,4,6,8,11,13,16,18,21,23,25,27,29,31,32,33,34,35,35,36,36,36,37,37,37,37,37,37
E01024448,EV motorcycles,Number,0,1,2,4,6,8,10,12,14,17,19,21,23,25,27,28,30,31,31,32,33,33,33,33,34,34,34,34,34,34
E01024449,EV motorcycles,Number,0,1,2,3,5,7,9,11,13,15,17,19,21,22,24,25,26,27,28,28,29,29,29,30,30,30,30,30,30,30
E01024450,EV motorcycles,Number,1,2,3,5,7,9,12,15,18,21,24,26,29,31,33,35,36,38,39,40,40,41,41,41,42,42,42,42,42,42
E01024451,EV motorcycles,Number,1,3,6,10,15,20,26,32,38,44,50,56,62,67,71,75,78,81,83,85,86,87,88,89,89,89,90,90,90,90
E01024452,EV motorcycles,Number,0,1,2,3,4,6,8,9,11,13,15,16,18,19,20,22,23,23,24,25,25,25,25,26,26,26,26,26,26,26
E01024453,EV motorcycles,Number,0,1,2,3,4,6,8,9,11,13,15,16,18,19,20,22,23,23,24,25,25,25,25,26,26,26,26,26,26,26
E01024454,EV motorcycles,Number,1,2,3,5,7,10,13,16,19,22,25,27,30,33,35,37,38,40,41,42,42,43,43,43,44,44,44,44,44,44
E01024455,EV motorcycles,Number,1,1,2,4,6,8,11,13,16,18,21,23,25,27,29,31,32,33,34,35,35,36,36,36,37,37,37,37,37,37
E01024456,EV motorcycles,Number,1,1,3,4,7,9,12,14,17,20,22,25,27,30,32,33,35,36,37,38,38,39,39,39,40,40,40,40,40,40
E01024457,EV motorcycles,Number,0,1,2,3,5,6,8,10,11,13,15,17,18,20,21,22,23,24,25,25,26,26,26,27,27,27,27,27,27,27
E01024458,EV motorcycles,Number,1,1,3,4,7,9,12,14,17,20,22,25,27,30,32,33,35,36,37,38,38,39,39,39,40,40,40,40,40,40
E01024459,EV motorcycles,Number,1,2,4,6,10,13,16,20,24,28,32,35,39,42,45,47,50,51,53,54,55,55,56,56,56,57,57,57,57,57
E01024460,EV motorcycles,Number,1,1,3,4,7,9,11,14,16,19,22,24,27,29,31,32,34,35,36,37,37,38,38,38,39,39,39,39,39,39
E01024461,EV motorcycles,Number,1,1,3,4,7,9,11,14,16,19,22,24,27,29,31,32,34,35,36,37,37,38,38,38,39,39,39,39,39,39
E01024462,EV motorcycles,Number,1,2,3,5,7,9,12,15,18,21,24,26,29,31,33,35,36,38,39,40,40,41,41,41,42,42,42,42,42,42
E01024463,EV motorcycles,Number,0,1,1,2,3,4,6,7,8,10,11,12,14,15,16,17,17,18,18,19,19,19,20,20,20,20,20,20,20,20
E01024464,EV motorcycles,Number,1,2,3,5,8,11,14,17,20,24,27,30,33,35,38,40,42,43,44,45,46,47,47,47,48,48,48,48,48,48
E01024465,EV motorcycles,Number,0,1,2,4,6,8,10,12,14,17,19,21,23,25,27,28,30,31,31,32,33,33,33,33,34,34,34,34,34,34
E01024466,EV motorcycles,Number,0,1,2,4,5,7,9,11,14,16,18,20,22,24,25,27,28,29,30,30,31,31,31,32,32,32,32,32,32,32
E01024467,EV motorcycles,Number,1,2,3,5,7,10,12,15,18,21,24,27,29,32,34,36,37,39,40,41,41,42,42,42,43,43,43,43,43,43
E01024468,EV motorcycles,Number,0,1,2,3,4,6,7,9,11,12,14,16,17,18,20,21,22,22,23,24,24,24,24,25,25,25,25,25,25,25
E01024469,EV motorcycles,Number,0,1,1,2,4,5,6,7,9,10,12,13,14,16,17,17,18,19,19,20,20,20,21,21,21,21,21,21,21,21
E01024470,EV motorcycles,Number,0,1,1,2,3,3,4,5,6,7,8,9,10,11,12,12,13,13,14,14,14,15,15,15,15,15,15,15,15,15
E01024471,EV motorcycles,Number,0,1,1,2,4,5,6,8,9,11,12,14,15,16,17,18,19,20,20,21,21,21,22,22,22,22,22,22,22,22
E01024472,EV motorcycles,Number,0,1,2,3,4,6,8,9,11,13,15,16,18,19,20,22,23,23,24,25,25,25,25,26,26,26,26,26,26,26
E01024473,EV motorcycles,Number,1,2,4,6,10,13,16,20,24,28,32,35,39,42,45,47,50,51,53,54,55,55,56,56,56,57,57,57,57,57
E01024474,EV motorcycles,Number,1,2,4,6,9,12,16,20,23,27,31,34,38,41,43,46,48,49,51,52,53,53,54,54,54,55,55,55,55,55
E01024475,EV motorcycles,Number,0,1,1,2,3,4,5,6,7,8,9,10,11,12,13,13,14,14,15,15,15,16,16,16,16,16,16,16,16,16
E01024476,EV motorcycles,Number,0,1,2,3,5,7,8,10,12,14,16,18,20,21,23,24,25,26,27,27,28,28,28,29,29,29,29,29,29,29
E01024477,EV motorcycles,Number,1,2,3,5,7,10,13,16,19,22,25,27,30,33,35,37,38,40,41,42,42,43,43,43,44,44,44,44,44,44
E01024478,EV motorcycles,Number,0,1,2,3,5,7,9,11,13,15,17,19,21,22,24,25,26,27,28,28,29,29,29,30,30,30,30,30,30,30
E01024479,EV motorcycles,Number,0,1,2,3,5,7,9,11,13,15,17,19,21,22,24,25,26,27,28,28,29,29,29,30,30,30,30,30,30,30
E01024480,EV motorcycles,Number,0,1,2,3,4,5,7,9,10,12,13,15,16,18,19,20,21,22,22,23,23,23,23,24,24,24,24,24,24,24
E01024481,EV motorcycles,Number,1,2,3,5,8,11,14,17,20,23,26,29,32,35,37,39,41,42,43,44,45,46,46,46,47,47,47,47,47,47
E01024482,EV motorcycles,Number,0,1,2,3,5,7,9,11,13,15,17,19,21,22,24,25,26,27,28,28,29,29,29,30,30,30,30,30,30,30
E01024483,EV motorcycles,Number,1,1,3,5,7,9,12,15,17,20,23,26,28,30,32,34,36,37,38,39,39,40,40,40,41,41,41,41,41,41
E01024484,EV motorcycles,Number,1,2,3,6,9,11,15,18,22,25,29,32,35,38,40,42,44,46,47,48,49,49,50,50,50,51,51,51,51,51
E01024485,EV motorcycles,Number,1,2,4,6,10,13,17,21,25,29,32,36,40,43,46,48,50,52,54,55,56,56,57,57,57,58,58,58,58,58
E01024486,EV motorcycles,Number,1,3,5,8,12,16,20,25,30,34,39,44,48,52,55,58,61,63,65,66,67,68,69,69,69,70,70,70,70,70
E01024487,EV motorcycles,Number,1,1,3,5,7,9,12,15,17,20,23,26,28,30,32,34,36,37,38,39,39,40,40,40,41,41,41,41,41,41
E01024488,EV motorcycles,Number,1,1,2,4,6,8,10,12,15,17,20,22,24,26,28,29,30,31,32,33,34,34,34,34,35,35,35,35,35,35
E01024489,EV motorcycles,Number,1,3,5,8,13,17,22,27,32,37,42,47,51,55,59,62,65,67,69,71,72,73,73,74,74,74,75,75,75,75
E01024490,EV motorcycles,Number,1,3,6,10,15,20,26,32,38,44,50,55,61,66,70,74,77,80,82,84,85,86,87,88,88,88,89,89,89,89
E01024491,EV motorcycles,Number,1,2,3,5,7,10,13,16,19,22,25,27,30,33,35,37,38,40,41,42,42,43,43,43,44,44,44,44,44,44
E01024492,EV motorcycles,Number,0,1,1,2,4,5,6,7,9,10,12,13,14,16,17,17,18,19,19,20,20,20,21,21,21,21,21,21,21,21
E01024493,EV motorcycles,Number,1,1,2,4,6,8,11,13,16,18,21,23,25,27,29,31,32,33,34,35,35,36,36,36,37,37,37,37,37,37
E01024494,EV motorcycles,Number,1,2,3,5,7,10,12,15,18,21,24,27,29,32,34,36,37,39,40,41,41,42,42,42,43,43,43,43,43,43
E01024495,EV motorcycles,Number,0,1,2,3,4,5,7,9,10,12,13,15,16,18,19,20,21,22,22,23,23,23,23,24,24,24,24,24,24,24
E01024496,EV motorcycles,Number,1,1,2,4,6,8,11,13,16,18,21,23,25,27,29,31,32,33,34,35,35,36,36,36,37,37,37,37,37,37
E01024497,EV motorcycles,Number,1,2,3,5,8,10,13,16,19,23,26,29,31,34,36,38,40,41,43,43,44,45,45,45,46,46,46,46,46,46
E01024498,EV motorcycles,Number,0,0,1,1,2,2,3,4,5,5,6,7,8,8,9,9,10,10,10,10,11,11,11,11,11,11,11,11,11,11
E01024499,EV motorcycles,Number,0,1,2,3,4,5,7,8,10,11,13,14,16,17,18,19,20,21,21,22,22,22,23,23,23,23,23,23,23,23
E01024500,EV motorcycles,Number,0,1,1,2,3,4,5,7,8,9,11,12,13,14,15,16,17,17,18,18,18,18,19,19,19,19,19,19,19,19
E01024501,EV motorcycles,Number,0,1,2,3,4,5,7,8,10,11,13,14,16,17,18,19,20,21,21,22,22,22,23,23,23,23,23,23,23,23
E01024502,EV motorcycles,Number,0,1,1,2,3,4,5,6,7,8,9,10,11,12,13,13,14,14,15,15,15,16,16,16,16,16,16,16,16,16
E01024503,EV motorcycles,Number,1,2,3,5,8,10,13,16,19,22,25,28,31,33,35,37,39,40,42,42,43,44,44,44,45,45,45,45,45,45
E01024504,EV motorcycles,Number,0,1,2,3,4,5,7,9,10,12,13,15,16,18,19,20,21,22,22,23,23,23,23,24,24,24,24,24,24,24
E01024505,EV motorcycles,Number,0,1,2,3,5,6,8,10,11,13,15,17,18,20,21,22,23,24,25,25,26,26,26,27,27,27,27,27,27,27
E01024507,EV motorcycles,Number,0,1,2,3,5,7,8,10,12,14,16,18,20,21,23,24,25,26,27,27,28,28,28,29,29,29,29,29,29,29
E01024508,EV motorcycles,Number,0,0,1,1,2,3,4,5,5,6,7,8,9,10,10,11,11,12,12,12,12,13,13,13,13,13,13,13,13,13
E01024509,EV motorcycles,Number,0,1,1,2,2,3,4,5,6,7,8,9,10,10,11,12,12,13,13,13,13,14,14,14,14,14,14,14,14,14
E01024510,EV motorcycles,Number,0,1,2,3,5,7,8,10,12,14,16,18,20,21,23,24,25,26,27,27,28,28,28,29,29,29,29,29,29,29
E01024511,EV motorcycles,Number,0,1,2,3,4,6,8,9,11,13,15,16,18,19,20,22,23,23,24,25,25,25,25,26,26,26,26,26,26,26
E01024512,EV motorcycles,Number,0,1,2,4,6,7,10,12,14,16,18,21,23,24,26,27,29,30,31,31,32,32,32,33,33,33,33,33,33,33
E01024513,EV motorcycles,Number,1,1,3,5,7,9,12,15,17,20,23,26,28,30,32,34,36,37,38,39,39,40,40,40,41,41,41,41,41,41
E01024514,EV motorcycles,Number,1,1,3,4,7,9,11,14,16,19,22,24,27,29,31,32,34,35,36,37,37,38,38,38,39,39,39,39,39,39
E01024515,EV motorcycles,Number,1,2,3,5,7,10,13,16,19,22,25,27,30,33,35,37,38,40,41,42,42,43,43,43,44,44,44,44,44,44
E01024516,EV motorcycles,Number,0,1,2,3,5,7,9,11,13,15,17,19,21,22,24,25,26,27,28,28,29,29,29,30,30,30,30,30,30,30
E01024517,EV motorcycles,Number,0,1,2,3,4,6,8,9,11,13,15,16,18,19,20,22,23,23,24,25,25,25,25,26,26,26,26,26,26,26
E01024518,EV motorcycles,Number,1,1,2,4,6,8,10,12,15,17,20,22,24,26,28,29,30,31,32,33,34,34,34,34,35,35,35,35,35,35
E01024519,EV motorcycles,Number,1,2,3,5,8,11,14,17,20,24,27,30,33,35,38,40,42,43,44,45,46,47,47,47,48,48,48,48,48,48
E01024520,EV motorcycles,Number,1,1,2,4,6,8,10,12,15,17,20,22,24,26,28,29,30,31,32,33,34,34,34,34,35,35,35,35,35,35
E01024521,EV motorcycles,Number,0,1,2,3,4,6,8,9,11,13,15,16,18,19,20,22,23,23,24,25,25,25,25,26,26,26,26,26,26,26
E01024522,EV motorcycles,Number,0,1,2,3,5,7,9,11,13,15,17,19,21,23,24,26,27,28,29,29,30,30,30,31,31,31,31,31,31,31
E01024523,EV motorcycles,Number,0,1,2,3,5,7,9,11,13,15,17,19,21,22,24,25,26,27,28,28,29,29,29,30,30,30,30,30,30,30
E01024524,EV motorcycles,Number,0,1,2,4,6,7,10,12,14,16,18,21,23,24,26,27,29,30,31,31,32,32,32,33,33,33,33,33,33,33
E01024525,EV motorcycles,Number,0,1,1,2,3,4,5,6,7,8,10,11,12,13,13,14,15,15,16,16,16,16,17,17,17,17,17,17,17,17
E01024526,EV motorcycles,Number,1,2,3,5,8,11,14,17,21,24,27,31,33,36,39,41,43,44,45,46,47,48,48,48,48,49,49,49,49,49
E01024527,EV motorcycles,Number,0,1,2,4,5,7,9,11,14,16,18,20,22,24,25,27,28,29,30,30,31,31,31,32,32,32,32,32,32,32
E01024528,EV motorcycles,Number,0,1,1,2,3,4,5,7,8,9,11,12,13,14,15,16,17,17,18,18,18,18,19,19,19,19,19,19,19,19
E01024529,EV motorcycles,Number,1,2,3,5,8,11,14,17,21,24,27,31,33,36,39,41,43,44,45,46,47,48,48,48,48,49,49,49,49,49
E01024530,EV motorcycles,Number,1,3,5,8,13,17,22,27,33,38,43,48,53,57,61,64,67,69,71,73,74,75,75,76,76,76,77,77,77,77
E01024531,EV motorcycles,Number,1,2,3,5,7,9,12,15,18,21,24,26,29,31,33,35,36,38,39,40,40,41,41,41,42,42,42,42,42,42
E01024532,EV motorcycles,Number,1,3,5,9,13,18,23,28,34,39,45,50,55,59,63,67,70,72,74,76,77,78,78,79,79,79,80,80,80,80
E01024533,EV motorcycles,Number,1,3,6,10,15,20,26,32,38,45,51,57,62,67,72,76,79,82,84,86,87,88,89,90,90,90,91,91,91,91
E01024534,EV motorcycles,Number,1,2,4,7,11,14,19,23,27,31,36,40,44,47,50,53,56,58,59,60,61,62,63,63,63,64,64,64,64,64
E01024535,EV motorcycles,Number,2,4,7,12,18,24,31,38,45,52,59,66,72,78,84,88,92,95,98,100,102,103,104,104,105,105,106,106,106,106
E01024536,EV motorcycles,Number,1,2,5,8,12,15,20,25,29,34,39,43,47,51,54,57,60,62,64,65,66,67,68,68,68,69,69,69,69,69
E01024537,EV motorcycles,Number,1,3,5,9,14,18,24,29,35,40,46,51,56,61,65,68,71,74,76,77,79,80,80,81,81,81,82,82,82,82
E01024538,EV motorcycles,Number,1,2,4,7,10,14,18,22,26,30,34,38,42,45,48,51,53,55,56,58,58,59,60,60,60,61,61,61,61,61
E01024539,EV motorcycles,Number,1,2,4,7,10,14,18,22,26,30,35,39,42,46,49,52,54,56,57,59,59,60,61,61,61,62,62,62,62,62
E01024540,EV motorcycles,Number,1,2,3,6,9,12,15,19,22,26,30,33,36,39,42,44,46,48,49,50,51,51,52,52,52,53,53,53,53,53
E01024541,EV motorcycles,Number,1,3,6,9,14,19,25,31,36,42,48,54,59,64,68,72,75,77,79,81,82,83,84,85,85,85,86,86,86,86
E01024542,EV motorcycles,Number,1,2,4,7,11,15,20,24,29,33,38,42,46,50,54,57,59,61,63,64,65,66,67,67,67,68,68,68,68,68
E01024544,EV motorcycles,Number,1,4,6,11,16,22,28,35,41,48,55,61,67,72,77,82,85,88,91,93,94,95,96,97,97,97,98,98,98,98
E01024545,EV motorcycles,Number,1,2,3,6,9,12,15,18,22,26,29,32,36,38,41,43,45,47,48,49,50,50,51,51,51,52,52,52,52,52
E01024546,EV motorcycles,Number,1,2,4,7,10,13,17,21,25,29,33,37,40,44,47,49,51,53,55,56,57,57,58,58,58,59,59,59,59,59
E01024547,EV motorcycles,Number,0,1,2,3,5,6,8,10,12,14,16,17,19,21,22,23,24,25,26,26,27,27,27,28,28,28,28,28,28,28
E01024548,EV motorcycles,Number,1,3,6,10,15,20,26,32,38,44,50,55,61,66,70,74,77,80,82,84,85,86,87,88,88,88,89,89,89,89
E01024549,EV motorcycles,Number,1,3,5,8,12,16,21,25,30,35,40,44,49,52,56,59,62,64,66,67,68,69,70,70,70,71,71,71,71,71
E01024550,EV motorcycles,Number,1,4,7,11,17,22,29,36,42,49,56,62,68,74,79,83,87,90,92,94,96,97,98,99,99,99,100,100,100,100
E01024551,EV motorcycles,Number,0,1,2,4,6,7,10,12,14,16,18,21,23,24,26,27,29,30,31,31,32,32,32,33,33,33,33,33,33,33
E01024552,EV motorcycles,Number,1,2,3,5,8,11,14,17,21,24,27,31,33,36,39,41,43,44,45,46,47,48,48,48,48,49,49,49,49,49
E01024553,EV motorcycles,Number,0,1,1,2,4,5,6,8,9,11,12,14,15,16,17,18,19,20,20,21,21,21,22,22,22,22,22,22,22,22
E01024554,EV motorcycles,Number,2,4,8,13,19,26,33,41,49,57,64,72,79,85,91,96,100,103,106,109,110,112,113,113,114,114,115,115,115,115
E01024555,EV motorcycles,Number,1,1,2,4,6,8,10,12,15,17,20,22,24,26,28,29,30,31,32,33,34,34,34,34,35,35,35,35,35,35
E01024556,EV motorcycles,Number,1,2,4,7,11,14,18,22,27,31,35,39,43,47,50,52,55,57,58,59,60,61,62,62,62,63,63,63,63,63
E01024557,EV motorcycles,Number,1,2,3,5,8,11,14,17,20,23,26,29,32,35,37,39,41,42,43,44,45,46,46,46,47,47,47,47,47,47
E01024558,EV motorcycles,Number,1,4,7,11,17,23,30,37,44,51,58,64,70,76,81,86,89,93,95,97,99,100,101,101,102,102,103,103,103,103
E01024559,EV motorcycles,Number,0,1,2,3,5,7,9,11,13,15,17,19,21,23,24,26,27,28,29,29,30,30,30,31,31,31,31,31,31,31
E01024560,EV motorcycles,Number,0,1,1,2,3,4,6,7,8,10,11,12,14,15,16,17,17,18,18,19,19,19,20,20,20,20,20,20,20,20
E01024561,EV motorcycles,Number,0,1,2,3,5,6,8,10,11,13,15,17,18,20,21,22,23,24,25,25,26,26,26,27,27,27,27,27,27,27
E01024562,EV motorcycles,Number,1,1,2,4,6,8,10,13,15,18,20,22,25,27,28,30,31,32,33,34,35,35,35,35,36,36,36,36,36,36
E01024563,EV motorcycles,Number,0,1,1,2,3,4,6,7,8,10,11,12,14,15,16,17,17,18,18,19,19,19,20,20,20,20,20,20,20,20
E01024564,EV motorcycles,Number,0,1,1,2,3,4,5,6,8,9,10,11,12,13,14,15,16,16,17,17,17,17,18,18,18,18,18,18,18,18
E01024565,EV motorcycles,Number,1,2,3,6,8,11,14,18,21,25,28,31,34,37,39,42,43,45,46,47,48,49,49,49,49,50,50,50,50,50
E01024566,EV motorcycles,Number,1,3,5,8,12,16,21,25,30,35,40,44,49,52,56,59,62,64,66,67,68,69,70,70,70,71,71,71,71,71
E01024567,EV motorcycles,Number,1,2,4,6,9,13,16,20,24,28,31,35,38,41,44,47,49,50,52,53,54,54,55,55,55,56,56,56,56,56
E01024568,EV motorcycles,Number,1,3,6,9,14,19,25,30,36,42,48,53,58,63,67,71,74,76,79,80,82,82,83,84,84,84,85,85,85,85
E01024569,EV motorcycles,Number,1,2,3,5,7,10,13,16,19,22,25,27,30,33,35,37,38,40,41,42,42,43,43,43,44,44,44,44,44,44
E01024570,EV motorcycles,Number,1,1,2,4,6,8,11,13,16,18,21,23,25,27,29,31,32,33,34,35,35,36,36,36,37,37,37,37,37,37
E01024571,EV motorcycles,Number,1,2,3,5,8,11,14,17,21,24,27,31,33,36,39,41,43,44,45,46,47,48,48,48,48,49,49,49,49,49
E01024572,EV motorcycles,Number,1,2,3,5,7,10,13,16,19,22,25,27,30,33,35,37,38,40,41,42,42,43,43,43,44,44,44,44,44,44
E01024573,EV motorcycles,Number,1,1,2,4,6,8,11,13,16,18,21,23,25,27,29,31,32,33,34,35,35,36,36,36,37,37,37,37,37,37
E01024575,EV motorcycles,Number,1,2,3,6,9,11,15,18,22,25,29,32,35,38,40,42,44,46,47,48,49,49,50,50,50,51,51,51,51,51
E01024576,EV motorcycles,Number,1,3,5,8,12,16,21,25,30,35,40,44,49,52,56,59,62,64,66,67,68,69,70,70,70,71,71,71,71,71
E01024577,EV motorcycles,Number,1,1,2,4,6,9,11,13,16,19,21,24,26,28,30,32,33,34,35,36,36,37,37,37,38,38,38,38,38,38
E01024578,EV motorcycles,Number,1,1,3,4,7,9,12,14,17,20,22,25,27,30,32,33,35,36,37,38,38,39,39,39,40,40,40,40,40,40
E01024579,EV motorcycles,Number,1,2,3,6,9,12,15,18,22,26,29,32,36,38,41,43,45,47,48,49,50,50,51,51,51,52,52,52,52,52
E01024580,EV motorcycles,Number,1,2,3,5,8,11,14,17,20,24,27,30,33,35,38,40,42,43,44,45,46,47,47,47,48,48,48,48,48,48
E01024581,EV motorcycles,Number,1,2,3,6,9,11,15,18,22,25,29,32,35,38,40,42,44,46,47,48,49,49,50,50,50,51,51,51,51,51
E01024582,EV motorcycles,Number,1,2,4,7,11,15,19,23,27,32,36,40,44,48,51,54,56,58,60,61,62,63,64,64,64,65,65,65,65,65
E01024583,EV motorcycles,Number,1,2,4,7,10,14,18,22,26,30,35,39,42,46,49,52,54,56,57,59,59,60,61,61,61,62,62,62,62,62
E01024584,EV motorcycles,Number,0,1,2,3,5,7,8,10,12,14,16,18,20,21,23,24,25,26,27,27,28,28,28,29,29,29,29,29,29,29
E01024585,EV motorcycles,Number,0,1,2,3,5,7,9,11,13,15,17,19,21,23,24,26,27,28,29,29,30,30,30,31,31,31,31,31,31,31
E01024586,EV motorcycles,Number,1,2,3,5,8,11,14,17,20,24,27,30,33,35,38,40,42,43,44,45,46,47,47,47,48,48,48,48,48,48
E01024587,EV motorcycles,Number,1,3,5,9,13,18,23,28,33,39,44,49,54,58,62,66,69,71,73,75,76,77,77,78,78,78,79,79,79,79
E01024588,EV motorcycles,Number,1,2,4,7,10,13,17,21,25,29,33,37,40,44,47,49,51,53,55,56,57,57,58,58,58,59,59,59,59,59
E01024589,EV motorcycles,Number,1,2,3,6,9,12,15,18,22,26,29,32,36,38,41,43,45,47,48,49,50,50,51,51,51,52,52,52,52,52
E01024590,EV motorcycles,Number,0,1,2,3,5,7,8,10,12,14,16,18,20,21,23,24,25,26,27,27,28,28,28,29,29,29,29,29,29,29
E01024591,EV motorcycles,Number,1,2,4,6,9,12,16,20,23,27,31,34,38,41,43,46,48,49,51,52,53,53,54,54,54,55,55,55,55,55
E01024592,EV motorcycles,Number,0,1,2,3,4,5,7,9,10,12,13,15,16,18,19,20,21,22,22,23,23,23,23,24,24,24,24,24,24,24
E01024593,EV motorcycles,Number,0,1,2,3,5,6,8,10,11,13,15,17,18,20,21,22,23,24,25,25,26,26,26,27,27,27,27,27,27,27
E01024594,EV motorcycles,Number,1,2,4,6,9,12,16,20,23,27,31,34,38,41,43,46,48,49,51,52,53,53,54,54,54,55,55,55,55,55
E01024595,EV motorcycles,Number,1,2,3,5,7,10,13,16,19,22,25,27,30,33,35,37,38,40,41,42,42,43,43,43,44,44,44,44,44,44
E01024596,EV motorcycles,Number,1,1,2,4,6,9,11,13,16,19,21,24,26,28,30,32,33,34,35,36,36,37,37,37,38,38,38,38,38,38
E01024597,EV motorcycles,Number,1,2,3,5,7,9,12,15,18,21,24,26,29,31,33,35,36,38,39,40,40,41,41,41,42,42,42,42,42,42
E01024598,EV motorcycles,Number,1,2,3,5,7,10,12,15,18,21,24,27,29,32,34,36,37,39,40,41,41,42,42,42,43,43,43,43,43,43
E01024599,EV motorcycles,Number,1,1,2,4,6,8,11,13,16,18,21,23,25,27,29,31,32,33,34,35,35,36,36,36,37,37,37,37,37,37
E01024600,EV motorcycles,Number,1,2,3,5,8,11,14,17,20,24,27,30,33,35,38,40,42,43,44,45,46,47,47,47,48,48,48,48,48,48
E01024601,EV motorcycles,Number,1,1,2,4,6,8,10,12,15,17,20,22,24,26,28,29,30,31,32,33,34,34,34,34,35,35,35,35,35,35
E01024602,EV motorcycles,Number,0,1,1,2,3,4,5,6,8,9,10,11,12,13,14,15,16,16,17,17,17,17,18,18,18,18,18,18,18,18
E01024603,EV motorcycles,Number,0,1,1,2,4,5,6,8,9,11,12,14,15,16,17,18,19,20,20,21,21,21,22,22,22,22,22,22,22,22
E01024604,EV motorcycles,Number,0,1,1,2,3,4,6,7,8,10,11,12,14,15,16,17,17,18,18,19,19,19,20,20,20,20,20,20,20,20
E01024605,EV motorcycles,Number,1,1,3,4,7,9,11,14,16,19,22,24,27,29,31,32,34,35,36,37,37,38,38,38,39,39,39,39,39,39
E01024606,EV motorcycles,Number,0,1,2,4,5,7,9,11,14,16,18,20,22,24,25,27,28,29,30,30,31,31,31,32,32,32,32,32,32,32
E01024608,EV motorcycles,Number,0,1,2,3,5,7,9,11,13,15,17,19,21,23,24,26,27,28,29,29,30,30,30,31,31,31,31,31,31,31
E01024609,EV motorcycles,Number,0,1,1,2,4,5,6,8,9,11,12,14,15,16,17,18,19,20,20,21,21,21,22,22,22,22,22,22,22,22
E01024610,EV motorcycles,Number,0,1,2,3,5,6,8,10,12,14,16,17,19,21,22,23,24,25,26,26,27,27,27,28,28,28,28,28,28,28
E01024611,EV motorcycles,Number,0,1,1,2,4,5,6,8,9,11,12,14,15,16,17,18,19,20,20,21,21,21,22,22,22,22,22,22,22,22
E01024612,EV motorcycles,Number,1,2,3,5,7,10,13,16,19,22,25,27,30,33,35,37,38,40,41,42,42,43,43,43,44,44,44,44,44,44
E01024613,EV motorcycles,Number,1,2,4,7,10,14,18,22,26,30,34,38,42,45,48,51,53,55,56,58,58,59,60,60,60,61,61,61,61,61
E01024614,EV motorcycles,Number,0,1,2,3,4,5,7,8,10,11,13,14,16,17,18,19,20,21,21,22,22,22,23,23,23,23,23,23,23,23
E01024615,EV motorcycles,Number,1,1,2,4,6,8,10,12,15,17,20,22,24,26,28,29,30,31,32,33,34,34,34,34,35,35,35,35,35,35
E01024616,EV motorcycles,Number,0,1,2,4,6,8,10,12,14,17,19,21,23,25,27,28,30,31,31,32,33,33,33,33,34,34,34,34,34,34
E01024618,EV motorcycles,Number,1,3,6,10,15,20,25,31,37,43,49,54,59,64,69,72,76,78,80,82,83,84,85,86,86,86,87,87,87,87
E01024619,EV motorcycles,Number,1,1,2,4,6,9,11,13,16,19,21,24,26,28,30,32,33,34,35,36,36,37,37,37,38,38,38,38,38,38
E01024620,EV motorcycles,Number,1,2,4,7,10,13,17,21,25,30,34,37,41,44,47,50,52,54,55,57,58,58,59,59,59,60,60,60,60,60
E01024621,EV motorcycles,Number,0,1,2,4,5,7,9,11,14,16,18,20,22,24,25,27,28,29,30,30,31,31,31,32,32,32,32,32,32,32
E01024622,EV motorcycles,Number,1,3,5,9,13,18,23,28,33,38,44,49,53,58,61,65,68,70,72,74,75,76,76,77,77,77,78,78,78,78
E01024623,EV motorcycles,Number,1,2,4,6,10,13,17,21,25,29,32,36,40,43,46,48,50,52,54,55,56,56,57,57,57,58,58,58,58,58
E01024624,EV motorcycles,Number,1,2,4,7,11,14,19,23,27,31,36,40,44,47,50,53,56,58,59,60,61,62,63,63,63,64,64,64,64,64
E01024625,EV motorcycles,Number,0,1,2,4,6,7,10,12,14,16,18,21,23,24,26,27,29,30,31,31,32,32,32,33,33,33,33,33,33,33
E01024626,EV motorcycles,Number,1,2,4,7,11,14,18,22,27,31,35,39,43,47,50,52,55,57,58,59,60,61,62,62,62,63,63,63,63,63
E01024627,EV motorcycles,Number,1,1,2,4,6,8,10,13,15,18,20,22,25,27,28,30,31,32,33,34,35,35,35,35,36,36,36,36,36,36
E01024628,EV motorcycles,Number,1,3,5,8,13,17,22,27,32,37,43,47,52,56,60,63,66,68,70,72,73,74,74,75,75,75,76,76,76,76
E01024629,EV motorcycles,Number,0,1,2,4,5,7,9,11,14,16,18,20,22,24,25,27,28,29,30,30,31,31,31,32,32,32,32,32,32,32
E01024630,EV motorcycles,Number,1,2,4,6,9,12,16,19,23,27,30,34,37,40,43,45,47,49,50,51,52,52,53,53,53,54,54,54,54,54
E01024631,EV motorcycles,Number,1,2,3,6,8,11,14,18,21,25,28,31,34,37,39,42,43,45,46,47,48,49,49,49,49,50,50,50,50,50
E01024632,EV motorcycles,Number,1,2,3,5,8,10,13,16,19,23,26,29,31,34,36,38,40,41,43,43,44,45,45,45,46,46,46,46,46,46
E01024633,EV motorcycles,Number,1,2,3,5,8,10,13,16,19,23,26,29,31,34,36,38,40,41,43,43,44,45,45,45,46,46,46,46,46,46
E01024634,EV motorcycles,Number,1,1,2,4,6,9,11,13,16,19,21,24,26,28,30,32,33,34,35,36,36,37,37,37,38,38,38,38,38,38
E01024635,EV motorcycles,Number,1,1,2,4,6,8,11,13,16,18,21,23,25,27,29,31,32,33,34,35,35,36,36,36,37,37,37,37,37,37
E01024636,EV motorcycles,Number,1,2,4,6,10,13,17,21,25,29,32,36,40,43,46,48,50,52,54,55,56,56,57,57,57,58,58,58,58,58
E01024637,EV motorcycles,Number,1,2,4,7,11,15,19,23,28,32,37,41,45,49,52,55,57,59,61,62,63,64,65,65,65,66,66,66,66,66
E01024638,EV motorcycles,Number,1,2,4,6,9,12,16,20,23,27,31,34,38,41,43,46,48,49,51,52,53,53,54,54,54,55,55,55,55,55
E01024639,EV motorcycles,Number,1,1,3,4,7,9,11,14,16,19,22,24,27,29,31,32,34,35,36,37,37,38,38,38,39,39,39,39,39,39
E01024640,EV motorcycles,Number,1,1,3,5,7,9,12,15,17,20,23,26,28,30,32,34,36,37,38,39,39,40,40,40,41,41,41,41,41,41
E01024641,EV motorcycles,Number,0,1,2,3,4,6,8,9,11,13,15,16,18,19,20,22,23,23,24,25,25,25,25,26,26,26,26,26,26,26
E01024642,EV motorcycles,Number,1,1,3,5,7,9,12,15,17,20,23,26,28,30,32,34,36,37,38,39,39,40,40,40,41,41,41,41,41,41
E01024643,EV motorcycles,Number,0,1,1,2,4,5,6,8,9,11,12,14,15,16,17,18,19,20,20,21,21,21,22,22,22,22,22,22,22,22
E01024644,EV motorcycles,Number,1,2,4,6,9,13,16,20,24,28,31,35,38,41,44,47,49,50,52,53,54,54,55,55,55,56,56,56,56,56
E01024645,EV motorcycles,Number,0,1,2,4,5,7,9,11,14,16,18,20,22,24,25,27,28,29,30,30,31,31,31,32,32,32,32,32,32,32
E01024646,EV motorcycles,Number,1,1,2,4,6,9,11,13,16,19,21,24,26,28,30,32,33,34,35,36,36,37,37,37,38,38,38,38,38,38
E01024647,EV motorcycles,Number,0,1,2,3,4,6,8,9,11,13,15,16,18,19,20,22,23,23,24,25,25,25,25,26,26,26,26,26,26,26
E01024648,EV motorcycles,Number,0,1,2,3,4,6,8,9,11,13,15,16,18,19,20,22,23,23,24,25,25,25,25,26,26,26,26,26,26,26
E01024649,EV motorcycles,Number,1,2,3,5,7,9,12,15,18,21,24,26,29,31,33,35,36,38,39,40,40,41,41,41,42,42,42,42,42,42
E01024650,EV motorcycles,Number,1,2,3,6,9,12,15,18,22,26,29,32,36,38,41,43,45,47,48,49,50,50,51,51,51,52,52,52,52,52
E01024651,EV motorcycles,Number,0,1,2,3,5,6,8,10,11,13,15,17,18,20,21,22,23,24,25,25,26,26,26,27,27,27,27,27,27,27
E01024652,EV motorcycles,Number,1,3,5,9,13,18,23,28,34,39,45,50,55,59,63,67,70,72,74,76,77,78,78,79,79,79,80,80,80,80
E01024653,EV motorcycles,Number,1,1,3,4,7,9,11,14,16,19,22,24,27,29,31,32,34,35,36,37,37,38,38,38,39,39,39,39,39,39
E01024654,EV motorcycles,Number,1,2,4,6,9,12,16,19,23,27,30,34,37,40,43,45,47,49,50,51,52,52,53,53,53,54,54,54,54,54
E01024655,EV motorcycles,Number,2,5,9,16,24,32,42,51,61,71,81,90,98,106,114,120,125,129,133,136,138,140,141,142,143,143,144,144,144,144
E01024656,EV motorcycles,Number,1,2,3,5,7,9,12,15,18,21,24,26,29,31,33,35,36,38,39,40,40,41,41,41,42,42,42,42,42,42
E01024657,EV motorcycles,Number,1,1,3,5,7,9,12,15,17,20,23,26,28,30,32,34,36,37,38,39,39,40,40,40,41,41,41,41,41,41
E01024658,EV motorcycles,Number,0,1,2,3,4,6,7,9,11,12,14,16,17,18,20,21,22,22,23,24,24,24,24,25,25,25,25,25,25,25
E01024659,EV motorcycles,Number,0,1,2,3,4,6,8,9,11,13,15,16,18,19,20,22,23,23,24,25,25,25,25,26,26,26,26,26,26,26
E01024660,EV motorcycles,Number,0,1,2,3,4,5,7,8,10,11,13,14,16,17,18,19,20,21,21,22,22,22,23,23,23,23,23,23,23,23
E01024661,EV motorcycles,Number,0,1,2,3,5,7,8,10,12,14,16,18,20,21,23,24,25,26,27,27,28,28,28,29,29,29,29,29,29,29
E01024662,EV motorcycles,Number,1,2,3,6,9,11,15,18,22,25,29,32,35,38,40,42,44,46,47,48,49,49,50,50,50,51,51,51,51,51
E01024663,EV motorcycles,Number,1,1,2,4,6,8,11,13,16,18,21,23,25,27,29,31,32,33,34,35,35,36,36,36,37,37,37,37,37,37
E01024664,EV motorcycles,Number,1,2,3,5,7,9,12,15,18,21,24,26,29,31,33,35,36,38,39,40,40,41,41,41,42,42,42,42,42,42
E01024665,EV motorcycles,Number,1,1,3,5,7,9,12,15,17,20,23,26,28,30,32,34,36,37,38,39,39,40,40,40,41,41,41,41,41,41
E01024666,EV motorcycles,Number,1,2,4,6,10,13,17,21,25,29,32,36,40,43,46,48,50,52,54,55,56,56,57,57,57,58,58,58,58,58
E01024667,EV motorcycles,Number,0,1,1,2,3,4,5,6,8,9,10,11,12,13,14,15,16,16,17,17,17,17,18,18,18,18,18,18,18,18
E01024668,EV motorcycles,Number,0,1,1,2,3,4,5,7,8,9,11,12,13,14,15,16,17,17,18,18,18,18,19,19,19,19,19,19,19,19
E01024669,EV motorcycles,Number,0,1,1,2,3,4,6,7,8,10,11,12,14,15,16,17,17,18,18,19,19,19,20,20,20,20,20,20,20,20
E01024670,EV motorcycles,Number,1,1,3,5,7,9,12,15,17,20,23,26,28,30,32,34,36,37,38,39,39,40,40,40,41,41,41,41,41,41
E01024671,EV motorcycles,Number,0,1,2,3,5,7,9,11,13,15,17,19,21,23,24,26,27,28,29,29,30,30,30,31,31,31,31,31,31,31
E01024672,EV motorcycles,Number,1,1,2,4,6,9,11,13,16,19,21,24,26,28,30,32,33,34,35,36,36,37,37,37,38,38,38,38,38,38
E01024673,EV motorcycles,Number,1,2,4,6,9,13,16,20,24,28,31,35,38,41,44,47,49,50,52,53,54,54,55,55,55,56,56,56,56,56
E01024674,EV motorcycles,Number,1,2,3,5,8,11,14,17,21,24,27,31,33,36,39,41,43,44,45,46,47,48,48,48,48,49,49,49,49,49
E01024675,EV motorcycles,Number,1,2,3,5,8,11,14,17,20,23,26,29,32,35,37,39,41,42,43,44,45,46,46,46,47,47,47,47,47,47
E01024676,EV motorcycles,Number,1,2,3,5,7,10,12,15,18,21,24,27,29,32,34,36,37,39,40,41,41,42,42,42,43,43,43,43,43,43
E01024677,EV motorcycles,Number,1,1,2,4,6,8,10,13,15,18,20,22,25,27,28,30,31,32,33,34,35,35,35,35,36,36,36,36,36,36
E01024678,EV motorcycles,Number,0,1,2,3,5,6,8,10,12,14,16,17,19,21,22,23,24,25,26,26,27,27,27,28,28,28,28,28,28,28
E01024679,EV motorcycles,Number,1,2,3,6,9,11,15,18,22,25,29,32,35,38,40,42,44,46,47,48,49,49,50,50,50,51,51,51,51,51
E01024680,EV motorcycles,Number,1,2,3,5,7,10,13,16,19,22,25,27,30,33,35,37,38,40,41,42,42,43,43,43,44,44,44,44,44,44
E01024681,EV motorcycles,Number,1,3,5,8,13,17,22,27,33,38,43,48,53,57,61,64,67,69,71,73,74,75,75,76,76,76,77,77,77,77
E01024682,EV motorcycles,Number,1,2,3,6,8,11,14,18,21,25,28,31,34,37,39,42,43,45,46,47,48,49,49,49,49,50,50,50,50,50
E01024683,EV motorcycles,Number,1,1,2,4,6,8,10,12,15,17,20,22,24,26,28,29,30,31,32,33,34,34,34,34,35,35,35,35,35,35
E01024684,EV motorcycles,Number,1,2,3,5,8,10,13,16,19,22,25,28,31,33,35,37,39,40,42,42,43,44,44,44,45,45,45,45,45,45
E01024685,EV motorcycles,Number,1,2,3,6,9,12,15,18,22,26,29,32,36,38,41,43,45,47,48,49,50,50,51,51,51,52,52,52,52,52
E01024686,EV motorcycles,Number,1,2,4,6,9,12,16,20,23,27,31,34,38,41,43,46,48,49,51,52,53,53,54,54,54,55,55,55,55,55
E01024687,EV motorcycles,Number,1,2,3,6,9,12,15,19,22,26,30,33,36,39,42,44,46,48,49,50,51,51,52,52,52,53,53,53,53,53
E01024688,EV motorcycles,Number,1,2,4,7,11,14,19,23,27,31,36,40,44,47,50,53,56,58,59,60,61,62,63,63,63,64,64,64,64,64
E01024689,EV motorcycles,Number,1,1,3,4,7,9,11,14,16,19,22,24,27,29,31,32,34,35,36,37,37,38,38,38,39,39,39,39,39,39
E01024690,EV motorcycles,Number,1,1,2,4,6,8,10,12,15,17,20,22,24,26,28,29,30,31,32,33,34,34,34,34,35,35,35,35,35,35
E01024691,EV motorcycles,Number,1,1,3,5,7,9,12,15,17,20,23,26,28,30,32,34,36,37,38,39,39,40,40,40,41,41,41,41,41,41
E01024692,EV motorcycles,Number,0,1,2,3,5,7,9,11,13,15,17,19,21,22,24,25,26,27,28,28,29,29,29,30,30,30,30,30,30,30
E01024693,EV motorcycles,Number,1,1,2,4,6,8,10,12,15,17,20,22,24,26,28,29,30,31,32,33,34,34,34,34,35,35,35,35,35,35
E01024694,EV motorcycles,Number,1,2,3,5,7,10,12,15,18,21,24,27,29,32,34,36,37,39,40,41,41,42,42,42,43,43,43,43,43,43
E01024695,EV motorcycles,Number,1,2,3,5,8,11,14,17,21,24,27,31,33,36,39,41,43,44,45,46,47,48,48,48,48,49,49,49,49,49
E01024696,EV motorcycles,Number,1,1,3,4,7,9,12,14,17,20,22,25,27,30,32,33,35,36,37,38,38,39,39,39,40,40,40,40,40,40
E01024697,EV motorcycles,Number,0,1,2,3,4,5,7,9,10,12,13,15,16,18,19,20,21,22,22,23,23,23,23,24,24,24,24,24,24,24
E01024698,EV motorcycles,Number,0,1,1,2,4,5,6,8,9,11,12,14,15,16,17,18,19,20,20,21,21,21,22,22,22,22,22,22,22,22
E01024699,EV motorcycles,Number,1,2,4,6,9,12,16,19,23,27,30,34,37,40,43,45,47,49,50,51,52,52,53,53,53,54,54,54,54,54
E01024700,EV motorcycles,Number,1,1,3,4,7,9,11,14,16,19,22,24,27,29,31,32,34,35,36,37,37,38,38,38,39,39,39,39,39,39
E01024701,EV motorcycles,Number,2,5,8,14,22,29,37,46,55,63,72,80,88,95,102,107,112,116,119,122,124,125,126,127,128,128,129,129,129,129
E01024702,EV motorcycles,Number,1,2,3,5,8,10,13,16,19,22,25,28,31,33,35,37,39,40,42,42,43,44,44,44,45,45,45,45,45,45
E01024703,EV motorcycles,Number,1,3,6,10,15,20,25,31,37,43,49,54,59,64,69,72,76,78,80,82,83,84,85,86,86,86,87,87,87,87
E01024704,EV motorcycles,Number,1,3,5,8,13,17,22,27,32,37,43,47,52,56,60,63,66,68,70,72,73,74,74,75,75,75,76,76,76,76
E01024705,EV motorcycles,Number,0,1,2,4,5,7,9,11,14,16,18,20,22,24,25,27,28,29,30,30,31,31,31,32,32,32,32,32,32,32
E01024706,EV motorcycles,Number,1,1,2,4,6,8,11,13,16,18,21,23,25,27,29,31,32,33,34,35,35,36,36,36,37,37,37,37,37,37
E01024707,EV motorcycles,Number,0,1,2,3,5,7,9,11,13,15,17,19,21,23,24,26,27,28,29,29,30,30,30,31,31,31,31,31,31,31
E01024708,EV motorcycles,Number,1,2,5,8,12,15,20,25,29,34,39,43,47,51,54,57,60,62,64,65,66,67,68,68,68,69,69,69,69,69
E01024709,EV motorcycles,Number,1,2,3,5,8,10,13,16,19,23,26,29,31,34,36,38,40,41,43,43,44,45,45,45,46,46,46,46,46,46
E01024710,EV motorcycles,Number,0,1,2,4,6,8,10,12,14,17,19,21,23,25,27,28,30,31,31,32,33,33,33,33,34,34,34,34,34,34
E01024711,EV motorcycles,Number,1,2,3,6,9,11,15,18,22,25,29,32,35,38,40,42,44,46,47,48,49,49,50,50,50,51,51,51,51,51
E01024712,EV motorcycles,Number,1,2,3,5,8,10,13,16,19,22,25,28,31,33,35,37,39,40,42,42,43,44,44,44,45,45,45,45,45,45
E01024713,EV motorcycles,Number,1,1,2,4,6,8,10,13,15,18,20,22,25,27,28,30,31,32,33,34,35,35,35,35,36,36,36,36,36,36
E01024714,EV motorcycles,Number,1,2,3,5,8,10,13,16,19,23,26,29,31,34,36,38,40,41,43,43,44,45,45,45,46,46,46,46,46,46
E01024715,EV motorcycles,Number,0,1,2,3,5,6,8,10,11,13,15,17,18,20,21,22,23,24,25,25,26,26,26,27,27,27,27,27,27,27
E01024716,EV motorcycles,Number,1,2,3,6,9,12,15,18,22,26,29,32,36,38,41,43,45,47,48,49,50,50,51,51,51,52,52,52,52,52
E01024717,EV motorcycles,Number,1,3,6,10,15,20,25,31,37,43,49,55,60,65,69,73,76,79,81,83,84,85,86,87,87,87,88,88,88,88
E01024718,EV motorcycles,Number,1,1,3,4,7,9,11,14,16,19,22,24,27,29,31,32,34,35,36,37,37,38,38,38,39,39,39,39,39,39
E01024719,EV motorcycles,Number,1,3,5,8,13,17,22,27,33,38,43,48,53,57,61,64,67,69,71,73,74,75,75,76,76,76,77,77,77,77
E01024720,EV motorcycles,Number,1,1,3,4,7,9,11,14,16,19,22,24,27,29,31,32,34,35,36,37,37,38,38,38,39,39,39,39,39,39
E01024721,EV motorcycles,Number,1,2,4,7,11,15,19,23,28,32,37,41,45,49,52,55,57,59,61,62,63,64,65,65,65,66,66,66,66,66
E01024722,EV motorcycles,Number,1,2,3,6,9,11,15,18,22,25,29,32,35,38,40,42,44,46,47,48,49,49,50,50,50,51,51,51,51,51
E01024723,EV motorcycles,Number,1,2,4,6,9,12,16,19,23,27,30,34,37,40,43,45,47,49,50,51,52,52,53,53,53,54,54,54,54,54
E01024724,EV motorcycles,Number,1,2,3,5,7,9,12,15,18,21,24,26,29,31,33,35,36,38,39,40,40,41,41,41,42,42,42,42,42,42
E01024725,EV motorcycles,Number,1,2,4,6,9,12,16,20,23,27,31,34,38,41,43,46,48,49,51,52,53,53,54,54,54,55,55,55,55,55
E01024726,EV motorcycles,Number,1,1,2,4,6,8,10,13,15,18,20,22,25,27,28,30,31,32,33,34,35,35,35,35,36,36,36,36,36,36
E01024727,EV motorcycles,Number,2,5,9,15,22,30,38,47,56,65,74,83,91,98,105,111,116,120,123,126,128,129,130,131,132,132,133,133,133,133
E01024728,EV motorcycles,Number,1,2,4,7,11,15,19,23,27,32,36,40,44,48,51,54,56,58,60,61,62,63,64,64,64,65,65,65,65,65
E01024729,EV motorcycles,Number,1,1,2,4,6,8,10,12,15,17,20,22,24,26,28,29,30,31,32,33,34,34,34,34,35,35,35,35,35,35
E01024730,EV motorcycles,Number,0,1,1,2,4,5,6,7,9,10,12,13,14,16,17,17,18,19,19,20,20,20,21,21,21,21,21,21,21,21
E01024731,EV motorcycles,Number,0,1,2,3,4,5,7,9,10,12,13,15,16,18,19,20,21,22,22,23,23,23,23,24,24,24,24,24,24,24
E01024732,EV motorcycles,Number,0,1,2,3,5,7,8,10,12,14,16,18,20,21,23,24,25,26,27,27,28,28,28,29,29,29,29,29,29,29
E01024733,EV motorcycles,Number,1,2,3,5,8,11,14,17,20,23,26,29,32,35,37,39,41,42,43,44,45,46,46,46,47,47,47,47,47,47
E01024734,EV motorcycles,Number,1,2,4,6,9,12,16,19,23,27,30,34,37,40,43,45,47,49,50,51,52,52,53,53,53,54,54,54,54,54
E01024735,EV motorcycles,Number,1,2,3,6,9,11,15,18,22,25,29,32,35,38,40,42,44,46,47,48,49,49,50,50,50,51,51,51,51,51
E01024736,EV motorcycles,Number,1,1,2,4,6,9,11,13,16,19,21,24,26,28,30,32,33,34,35,36,36,37,37,37,38,38,38,38,38,38
E01024737,EV motorcycles,Number,1,2,4,6,10,13,16,20,24,28,32,35,39,42,45,47,50,51,53,54,55,55,56,56,56,57,57,57,57,57
E01024740,EV motorcycles,Number,1,3,5,9,13,18,23,28,34,39,45,50,55,59,63,67,70,72,74,76,77,78,78,79,79,79,80,80,80,80
E01024741,EV motorcycles,Number,0,1,1,2,4,5,6,8,9,11,12,14,15,16,17,18,19,20,20,21,21,21,22,22,22,22,22,22,22,22
E01024742,EV motorcycles,Number,1,2,3,6,9,12,15,18,22,26,29,32,36,38,41,43,45,47,48,49,50,50,51,51,51,52,52,52,52,52
E01024743,EV motorcycles,Number,1,2,3,5,8,11,14,17,20,23,26,29,32,35,37,39,41,42,43,44,45,46,46,46,47,47,47,47,47,47
E01024744,EV motorcycles,Number,1,2,4,6,9,12,16,20,23,27,31,34,38,41,43,46,48,49,51,52,53,53,54,54,54,55,55,55,55,55
E01024745,EV motorcycles,Number,1,2,4,6,9,13,16,20,24,28,31,35,38,41,44,47,49,50,52,53,54,54,55,55,55,56,56,56,56,56
E01024746,EV motorcycles,Number,1,2,3,5,7,10,13,16,19,22,25,27,30,33,35,37,38,40,41,42,42,43,43,43,44,44,44,44,44,44
E01024747,EV motorcycles,Number,1,2,3,5,7,10,12,15,18,21,24,27,29,32,34,36,37,39,40,41,41,42,42,42,43,43,43,43,43,43
E01024748,EV motorcycles,Number,0,1,1,2,4,5,6,8,9,11,12,14,15,16,17,18,19,20,20,21,21,21,22,22,22,22,22,22,22,22
E01024749,EV motorcycles,Number,1,1,3,4,7,9,11,14,16,19,22,24,27,29,31,32,34,35,36,37,37,38,38,38,39,39,39,39,39,39
E01024750,EV motorcycles,Number,0,1,2,4,6,7,10,12,14,16,18,21,23,24,26,27,29,30,31,31,32,32,32,33,33,33,33,33,33,33
E01024751,EV motorcycles,Number,1,2,4,6,10,13,16,20,24,28,32,35,39,42,45,47,50,51,53,54,55,55,56,56,56,57,57,57,57,57
E01024752,EV motorcycles,Number,1,1,3,5,7,9,12,15,17,20,23,26,28,30,32,34,36,37,38,39,39,40,40,40,41,41,41,41,41,41
E01024753,EV motorcycles,Number,1,1,3,5,7,9,12,15,17,20,23,26,28,30,32,34,36,37,38,39,39,40,40,40,41,41,41,41,41,41
E01024754,EV motorcycles,Number,1,2,3,5,8,10,13,16,19,22,25,28,31,33,35,37,39,40,42,42,43,44,44,44,45,45,45,45,45,45
E01024755,EV motorcycles,Number,1,2,3,5,8,11,14,17,20,24,27,30,33,35,38,40,42,43,44,45,46,47,47,47,48,48,48,48,48,48
E01024756,EV motorcycles,Number,0,1,1,2,4,5,6,8,9,11,12,14,15,16,17,18,19,20,20,21,21,21,22,22,22,22,22,22,22,22
E01024757,EV motorcycles,Number,0,1,1,2,4,5,6,7,9,10,12,13,14,16,17,17,18,19,19,20,20,20,21,21,21,21,21,21,21,21
E01024758,EV motorcycles,Number,0,1,2,3,5,7,9,11,13,15,17,19,21,22,24,25,26,27,28,28,29,29,29,30,30,30,30,30,30,30
E01024760,EV motorcycles,Number,0,1,2,4,6,7,10,12,14,16,18,21,23,24,26,27,29,30,31,31,32,32,32,33,33,33,33,33,33,33
E01024761,EV motorcycles,Number,1,2,3,6,9,12,15,18,22,26,29,32,36,38,41,43,45,47,48,49,50,50,51,51,51,52,52,52,52,52
E01024762,EV motorcycles,Number,1,2,4,7,11,15,20,24,29,33,38,42,46,50,54,57,59,61,63,64,65,66,67,67,67,68,68,68,68,68
E01024763,EV motorcycles,Number,1,2,3,5,8,11,14,17,20,23,26,29,32,35,37,39,41,42,43,44,45,46,46,46,47,47,47,47,47,47
E01024764,EV motorcycles,Number,1,2,3,5,8,11,14,17,21,24,27,31,33,36,39,41,43,44,45,46,47,48,48,48,48,49,49,49,49,49
E01024765,EV motorcycles,Number,1,2,3,5,8,11,14,17,20,24,27,30,33,35,38,40,42,43,44,45,46,47,47,47,48,48,48,48,48,48
E01024766,EV motorcycles,Number,1,2,3,5,7,10,12,15,18,21,24,27,29,32,34,36,37,39,40,41,41,42,42,42,43,43,43,43,43,43
E01024767,EV motorcycles,Number,0,1,2,4,6,7,10,12,14,16,18,21,23,24,26,27,29,30,31,31,32,32,32,33,33,33,33,33,33,33
E01024768,EV motorcycles,Number,0,1,2,3,5,7,9,11,13,15,17,19,21,23,24,26,27,28,29,29,30,30,30,31,31,31,31,31,31,31
E01024771,EV motorcycles,Number,1,2,4,7,10,14,18,22,26,30,35,39,42,46,49,52,54,56,57,59,59,60,61,61,61,62,62,62,62,62
E01024772,EV motorcycles,Number,1,2,4,6,9,12,16,20,23,27,31,34,38,41,43,46,48,49,51,52,53,53,54,54,54,55,55,55,55,55
E01024773,EV motorcycles,Number,1,2,3,5,7,10,12,15,18,21,24,27,29,32,34,36,37,39,40,41,41,42,42,42,43,43,43,43,43,43
E01024774,EV motorcycles,Number,1,3,6,10,15,20,25,31,37,43,49,54,59,64,69,72,76,78,80,82,83,84,85,86,86,86,87,87,87,87
E01024775,EV motorcycles,Number,0,1,2,3,4,5,7,8,10,11,13,14,16,17,18,19,20,21,21,22,22,22,23,23,23,23,23,23,23,23
E01024776,EV motorcycles,Number,0,1,2,4,6,7,10,12,14,16,18,21,23,24,26,27,29,30,31,31,32,32,32,33,33,33,33,33,33,33
E01024777,EV motorcycles,Number,0,1,1,2,4,5,6,8,9,11,12,14,15,16,17,18,19,20,20,21,21,21,22,22,22,22,22,22,22,22
E01024778,EV motorcycles,Number,0,1,2,3,5,7,9,11,13,15,17,19,21,23,24,26,27,28,29,29,30,30,30,31,31,31,31,31,31,31
E01024779,EV motorcycles,Number,0,1,1,2,4,5,6,7,9,10,12,13,14,16,17,17,18,19,19,20,20,20,21,21,21,21,21,21,21,21
E01024780,EV motorcycles,Number,1,2,3,5,7,10,12,15,18,21,24,27,29,32,34,36,37,39,40,41,41,42,42,42,43,43,43,43,43,43
E01024781,EV motorcycles,Number,1,2,3,6,8,11,14,18,21,25,28,31,34,37,39,42,43,45,46,47,48,49,49,49,49,50,50,50,50,50
E01024782,EV motorcycles,Number,1,1,2,4,6,8,10,13,15,18,20,22,25,27,28,30,31,32,33,34,35,35,35,35,36,36,36,36,36,36
E01024783,EV motorcycles,Number,0,1,2,4,6,8,10,12,14,17,19,21,23,25,27,28,30,31,31,32,33,33,33,33,34,34,34,34,34,34
E01024784,EV motorcycles,Number,1,2,4,7,10,14,18,22,26,30,35,39,42,46,49,52,54,56,57,59,59,60,61,61,61,62,62,62,62,62
E01024785,EV motorcycles,Number,1,2,3,5,7,9,12,15,18,21,24,26,29,31,33,35,36,38,39,40,40,41,41,41,42,42,42,42,42,42
E01024786,EV motorcycles,Number,1,2,3,5,8,10,13,16,19,22,25,28,31,33,35,37,39,40,42,42,43,44,44,44,45,45,45,45,45,45
E01024787,EV motorcycles,Number,1,2,4,7,11,14,19,23,27,31,36,40,44,47,50,53,56,58,59,60,61,62,63,63,63,64,64,64,64,64
E01024788,EV motorcycles,Number,0,1,2,4,6,8,10,12,14,17,19,21,23,25,27,28,30,31,31,32,33,33,33,33,34,34,34,34,34,34
E01024789,EV motorcycles,Number,1,2,4,7,11,15,19,23,27,32,36,40,44,48,51,54,56,58,60,61,62,63,64,64,64,65,65,65,65,65
E01024790,EV motorcycles,Number,0,1,1,2,3,4,5,6,7,8,10,11,12,13,13,14,15,15,16,16,16,16,17,17,17,17,17,17,17,17
E01024791,EV motorcycles,Number,0,1,1,2,4,5,6,7,9,10,12,13,14,16,17,17,18,19,19,20,20,20,21,21,21,21,21,21,21,21
E01024792,EV motorcycles,Number,0,1,2,4,6,7,10,12,14,16,18,21,23,24,26,27,29,30,31,31,32,32,32,33,33,33,33,33,33,33
E01024793,EV motorcycles,Number,1,2,4,6,9,12,16,19,23,27,30,34,37,40,43,45,47,49,50,51,52,52,53,53,53,54,54,54,54,54
E01024794,EV motorcycles,Number,1,1,3,4,7,9,11,14,16,19,22,24,27,29,31,32,34,35,36,37,37,38,38,38,39,39,39,39,39,39
E01024795,EV motorcycles,Number,0,1,2,3,5,7,9,11,13,15,17,19,21,22,24,25,26,27,28,28,29,29,29,30,30,30,30,30,30,30
E01024796,EV motorcycles,Number,0,1,2,4,6,8,10,12,14,17,19,21,23,25,27,28,30,31,31,32,33,33,33,33,34,34,34,34,34,34
E01024797,EV motorcycles,Number,1,2,3,5,8,11,14,17,20,23,26,29,32,35,37,39,41,42,43,44,45,46,46,46,47,47,47,47,47,47
E01024798,EV motorcycles,Number,1,3,5,9,14,18,24,29,35,40,46,51,56,61,65,68,71,74,76,77,79,80,80,81,81,81,82,82,82,82
E01024799,EV motorcycles,Number,0,1,2,3,4,5,7,8,10,11,13,14,16,17,18,19,20,21,21,22,22,22,23,23,23,23,23,23,23,23
E01024800,EV motorcycles,Number,0,1,2,4,5,7,9,11,14,16,18,20,22,24,25,27,28,29,30,30,31,31,31,32,32,32,32,32,32,32
E01024801,EV motorcycles,Number,1,1,2,4,6,9,11,13,16,19,21,24,26,28,30,32,33,34,35,36,36,37,37,37,38,38,38,38,38,38
E01024802,EV motorcycles,Number,0,1,1,2,3,4,6,7,8,10,11,12,14,15,16,17,17,18,18,19,19,19,20,20,20,20,20,20,20,20
E01024803,EV motorcycles,Number,1,2,3,5,8,11,14,17,20,23,26,29,32,35,37,39,41,42,43,44,45,46,46,46,47,47,47,47,47,47
E01024804,EV motorcycles,Number,0,1,2,4,6,7,10,12,14,16,18,21,23,24,26,27,29,30,31,31,32,32,32,33,33,33,33,33,33,33
E01024805,EV motorcycles,Number,1,2,3,6,9,12,15,19,22,26,30,33,36,39,42,44,46,48,49,50,51,51,52,52,52,53,53,53,53,53
E01024806,EV motorcycles,Number,1,2,3,5,8,11,14,17,20,23,26,29,32,35,37,39,41,42,43,44,45,46,46,46,47,47,47,47,47,47
E01024807,EV motorcycles,Number,1,1,2,4,6,8,10,12,15,17,20,22,24,26,28,29,30,31,32,33,34,34,34,34,35,35,35,35,35,35
E01024808,EV motorcycles,Number,1,2,3,5,8,11,14,17,21,24,27,31,33,36,39,41,43,44,45,46,47,48,48,48,48,49,49,49,49,49
E01024809,EV motorcycles,Number,1,2,4,7,11,15,20,24,29,33,38,42,46,50,54,57,59,61,63,64,65,66,67,67,67,68,68,68,68,68
E01024810,EV motorcycles,Number,1,1,2,4,6,9,11,13,16,19,21,24,26,28,30,32,33,34,35,36,36,37,37,37,38,38,38,38,38,38
E01024811,EV motorcycles,Number,0,1,2,3,4,6,8,9,11,13,15,16,18,19,20,22,23,23,24,25,25,25,25,26,26,26,26,26,26,26
E01024812,EV motorcycles,Number,1,2,3,6,9,12,15,19,22,26,30,33,36,39,42,44,46,48,49,50,51,51,52,52,52,53,53,53,53,53
E01024813,EV motorcycles,Number,1,1,2,4,6,8,10,12,15,17,20,22,24,26,28,29,30,31,32,33,34,34,34,34,35,35,35,35,35,35
E01024814,EV motorcycles,Number,0,1,2,3,5,7,9,11,13,15,17,19,21,22,24,25,26,27,28,28,29,29,29,30,30,30,30,30,30,30
E01024815,EV motorcycles,Number,0,1,2,3,5,6,8,10,12,14,16,17,19,21,22,23,24,25,26,26,27,27,27,28,28,28,28,28,28,28
E01024816,EV motorcycles,Number,0,1,2,3,5,6,8,10,12,14,16,17,19,21,22,23,24,25,26,26,27,27,27,28,28,28,28,28,28,28
E01024817,EV motorcycles,Number,1,1,3,5,7,9,12,15,17,20,23,26,28,30,32,34,36,37,38,39,39,40,40,40,41,41,41,41,41,41
E01024818,EV motorcycles,Number,1,2,3,5,8,10,13,16,19,22,25,28,31,33,35,37,39,40,42,42,43,44,44,44,45,45,45,45,45,45
E01024819,EV motorcycles,Number,0,1,2,3,4,5,7,9,10,12,13,15,16,18,19,20,21,22,22,23,23,23,23,24,24,24,24,24,24,24
E01024820,EV motorcycles,Number,0,1,1,2,3,4,5,6,7,8,9,10,11,12,13,13,14,14,15,15,15,16,16,16,16,16,16,16,16,16
E01024821,EV motorcycles,Number,1,1,3,4,7,9,12,14,17,20,22,25,27,30,32,33,35,36,37,38,38,39,39,39,40,40,40,40,40,40
E01024822,EV motorcycles,Number,0,1,1,2,3,3,4,5,6,7,8,9,10,11,12,12,13,13,14,14,14,15,15,15,15,15,15,15,15,15
E01024823,EV motorcycles,Number,0,1,1,2,3,4,5,7,8,9,11,12,13,14,15,16,17,17,18,18,18,18,19,19,19,19,19,19,19,19
E01024824,EV motorcycles,Number,0,1,2,3,5,7,8,10,12,14,16,18,20,21,23,24,25,26,27,27,28,28,28,29,29,29,29,29,29,29
E01024825,EV motorcycles,Number,1,2,3,5,8,10,13,16,19,22,25,28,31,33,35,37,39,40,42,42,43,44,44,44,45,45,45,45,45,45
E01024826,EV motorcycles,Number,0,1,2,4,5,7,9,11,14,16,18,20,22,24,25,27,28,29,30,30,31,31,31,32,32,32,32,32,32,32
E01024827,EV motorcycles,Number,1,1,2,4,6,8,10,12,15,17,20,22,24,26,28,29,30,31,32,33,34,34,34,34,35,35,35,35,35,35
E01024828,EV motorcycles,Number,0,1,2,3,5,6,8,10,11,13,15,17,18,20,21,22,23,24,25,25,26,26,26,27,27,27,27,27,27,27
E01024829,EV motorcycles,Number,1,1,3,5,7,9,12,15,17,20,23,26,28,30,32,34,36,37,38,39,39,40,40,40,41,41,41,41,41,41
E01024830,EV motorcycles,Number,1,2,3,5,8,11,14,17,21,24,27,31,33,36,39,41,43,44,45,46,47,48,48,48,48,49,49,49,49,49
E01024831,EV motorcycles,Number,1,1,2,4,6,9,11,13,16,19,21,24,26,28,30,32,33,34,35,36,36,37,37,37,38,38,38,38,38,38
E01024832,EV motorcycles,Number,0,1,1,2,4,5,6,8,9,11,12,14,15,16,17,18,19,20,20,21,21,21,22,22,22,22,22,22,22,22
E01024833,EV motorcycles,Number,0,1,2,3,5,7,8,10,12,14,16,18,20,21,23,24,25,26,27,27,28,28,28,29,29,29,29,29,29,29
E01024834,EV motorcycles,Number,0,1,2,3,5,7,9,11,13,15,17,19,21,23,24,26,27,28,29,29,30,30,30,31,31,31,31,31,31,31
E01024835,EV motorcycles,Number,0,1,2,3,4,5,7,9,10,12,13,15,16,18,19,20,21,22,22,23,23,23,23,24,24,24,24,24,24,24
E01024836,EV motorcycles,Number,1,1,3,4,7,9,12,14,17,20,22,25,27,30,32,33,35,36,37,38,38,39,39,39,40,40,40,40,40,40
E01024837,EV motorcycles,Number,1,1,3,4,7,9,11,14,16,19,22,24,27,29,31,32,34,35,36,37,37,38,38,38,39,39,39,39,39,39
E01024838,EV motorcycles,Number,0,1,2,3,4,5,7,9,10,12,13,15,16,18,19,20,21,22,22,23,23,23,23,24,24,24,24,24,24,24
E01024839,EV motorcycles,Number,1,3,5,8,13,17,22,27,32,37,43,47,52,56,60,63,66,68,70,72,73,74,74,75,75,75,76,76,76,76
E01024840,EV motorcycles,Number,1,2,3,5,8,10,13,16,19,23,26,29,31,34,36,38,40,41,43,43,44,45,45,45,46,46,46,46,46,46
E01024841,EV motorcycles,Number,1,1,3,4,7,9,12,14,17,20,22,25,27,30,32,33,35,36,37,38,38,39,39,39,40,40,40,40,40,40
E01024842,EV motorcycles,Number,1,1,2,4,6,9,11,13,16,19,21,24,26,28,30,32,33,34,35,36,36,37,37,37,38,38,38,38,38,38
E01024843,EV motorcycles,Number,0,1,2,3,5,6,8,10,12,14,16,17,19,21,22,23,24,25,26,26,27,27,27,28,28,28,28,28,28,28
E01024844,EV motorcycles,Number,1,1,3,4,7,9,11,14,16,19,22,24,27,29,31,32,34,35,36,37,37,38,38,38,39,39,39,39,39,39
E01024845,EV motorcycles,Number,0,1,1,2,3,4,6,7,8,10,11,12,14,15,16,17,17,18,18,19,19,19,20,20,20,20,20,20,20,20
E01024846,EV motorcycles,Number,1,2,3,6,8,11,14,18,21,25,28,31,34,37,39,42,43,45,46,47,48,49,49,49,49,50,50,50,50,50
E01024847,EV motorcycles,Number,1,1,3,5,7,9,12,15,17,20,23,26,28,30,32,34,36,37,38,39,39,40,40,40,41,41,41,41,41,41
E01024848,EV motorcycles,Number,0,1,2,3,5,6,8,10,12,14,16,17,19,21,22,23,24,25,26,26,27,27,27,28,28,28,28,28,28,28
E01024849,EV motorcycles,Number,1,1,2,4,6,8,10,13,15,18,20,22,25,27,28,30,31,32,33,34,35,35,35,35,36,36,36,36,36,36
E01024850,EV motorcycles,Number,0,1,2,3,4,5,7,9,10,12,13,15,16,18,19,20,21,22,22,23,23,23,23,24,24,24,24,24,24,24
E01024851,EV motorcycles,Number,0,1,1,2,3,4,6,7,8,10,11,12,14,15,16,17,17,18,18,19,19,19,20,20,20,20,20,20,20,20
E01024852,EV motorcycles,Number,0,1,1,2,4,5,6,7,9,10,12,13,14,16,17,17,18,19,19,20,20,20,21,21,21,21,21,21,21,21
E01024853,EV motorcycles,Number,0,1,1,2,3,4,5,6,7,8,9,10,11,12,13,13,14,14,15,15,15,16,16,16,16,16,16,16,16,16
E01024854,EV motorcycles,Number,0,1,1,2,3,3,4,5,6,7,8,9,10,11,12,12,13,13,14,14,14,15,15,15,15,15,15,15,15,15
E01026254,EV motorcycles,Number,0,0,0,0,0,0,0,0,0,0,0,0,0,0,0,0,0,0,0,0,0,0,0,0,0,0,0,0,0,0
E01026280,EV motorcycles,Number,0,0,0,0,0,0,0,0,0,0,0,0,0,0,0,0,0,0,0,0,0,0,0,0,0,0,0,0,0,0
E01026419,EV motorcycles,Number,1,3,5,9,14,19,24,30,36,41,47,52,57,62,66,70,73,76,78,79,81,82,82,83,83,83,84,84,84,84
E01026420,EV motorcycles,Number,1,3,5,8,12,16,20,25,30,34,39,44,48,52,55,58,61,63,65,66,67,68,69,69,69,70,70,70,70,70
E01026421,EV motorcycles,Number,1,3,6,10,15,20,25,31,37,43,49,55,60,65,69,73,76,79,81,83,84,85,86,87,87,87,88,88,88,88
E01026422,EV motorcycles,Number,1,3,6,10,16,21,27,33,39,46,52,58,64,69,73,77,81,84,86,88,89,90,91,92,92,92,93,93,93,93
E01026423,EV motorcycles,Number,1,2,4,7,10,14,18,22,26,30,34,38,42,45,48,51,53,55,56,58,58,59,60,60,60,61,61,61,61,61
E01026424,EV motorcycles,Number,1,3,5,9,14,18,23,29,34,40,45,50,55,60,64,67,70,73,75,76,78,79,79,80,80,80,81,81,81,81
E01026425,EV motorcycles,Number,1,2,4,7,11,14,18,22,27,31,35,39,43,47,50,52,55,57,58,59,60,61,62,62,62,63,63,63,63,63
E01026426,EV motorcycles,Number,1,3,5,8,12,16,20,25,30,34,39,44,48,52,55,58,61,63,65,66,67,68,69,69,69,70,70,70,70,70
E01026427,EV motorcycles,Number,5,13,23,39,59,80,103,126,150,175,199,222,243,263,281,296,309,320,329,336,341,345,349,351,352,354,356,356,356,356
E01026428,EV motorcycles,Number,2,4,7,12,19,25,32,39,47,55,62,69,76,82,88,92,96,100,103,105,106,108,109,109,110,110,111,111,111,111
E01026429,EV motorcycles,Number,1,2,4,6,10,13,17,21,25,29,32,36,40,43,46,48,50,52,54,55,56,56,57,57,57,58,58,58,58,58
E01026430,EV motorcycles,Number,1,2,3,6,9,12,15,19,22,26,30,33,36,39,42,44,46,48,49,50,51,51,52,52,52,53,53,53,53,53
E01026431,EV motorcycles,Number,0,1,2,3,5,6,8,10,11,13,15,17,18,20,21,22,23,24,25,25,26,26,26,27,27,27,27,27,27,27
E01026432,EV motorcycles,Number,1,1,2,4,6,8,11,13,16,18,21,23,25,27,29,31,32,33,34,35,35,36,36,36,37,37,37,37,37,37
E01026433,EV motorcycles,Number,0,1,2,4,6,8,10,12,14,17,19,21,23,25,27,28,30,31,31,32,33,33,33,33,34,34,34,34,34,34
E01026434,EV motorcycles,Number,1,2,4,7,10,14,18,22,26,30,35,39,42,46,49,52,54,56,57,59,59,60,61,61,61,62,62,62,62,62
E01026435,EV motorcycles,Number,2,4,7,12,18,24,30,37,44,52,59,65,72,78,83,87,91,94,97,99,101,102,103,103,104,104,105,105,105,105
E01026436,EV motorcycles,Number,1,3,6,10,15,20,25,31,37,43,49,54,59,64,69,72,76,78,80,82,83,84,85,86,86,86,87,87,87,87
E01026437,EV motorcycles,Number,1,3,5,8,13,17,22,27,32,37,42,47,51,55,59,62,65,67,69,71,72,73,73,74,74,74,75,75,75,75
E01026438,EV motorcycles,Number,1,2,3,6,9,12,15,19,22,26,30,33,36,39,42,44,46,48,49,50,51,51,52,52,52,53,53,53,53,53
E01026439,EV motorcycles,Number,1,3,5,9,14,18,23,29,34,40,45,50,55,60,64,67,70,73,75,76,78,79,79,80,80,80,81,81,81,81
E01026440,EV motorcycles,Number,1,1,3,4,7,9,11,14,16,19,22,24,27,29,31,32,34,35,36,37,37,38,38,38,39,39,39,39,39,39
E01026441,EV motorcycles,Number,1,2,3,5,8,11,14,17,20,23,26,29,32,35,37,39,41,42,43,44,45,46,46,46,47,47,47,47,47,47
E01026442,EV motorcycles,Number,1,3,5,9,14,19,24,30,36,41,47,52,57,62,66,70,73,76,78,79,81,82,82,83,83,83,84,84,84,84
E01026443,EV motorcycles,Number,2,4,7,12,18,24,31,38,45,52,59,66,72,78,84,88,92,95,98,100,102,103,104,104,105,105,106,106,106,106
E01026444,EV motorcycles,Number,2,5,9,15,22,30,39,48,57,66,75,83,92,99,106,111,116,120,124,126,128,130,131,132,133,133,134,134,134,134
E01026445,EV motorcycles,Number,1,2,4,7,11,15,19,23,27,32,36,40,44,48,51,54,56,58,60,61,62,63,64,64,64,65,65,65,65,65
E01026446,EV motorcycles,Number,1,3,5,9,13,18,23,28,33,39,44,49,54,58,62,66,69,71,73,75,76,77,77,78,78,78,79,79,79,79
E01026447,EV motorcycles,Number,1,2,3,5,8,10,13,16,19,22,25,28,31,33,35,37,39,40,42,42,43,44,44,44,45,45,45,45,45,45
E01026448,EV motorcycles,Number,1,3,6,10,15,20,25,31,37,43,49,54,59,64,69,72,76,78,80,82,83,84,85,86,86,86,87,87,87,87
E01026449,EV motorcycles,Number,1,3,5,8,12,17,21,26,31,36,41,46,51,55,58,62,64,67,68,70,71,72,72,73,73,73,74,74,74,74
E01026450,EV motorcycles,Number,1,2,4,6,10,13,17,21,25,29,32,36,40,43,46,48,50,52,54,55,56,56,57,57,57,58,58,58,58,58
E01026451,EV motorcycles,Number,2,5,8,14,21,29,37,45,54,62,71,79,87,94,100,106,110,114,117,120,122,123,124,125,126,126,127,127,127,127
E01026452,EV motorcycles,Number,1,2,4,7,11,14,19,23,27,31,36,40,44,47,50,53,56,58,59,60,61,62,63,63,63,64,64,64,64,64
E01026453,EV motorcycles,Number,1,3,5,9,14,19,24,30,36,41,47,52,57,62,66,70,73,76,78,79,81,82,82,83,83,83,84,84,84,84
E01026454,EV motorcycles,Number,1,1,3,5,7,9,12,15,17,20,23,26,28,30,32,34,36,37,38,39,39,40,40,40,41,41,41,41,41,41
E01026455,EV motorcycles,Number,1,2,4,7,10,14,18,22,26,30,34,38,42,45,48,51,53,55,56,58,58,59,60,60,60,61,61,61,61,61
E01026456,EV motorcycles,Number,1,2,3,5,8,11,14,17,20,23,26,29,32,35,37,39,41,42,43,44,45,46,46,46,47,47,47,47,47,47
E01026457,EV motorcycles,Number,1,2,3,6,9,12,15,18,22,26,29,32,36,38,41,43,45,47,48,49,50,50,51,51,51,52,52,52,52,52
E01026458,EV motorcycles,Number,1,2,4,6,9,12,16,20,23,27,31,34,38,41,43,46,48,49,51,52,53,53,54,54,54,55,55,55,55,55
E01026459,EV motorcycles,Number,1,1,3,4,7,9,12,14,17,20,22,25,27,30,32,33,35,36,37,38,38,39,39,39,40,40,40,40,40,40
E01026461,EV motorcycles,Number,1,2,4,6,9,13,16,20,24,28,31,35,38,41,44,47,49,50,52,53,54,54,55,55,55,56,56,56,56,56
E01026462,EV motorcycles,Number,2,4,7,12,19,25,32,39,47,55,62,69,76,82,88,92,96,100,103,105,106,108,109,109,110,110,111,111,111,111
E01026464,EV motorcycles,Number,1,3,5,8,13,17,22,27,32,37,43,47,52,56,60,63,66,68,70,72,73,74,74,75,75,75,76,76,76,76
E01026465,EV motorcycles,Number,1,1,3,4,7,9,12,14,17,20,22,25,27,30,32,33,35,36,37,38,38,39,39,39,40,40,40,40,40,40
E01026466,EV motorcycles,Number,1,2,3,5,8,11,14,17,20,24,27,30,33,35,38,40,42,43,44,45,46,47,47,47,48,48,48,48,48,48
E01026467,EV motorcycles,Number,0,1,2,4,6,7,10,12,14,16,18,21,23,24,26,27,29,30,31,31,32,32,32,33,33,33,33,33,33,33
E01026468,EV motorcycles,Number,1,2,4,6,9,12,16,20,23,27,31,34,38,41,43,46,48,49,51,52,53,53,54,54,54,55,55,55,55,55
E01026469,EV motorcycles,Number,1,2,3,5,7,10,12,15,18,21,24,27,29,32,34,36,37,39,40,41,41,42,42,42,43,43,43,43,43,43
E01026470,EV motorcycles,Number,1,2,5,8,12,15,20,25,29,34,39,43,47,51,54,57,60,62,64,65,66,67,68,68,68,69,69,69,69,69
E01026471,EV motorcycles,Number,0,1,2,3,5,7,9,11,13,15,17,19,21,23,24,26,27,28,29,29,30,30,30,31,31,31,31,31,31,31
E01026472,EV motorcycles,Number,0,1,2,3,5,7,9,11,13,15,17,19,21,23,24,26,27,28,29,29,30,30,30,31,31,31,31,31,31,31
E01026473,EV motorcycles,Number,1,1,3,4,7,9,12,14,17,20,22,25,27,30,32,33,35,36,37,38,38,39,39,39,40,40,40,40,40,40
E01026474,EV motorcycles,Number,1,2,4,7,10,14,18,22,26,30,35,39,42,46,49,52,54,56,57,59,59,60,61,61,61,62,62,62,62,62
E01026475,EV motorcycles,Number,0,1,2,4,6,7,10,12,14,16,18,21,23,24,26,27,29,30,31,31,32,32,32,33,33,33,33,33,33,33
E01026476,EV motorcycles,Number,1,1,2,4,6,8,11,13,16,18,21,23,25,27,29,31,32,33,34,35,35,36,36,36,37,37,37,37,37,37
E01026477,EV motorcycles,Number,0,1,2,4,6,7,10,12,14,16,18,21,23,24,26,27,29,30,31,31,32,32,32,33,33,33,33,33,33,33
E01026478,EV motorcycles,Number,0,1,2,3,5,6,8,10,12,14,16,17,19,21,22,23,24,25,26,26,27,27,27,28,28,28,28,28,28,28
E01026479,EV motorcycles,Number,1,2,4,6,10,13,16,20,24,28,32,35,39,42,45,47,50,51,53,54,55,55,56,56,56,57,57,57,57,57
E01026480,EV motorcycles,Number,1,2,3,5,8,11,14,17,21,24,27,31,33,36,39,41,43,44,45,46,47,48,48,48,48,49,49,49,49,49
E01026481,EV motorcycles,Number,1,2,4,6,9,12,16,19,23,27,30,34,37,40,43,45,47,49,50,51,52,52,53,53,53,54,54,54,54,54
E01026483,EV motorcycles,Number,1,2,3,6,9,11,15,18,22,25,29,32,35,38,40,42,44,46,47,48,49,49,50,50,50,51,51,51,51,51
E01026484,EV motorcycles,Number,6,14,25,43,65,88,113,139,165,192,218,243,267,288,307,324,339,351,360,368,374,378,382,384,386,387,390,390,390,390
E01026485,EV motorcycles,Number,1,2,4,7,10,13,17,21,25,30,34,37,41,44,47,50,52,54,55,57,58,58,59,59,59,60,60,60,60,60
E01026486,EV motorcycles,Number,1,3,5,9,14,19,24,29,35,41,46,52,57,61,65,69,72,75,77,78,80,81,81,82,82,82,83,83,83,83
E01026487,EV motorcycles,Number,1,2,4,7,11,14,18,22,27,31,35,39,43,47,50,52,55,57,58,59,60,61,62,62,62,63,63,63,63,63
E01026488,EV motorcycles,Number,1,1,2,4,6,9,11,13,16,19,21,24,26,28,30,32,33,34,35,36,36,37,37,37,38,38,38,38,38,38
E01026489,EV motorcycles,Number,1,2,4,7,11,15,19,23,27,32,36,40,44,48,51,54,56,58,60,61,62,63,64,64,64,65,65,65,65,65
E01026490,EV motorcycles,Number,1,2,4,7,10,14,18,22,26,30,34,38,42,45,48,51,53,55,56,58,58,59,60,60,60,61,61,61,61,61
E01026491,EV motorcycles,Number,1,3,6,10,16,21,27,33,39,46,52,58,64,69,73,77,81,84,86,88,89,90,91,92,92,92,93,93,93,93
E01026492,EV motorcycles,Number,0,1,2,3,5,7,9,11,13,15,17,19,21,23,24,26,27,28,29,29,30,30,30,31,31,31,31,31,31,31
E01026493,EV motorcycles,Number,1,2,3,6,9,12,15,18,22,26,29,32,36,38,41,43,45,47,48,49,50,50,51,51,51,52,52,52,52,52
E01026494,EV motorcycles,Number,2,4,7,12,19,25,32,40,47,55,63,70,77,83,88,93,97,101,104,106,107,109,110,110,111,111,112,112,112,112
E01026495,EV motorcycles,Number,1,1,3,4,7,9,11,14,16,19,22,24,27,29,31,32,34,35,36,37,37,38,38,38,39,39,39,39,39,39
E01026496,EV motorcycles,Number,1,2,4,7,11,15,19,23,27,32,36,40,44,48,51,54,56,58,60,61,62,63,64,64,64,65,65,65,65,65
E01026497,EV motorcycles,Number,1,2,4,7,10,14,18,22,26,30,34,38,42,45,48,51,53,55,56,58,58,59,60,60,60,61,61,61,61,61
E01026498,EV motorcycles,Number,0,1,2,3,5,6,8,10,11,13,15,17,18,20,21,22,23,24,25,25,26,26,26,27,27,27,27,27,27,27
E01026499,EV motorcycles,Number,1,2,4,6,9,12,16,19,23,27,30,34,37,40,43,45,47,49,50,51,52,52,53,53,53,54,54,54,54,54
E01026500,EV motorcycles,Number,1,2,3,5,8,11,14,17,20,23,26,29,32,35,37,39,41,42,43,44,45,46,46,46,47,47,47,47,47,47
E01026501,EV motorcycles,Number,1,2,3,6,9,12,15,19,22,26,30,33,36,39,42,44,46,48,49,50,51,51,52,52,52,53,53,53,53,53
E01026502,EV motorcycles,Number,1,2,4,6,9,12,16,20,23,27,31,34,38,41,43,46,48,49,51,52,53,53,54,54,54,55,55,55,55,55
E01026503,EV motorcycles,Number,1,2,4,7,10,13,17,21,25,30,34,37,41,44,47,50,52,54,55,57,58,58,59,59,59,60,60,60,60,60
E01026504,EV motorcycles,Number,1,2,4,6,9,12,16,19,23,27,30,34,37,40,43,45,47,49,50,51,52,52,53,53,53,54,54,54,54,54
E01026505,EV motorcycles,Number,1,2,4,7,10,13,17,21,25,30,34,37,41,44,47,50,52,54,55,57,58,58,59,59,59,60,60,60,60,60
E01026506,EV motorcycles,Number,1,2,3,5,7,10,13,16,19,22,25,27,30,33,35,37,38,40,41,42,42,43,43,43,44,44,44,44,44,44
E01026507,EV motorcycles,Number,1,2,3,5,7,10,13,16,19,22,25,27,30,33,35,37,38,40,41,42,42,43,43,43,44,44,44,44,44,44
E01026508,EV motorcycles,Number,1,1,2,4,6,8,10,12,15,17,20,22,24,26,28,29,30,31,32,33,34,34,34,34,35,35,35,35,35,35
E01026509,EV motorcycles,Number,1,2,3,6,9,12,15,18,22,26,29,32,36,38,41,43,45,47,48,49,50,50,51,51,51,52,52,52,52,52
E01026510,EV motorcycles,Number,1,2,3,6,9,12,15,18,22,26,29,32,36,38,41,43,45,47,48,49,50,50,51,51,51,52,52,52,52,52
E01026511,EV motorcycles,Number,1,3,5,8,12,16,20,25,30,34,39,44,48,52,55,58,61,63,65,66,67,68,69,69,69,70,70,70,70,70
E01026512,EV motorcycles,Number,1,2,3,5,7,10,13,16,19,22,25,27,30,33,35,37,38,40,41,42,42,43,43,43,44,44,44,44,44,44
E01026513,EV motorcycles,Number,0,1,2,4,6,8,10,12,14,17,19,21,23,25,27,28,30,31,31,32,33,33,33,33,34,34,34,34,34,34
E01026514,EV motorcycles,Number,1,2,4,6,10,13,16,20,24,28,32,35,39,42,45,47,50,51,53,54,55,55,56,56,56,57,57,57,57,57
E01026515,EV motorcycles,Number,1,2,3,6,9,12,15,19,22,26,30,33,36,39,42,44,46,48,49,50,51,51,52,52,52,53,53,53,53,53
E01026516,EV motorcycles,Number,0,1,2,3,5,6,8,10,11,13,15,17,18,20,21,22,23,24,25,25,26,26,26,27,27,27,27,27,27,27
E01026517,EV motorcycles,Number,1,2,4,7,11,15,19,23,27,32,36,40,44,48,51,54,56,58,60,61,62,63,64,64,64,65,65,65,65,65
E01026518,EV motorcycles,Number,1,2,3,6,9,12,15,19,22,26,30,33,36,39,42,44,46,48,49,50,51,51,52,52,52,53,53,53,53,53
E01026519,EV motorcycles,Number,1,2,3,5,7,10,12,15,18,21,24,27,29,32,34,36,37,39,40,41,41,42,42,42,43,43,43,43,43,43
E01026520,EV motorcycles,Number,0,1,2,3,5,7,9,11,13,15,17,19,21,23,24,26,27,28,29,29,30,30,30,31,31,31,31,31,31,31
E01026521,EV motorcycles,Number,0,1,2,4,6,8,10,12,14,17,19,21,23,25,27,28,30,31,31,32,33,33,33,33,34,34,34,34,34,34
E01026522,EV motorcycles,Number,1,2,4,6,9,12,16,19,23,27,30,34,37,40,43,45,47,49,50,51,52,52,53,53,53,54,54,54,54,54
E01026523,EV motorcycles,Number,1,3,6,10,15,20,26,32,38,45,51,57,62,67,72,76,79,82,84,86,87,88,89,90,90,90,91,91,91,91
E01026524,EV motorcycles,Number,1,3,5,9,13,18,23,28,33,39,44,49,54,58,62,66,69,71,73,75,76,77,77,78,78,78,79,79,79,79
E01026525,EV motorcycles,Number,1,2,3,6,9,12,15,18,22,26,29,32,36,38,41,43,45,47,48,49,50,50,51,51,51,52,52,52,52,52
E01026526,EV motorcycles,Number,1,2,4,6,9,12,16,20,23,27,31,34,38,41,43,46,48,49,51,52,53,53,54,54,54,55,55,55,55,55
E01026527,EV motorcycles,Number,1,2,3,5,7,10,13,16,19,22,25,27,30,33,35,37,38,40,41,42,42,43,43,43,44,44,44,44,44,44
E01026528,EV motorcycles,Number,1,2,3,5,8,11,14,17,21,24,27,31,33,36,39,41,43,44,45,46,47,48,48,48,48,49,49,49,49,49
E01026529,EV motorcycles,Number,1,2,4,6,10,13,17,21,25,29,32,36,40,43,46,48,50,52,54,55,56,56,57,57,57,58,58,58,58,58
E01026530,EV motorcycles,Number,1,2,4,7,10,13,17,21,25,30,34,37,41,44,47,50,52,54,55,57,58,58,59,59,59,60,60,60,60,60
E01026531,EV motorcycles,Number,1,2,5,8,12,15,20,25,29,34,39,43,47,51,54,57,60,62,64,65,66,67,68,68,68,69,69,69,69,69
E01026532,EV motorcycles,Number,1,3,5,8,13,17,22,27,33,38,43,48,53,57,61,64,67,69,71,73,74,75,75,76,76,76,77,77,77,77
E01026533,EV motorcycles,Number,1,2,4,7,11,15,19,23,28,32,37,41,45,49,52,55,57,59,61,62,63,64,65,65,65,66,66,66,66,66
E01026534,EV motorcycles,Number,1,3,5,8,13,17,22,27,32,37,42,47,51,55,59,62,65,67,69,71,72,73,73,74,74,74,75,75,75,75
E01026535,EV motorcycles,Number,1,4,6,11,16,22,28,35,41,48,55,61,67,72,77,82,85,88,91,93,94,95,96,97,97,97,98,98,98,98
E01026536,EV motorcycles,Number,1,2,4,7,11,15,19,23,27,32,36,40,44,48,51,54,56,58,60,61,62,63,64,64,64,65,65,65,65,65
E01026537,EV motorcycles,Number,1,2,4,6,10,13,16,20,24,28,32,35,39,42,45,47,50,51,53,54,55,55,56,56,56,57,57,57,57,57
E01026538,EV motorcycles,Number,1,1,3,5,7,9,12,15,17,20,23,26,28,30,32,34,36,37,38,39,39,40,40,40,41,41,41,41,41,41
E01026539,EV motorcycles,Number,1,2,4,7,11,14,19,23,27,31,36,40,44,47,50,53,56,58,59,60,61,62,63,63,63,64,64,64,64,64
E01026540,EV motorcycles,Number,1,1,2,4,6,8,11,13,16,18,21,23,25,27,29,31,32,33,34,35,35,36,36,36,37,37,37,37,37,37
E01026541,EV motorcycles,Number,1,3,5,9,13,18,23,28,33,39,44,49,54,58,62,66,69,71,73,75,76,77,77,78,78,78,79,79,79,79
E01026542,EV motorcycles,Number,1,2,3,5,8,10,13,16,19,22,25,28,31,33,35,37,39,40,42,42,43,44,44,44,45,45,45,45,45,45
E01026543,EV motorcycles,Number,0,1,2,4,6,7,10,12,14,16,18,21,23,24,26,27,29,30,31,31,32,32,32,33,33,33,33,33,33,33
E01026544,EV motorcycles,Number,1,2,4,6,10,13,17,21,25,29,32,36,40,43,46,48,50,52,54,55,56,56,57,57,57,58,58,58,58,58
E01026545,EV motorcycles,Number,1,2,4,7,10,13,17,21,25,30,34,37,41,44,47,50,52,54,55,57,58,58,59,59,59,60,60,60,60,60
E01026546,EV motorcycles,Number,1,2,3,5,7,10,13,16,19,22,25,27,30,33,35,37,38,40,41,42,42,43,43,43,44,44,44,44,44,44
E01026547,EV motorcycles,Number,1,2,3,6,9,11,15,18,22,25,29,32,35,38,40,42,44,46,47,48,49,49,50,50,50,51,51,51,51,51
E01026548,EV motorcycles,Number,1,2,4,7,11,14,19,23,27,31,36,40,44,47,50,53,56,58,59,60,61,62,63,63,63,64,64,64,64,64
E01026549,EV motorcycles,Number,1,3,6,9,14,19,25,30,36,42,48,53,58,63,67,71,74,76,79,80,82,82,83,84,84,84,85,85,85,85
E01026550,EV motorcycles,Number,0,1,2,3,5,7,8,10,12,14,16,18,20,21,23,24,25,26,27,27,28,28,28,29,29,29,29,29,29,29
E01026551,EV motorcycles,Number,1,1,2,4,6,8,10,13,15,18,20,22,25,27,28,30,31,32,33,34,35,35,35,35,36,36,36,36,36,36
E01026552,EV motorcycles,Number,1,3,5,9,14,19,24,30,36,41,47,52,57,62,66,70,73,76,78,79,81,82,82,83,83,83,84,84,84,84
E01026553,EV motorcycles,Number,1,1,2,4,6,8,10,13,15,18,20,22,25,27,28,30,31,32,33,34,35,35,35,35,36,36,36,36,36,36
E01026554,EV motorcycles,Number,0,1,2,3,5,6,8,10,12,14,16,17,19,21,22,23,24,25,26,26,27,27,27,28,28,28,28,28,28,28
E01026555,EV motorcycles,Number,1,2,4,7,11,15,19,24,28,33,37,42,46,50,53,56,58,60,62,63,64,65,66,66,66,67,67,67,67,67
E01026556,EV motorcycles,Number,1,2,3,5,8,10,13,16,19,22,25,28,31,33,35,37,39,40,42,42,43,44,44,44,45,45,45,45,45,45
E01026557,EV motorcycles,Number,1,2,3,5,7,10,13,16,19,22,25,27,30,33,35,37,38,40,41,42,42,43,43,43,44,44,44,44,44,44
E01026558,EV motorcycles,Number,1,4,6,11,16,22,28,35,41,48,55,61,67,72,77,82,85,88,91,93,94,95,96,97,97,97,98,98,98,98
E01026559,EV motorcycles,Number,1,2,3,5,7,10,12,15,18,21,24,27,29,32,34,36,37,39,40,41,41,42,42,42,43,43,43,43,43,43
E01026560,EV motorcycles,Number,1,2,4,6,10,13,16,20,24,28,32,35,39,42,45,47,50,51,53,54,55,55,56,56,56,57,57,57,57,57
E01026561,EV motorcycles,Number,1,3,6,10,15,20,25,31,37,43,49,54,59,64,69,72,76,78,80,82,83,84,85,86,86,86,87,87,87,87
E01026562,EV motorcycles,Number,0,1,2,4,6,8,10,12,14,17,19,21,23,25,27,28,30,31,31,32,33,33,33,33,34,34,34,34,34,34
E01026563,EV motorcycles,Number,0,1,2,3,5,7,9,11,13,15,17,19,21,23,24,26,27,28,29,29,30,30,30,31,31,31,31,31,31,31
E01026564,EV motorcycles,Number,1,1,2,4,6,8,11,13,16,18,21,23,25,27,29,31,32,33,34,35,35,36,36,36,37,37,37,37,37,37
E01026565,EV motorcycles,Number,0,1,1,2,4,5,6,7,9,10,12,13,14,16,17,17,18,19,19,20,20,20,21,21,21,21,21,21,21,21
E01026566,EV motorcycles,Number,1,2,3,5,7,10,13,16,19,22,25,27,30,33,35,37,38,40,41,42,42,43,43,43,44,44,44,44,44,44
E01026567,EV motorcycles,Number,1,2,3,5,8,10,13,16,19,23,26,29,31,34,36,38,40,41,43,43,44,45,45,45,46,46,46,46,46,46
E01026568,EV motorcycles,Number,0,1,2,3,5,7,8,10,12,14,16,18,20,21,23,24,25,26,27,27,28,28,28,29,29,29,29,29,29,29
E01026569,EV motorcycles,Number,1,1,3,4,7,9,11,14,16,19,22,24,27,29,31,32,34,35,36,37,37,38,38,38,39,39,39,39,39,39
E01026570,EV motorcycles,Number,1,3,5,8,12,17,21,26,31,36,41,46,51,55,58,62,64,67,68,70,71,72,72,73,73,73,74,74,74,74
E01026571,EV motorcycles,Number,0,1,2,3,5,7,9,11,13,15,17,19,21,22,24,25,26,27,28,28,29,29,29,30,30,30,30,30,30,30
E01026572,EV motorcycles,Number,1,2,3,6,8,11,14,18,21,25,28,31,34,37,39,42,43,45,46,47,48,49,49,49,49,50,50,50,50,50
E01026573,EV motorcycles,Number,1,1,3,5,7,9,12,15,17,20,23,26,28,30,32,34,36,37,38,39,39,40,40,40,41,41,41,41,41,41
E01026574,EV motorcycles,Number,1,2,3,5,7,10,13,16,19,22,25,27,30,33,35,37,38,40,41,42,42,43,43,43,44,44,44,44,44,44
E01026575,EV motorcycles,Number,1,2,3,5,8,11,14,17,21,24,27,31,33,36,39,41,43,44,45,46,47,48,48,48,48,49,49,49,49,49
E01026576,EV motorcycles,Number,1,2,3,5,8,10,13,16,19,22,25,28,31,33,35,37,39,40,42,42,43,44,44,44,45,45,45,45,45,45
E01026577,EV motorcycles,Number,1,2,3,5,8,11,14,17,20,23,26,29,32,35,37,39,41,42,43,44,45,46,46,46,47,47,47,47,47,47
E01026578,EV motorcycles,Number,1,4,6,11,17,22,29,35,42,49,55,62,68,73,78,82,86,89,92,93,95,96,97,98,98,98,99,99,99,99
E01026579,EV motorcycles,Number,1,2,4,7,10,14,18,22,26,30,35,39,42,46,49,52,54,56,57,59,59,60,61,61,61,62,62,62,62,62
E01026580,EV motorcycles,Number,1,2,4,7,11,15,19,23,28,32,37,41,45,49,52,55,57,59,61,62,63,64,65,65,65,66,66,66,66,66
E01026581,EV motorcycles,Number,1,2,3,6,9,12,15,18,22,26,29,32,36,38,41,43,45,47,48,49,50,50,51,51,51,52,52,52,52,52
E01026582,EV motorcycles,Number,1,2,4,6,10,13,17,21,25,29,32,36,40,43,46,48,50,52,54,55,56,56,57,57,57,58,58,58,58,58
E01026583,EV motorcycles,Number,1,1,3,4,7,9,12,14,17,20,22,25,27,30,32,33,35,36,37,38,38,39,39,39,40,40,40,40,40,40
E01026584,EV motorcycles,Number,1,2,4,6,9,12,16,20,23,27,31,34,38,41,43,46,48,49,51,52,53,53,54,54,54,55,55,55,55,55
E01026585,EV motorcycles,Number,1,2,3,5,7,10,13,16,19,22,25,27,30,33,35,37,38,40,41,42,42,43,43,43,44,44,44,44,44,44
E01026586,EV motorcycles,Number,0,1,2,4,6,7,10,12,14,16,18,21,23,24,26,27,29,30,31,31,32,32,32,33,33,33,33,33,33,33
E01026587,EV motorcycles,Number,1,3,5,9,14,19,24,30,36,41,47,52,57,62,66,70,73,76,78,79,81,82,82,83,83,83,84,84,84,84
E01026588,EV motorcycles,Number,1,4,6,11,16,22,28,34,41,48,54,60,66,72,76,81,84,87,90,92,93,94,95,96,96,96,97,97,97,97
E01026589,EV motorcycles,Number,1,1,3,4,7,9,11,14,16,19,22,24,27,29,31,32,34,35,36,37,37,38,38,38,39,39,39,39,39,39
E01026590,EV motorcycles,Number,1,1,3,4,7,9,12,14,17,20,22,25,27,30,32,33,35,36,37,38,38,39,39,39,40,40,40,40,40,40
E01026591,EV motorcycles,Number,1,2,4,6,9,12,16,20,23,27,31,34,38,41,43,46,48,49,51,52,53,53,54,54,54,55,55,55,55,55
E01026592,EV motorcycles,Number,0,1,2,3,5,7,9,11,13,15,17,19,21,23,24,26,27,28,29,29,30,30,30,31,31,31,31,31,31,31
E01026593,EV motorcycles,Number,1,1,2,4,6,9,11,13,16,19,21,24,26,28,30,32,33,34,35,36,36,37,37,37,38,38,38,38,38,38
E01026594,EV motorcycles,Number,1,2,3,6,9,12,15,18,22,26,29,32,36,38,41,43,45,47,48,49,50,50,51,51,51,52,52,52,52,52
E01026595,EV motorcycles,Number,0,1,2,4,6,8,10,12,14,17,19,21,23,25,27,28,30,31,31,32,33,33,33,33,34,34,34,34,34,34
E01026596,EV motorcycles,Number,1,2,3,6,9,11,15,18,22,25,29,32,35,38,40,42,44,46,47,48,49,49,50,50,50,51,51,51,51,51
E01026597,EV motorcycles,Number,1,1,2,4,6,8,10,13,15,18,20,22,25,27,28,30,31,32,33,34,35,35,35,35,36,36,36,36,36,36
E01026598,EV motorcycles,Number,1,1,2,4,6,8,11,13,16,18,21,23,25,27,29,31,32,33,34,35,35,36,36,36,37,37,37,37,37,37
E01026599,EV motorcycles,Number,0,1,2,3,4,5,7,9,10,12,13,15,16,18,19,20,21,22,22,23,23,23,23,24,24,24,24,24,24,24
E01026600,EV motorcycles,Number,1,1,3,4,7,9,11,14,16,19,22,24,27,29,31,32,34,35,36,37,37,38,38,38,39,39,39,39,39,39
E01026601,EV motorcycles,Number,0,1,1,2,4,5,6,7,9,10,12,13,14,16,17,17,18,19,19,20,20,20,21,21,21,21,21,21,21,21
E01026602,EV motorcycles,Number,1,2,3,5,8,11,14,17,20,24,27,30,33,35,38,40,42,43,44,45,46,47,47,47,48,48,48,48,48,48
E01026603,EV motorcycles,Number,0,1,2,3,5,7,9,11,13,15,17,19,21,22,24,25,26,27,28,28,29,29,29,30,30,30,30,30,30,30
E01026604,EV motorcycles,Number,1,1,2,4,6,8,10,13,15,18,20,22,25,27,28,30,31,32,33,34,35,35,35,35,36,36,36,36,36,36
E01026605,EV motorcycles,Number,1,2,4,6,9,12,16,20,23,27,31,34,38,41,43,46,48,49,51,52,53,53,54,54,54,55,55,55,55,55
E01026606,EV motorcycles,Number,1,2,3,6,9,11,15,18,22,25,29,32,35,38,40,42,44,46,47,48,49,49,50,50,50,51,51,51,51,51
E01026607,EV motorcycles,Number,1,2,3,6,9,11,15,18,22,25,29,32,35,38,40,42,44,46,47,48,49,49,50,50,50,51,51,51,51,51
E01026608,EV motorcycles,Number,1,2,4,7,10,13,17,21,25,30,34,37,41,44,47,50,52,54,55,57,58,58,59,59,59,60,60,60,60,60
E01026609,EV motorcycles,Number,1,2,3,5,8,10,13,16,19,23,26,29,31,34,36,38,40,41,43,43,44,45,45,45,46,46,46,46,46,46
E01026610,EV motorcycles,Number,0,1,2,4,6,7,10,12,14,16,18,21,23,24,26,27,29,30,31,31,32,32,32,33,33,33,33,33,33,33
E01026611,EV motorcycles,Number,0,1,2,3,5,7,8,10,12,14,16,18,20,21,23,24,25,26,27,27,28,28,28,29,29,29,29,29,29,29
E01026612,EV motorcycles,Number,1,3,5,8,12,17,21,26,31,36,41,46,51,55,58,62,64,67,68,70,71,72,72,73,73,73,74,74,74,74
E01026613,EV motorcycles,Number,1,2,3,5,8,11,14,17,20,24,27,30,33,35,38,40,42,43,44,45,46,47,47,47,48,48,48,48,48,48
E01026614,EV motorcycles,Number,1,2,4,7,11,15,19,23,27,32,36,40,44,48,51,54,56,58,60,61,62,63,64,64,64,65,65,65,65,65
E01026615,EV motorcycles,Number,1,2,4,7,10,14,18,22,26,30,34,38,42,45,48,51,53,55,56,58,58,59,60,60,60,61,61,61,61,61
E01026616,EV motorcycles,Number,1,2,3,5,8,11,14,17,21,24,27,31,33,36,39,41,43,44,45,46,47,48,48,48,48,49,49,49,49,49
E01026617,EV motorcycles,Number,0,1,2,4,6,8,10,12,14,17,19,21,23,25,27,28,30,31,31,32,33,33,33,33,34,34,34,34,34,34
E01026618,EV motorcycles,Number,0,1,2,4,6,8,10,12,14,17,19,21,23,25,27,28,30,31,31,32,33,33,33,33,34,34,34,34,34,34
E01026619,EV motorcycles,Number,0,1,2,4,5,7,9,11,14,16,18,20,22,24,25,27,28,29,30,30,31,31,31,32,32,32,32,32,32,32
E01026620,EV motorcycles,Number,0,1,2,3,4,5,7,8,10,11,13,14,16,17,18,19,20,21,21,22,22,22,23,23,23,23,23,23,23,23
E01026621,EV motorcycles,Number,1,2,3,5,8,11,14,17,20,23,26,29,32,35,37,39,41,42,43,44,45,46,46,46,47,47,47,47,47,47
E01026622,EV motorcycles,Number,0,1,2,4,6,8,10,12,14,17,19,21,23,25,27,28,30,31,31,32,33,33,33,33,34,34,34,34,34,34
E01026623,EV motorcycles,Number,0,1,1,2,4,5,6,7,9,10,12,13,14,16,17,17,18,19,19,20,20,20,21,21,21,21,21,21,21,21
E01026624,EV motorcycles,Number,0,1,2,3,4,6,7,9,11,12,14,16,17,18,20,21,22,22,23,24,24,24,24,25,25,25,25,25,25,25
E01026625,EV motorcycles,Number,0,1,2,3,4,6,8,9,11,13,15,16,18,19,20,22,23,23,24,25,25,25,25,26,26,26,26,26,26,26
E01026626,EV motorcycles,Number,1,1,2,4,6,8,11,13,16,18,21,23,25,27,29,31,32,33,34,35,35,36,36,36,37,37,37,37,37,37
E01026627,EV motorcycles,Number,1,2,3,5,7,10,13,16,19,22,25,27,30,33,35,37,38,40,41,42,42,43,43,43,44,44,44,44,44,44
E01026628,EV motorcycles,Number,1,2,3,6,9,12,15,19,22,26,30,33,36,39,42,44,46,48,49,50,51,51,52,52,52,53,53,53,53,53
E01026629,EV motorcycles,Number,1,2,4,6,10,13,17,21,25,29,32,36,40,43,46,48,50,52,54,55,56,56,57,57,57,58,58,58,58,58
E01026630,EV motorcycles,Number,1,1,2,4,6,8,10,13,15,18,20,22,25,27,28,30,31,32,33,34,35,35,35,35,36,36,36,36,36,36
E01026631,EV motorcycles,Number,1,1,3,4,7,9,12,14,17,20,22,25,27,30,32,33,35,36,37,38,38,39,39,39,40,40,40,40,40,40
E01026632,EV motorcycles,Number,0,1,2,4,6,7,10,12,14,16,18,21,23,24,26,27,29,30,31,31,32,32,32,33,33,33,33,33,33,33
E01026633,EV motorcycles,Number,1,2,3,5,7,10,13,16,19,22,25,27,30,33,35,37,38,40,41,42,42,43,43,43,44,44,44,44,44,44
E01026634,EV motorcycles,Number,1,1,2,4,6,8,10,12,15,17,20,22,24,26,28,29,30,31,32,33,34,34,34,34,35,35,35,35,35,35
E01026635,EV motorcycles,Number,1,2,4,6,9,12,16,19,23,27,30,34,37,40,43,45,47,49,50,51,52,52,53,53,53,54,54,54,54,54
E01026636,EV motorcycles,Number,1,2,3,6,9,12,15,18,22,26,29,32,36,38,41,43,45,47,48,49,50,50,51,51,51,52,52,52,52,52
E01026637,EV motorcycles,Number,1,2,4,7,10,14,18,22,26,30,34,38,42,45,48,51,53,55,56,58,58,59,60,60,60,61,61,61,61,61
E01026638,EV motorcycles,Number,1,3,6,10,15,20,25,31,37,43,49,54,59,64,69,72,76,78,80,82,83,84,85,86,86,86,87,87,87,87
E01026639,EV motorcycles,Number,1,1,2,4,6,8,11,13,16,18,21,23,25,27,29,31,32,33,34,35,35,36,36,36,37,37,37,37,37,37
E01026640,EV motorcycles,Number,0,1,2,3,5,7,8,10,12,14,16,18,20,21,23,24,25,26,27,27,28,28,28,29,29,29,29,29,29,29
E01026641,EV motorcycles,Number,1,2,3,5,8,10,13,16,19,22,25,28,31,33,35,37,39,40,42,42,43,44,44,44,45,45,45,45,45,45
E01026642,EV motorcycles,Number,1,1,3,4,7,9,11,14,16,19,22,24,27,29,31,32,34,35,36,37,37,38,38,38,39,39,39,39,39,39
E01026643,EV motorcycles,Number,1,2,5,8,12,15,20,25,29,34,39,43,47,51,54,57,60,62,64,65,66,67,68,68,68,69,69,69,69,69
E01026644,EV motorcycles,Number,0,1,2,3,4,6,7,9,11,12,14,16,17,18,20,21,22,22,23,24,24,24,24,25,25,25,25,25,25,25
E01026645,EV motorcycles,Number,0,1,2,3,5,7,9,11,13,15,17,19,21,23,24,26,27,28,29,29,30,30,30,31,31,31,31,31,31,31
E01026646,EV motorcycles,Number,0,1,2,4,6,8,10,12,14,17,19,21,23,25,27,28,30,31,31,32,33,33,33,33,34,34,34,34,34,34
E01026647,EV motorcycles,Number,2,4,7,12,18,24,31,39,46,53,61,68,74,80,86,90,94,98,100,103,104,105,106,107,108,108,109,109,109,109
E01026648,EV motorcycles,Number,1,2,5,8,12,15,20,25,29,34,39,43,47,51,54,57,60,62,64,65,66,67,68,68,68,69,69,69,69,69
E01026649,EV motorcycles,Number,1,2,5,8,12,15,20,25,29,34,39,43,47,51,54,57,60,62,64,65,66,67,68,68,68,69,69,69,69,69
E01026650,EV motorcycles,Number,0,1,1,2,3,4,6,7,8,10,11,12,14,15,16,17,17,18,18,19,19,19,20,20,20,20,20,20,20,20
E01026651,EV motorcycles,Number,2,5,8,14,21,29,37,45,54,62,71,79,87,94,100,106,110,114,117,120,122,123,124,125,126,126,127,127,127,127
E01026652,EV motorcycles,Number,1,2,3,5,7,10,13,16,19,22,25,27,30,33,35,37,38,40,41,42,42,43,43,43,44,44,44,44,44,44
E01026653,EV motorcycles,Number,1,2,3,6,9,11,15,18,22,25,29,32,35,38,40,42,44,46,47,48,49,49,50,50,50,51,51,51,51,51
E01026654,EV motorcycles,Number,1,2,3,6,9,12,15,19,22,26,30,33,36,39,42,44,46,48,49,50,51,51,52,52,52,53,53,53,53,53
E01026655,EV motorcycles,Number,1,1,3,4,7,9,11,14,16,19,22,24,27,29,31,32,34,35,36,37,37,38,38,38,39,39,39,39,39,39
E01026656,EV motorcycles,Number,1,2,4,7,11,15,20,24,29,33,38,42,46,50,54,57,59,61,63,64,65,66,67,67,67,68,68,68,68,68
E01026659,EV motorcycles,Number,1,3,5,8,12,17,21,26,31,36,41,46,51,55,58,62,64,67,68,70,71,72,72,73,73,73,74,74,74,74
E01026660,EV motorcycles,Number,1,3,5,8,12,16,21,26,31,36,41,45,50,54,58,61,63,66,67,69,70,71,71,72,72,72,73,73,73,73
E01026661,EV motorcycles,Number,1,3,6,10,15,20,25,31,37,43,49,55,60,65,69,73,76,79,81,83,84,85,86,87,87,87,88,88,88,88
E01026662,EV motorcycles,Number,1,1,3,4,7,9,11,14,16,19,22,24,27,29,31,32,34,35,36,37,37,38,38,38,39,39,39,39,39,39
E01026663,EV motorcycles,Number,0,1,2,4,6,7,10,12,14,16,18,21,23,24,26,27,29,30,31,31,32,32,32,33,33,33,33,33,33,33
E01026664,EV motorcycles,Number,1,1,2,4,6,8,10,13,15,18,20,22,25,27,28,30,31,32,33,34,35,35,35,35,36,36,36,36,36,36
E01026665,EV motorcycles,Number,1,3,5,9,13,18,23,28,33,39,44,49,54,58,62,66,69,71,73,75,76,77,77,78,78,78,79,79,79,79
E01026666,EV motorcycles,Number,1,2,4,6,10,13,16,20,24,28,32,35,39,42,45,47,50,51,53,54,55,55,56,56,56,57,57,57,57,57
E01026667,EV motorcycles,Number,0,1,2,3,4,6,7,9,11,12,14,16,17,18,20,21,22,22,23,24,24,24,24,25,25,25,25,25,25,25
E01026668,EV motorcycles,Number,1,1,3,4,7,9,12,14,17,20,22,25,27,30,32,33,35,36,37,38,38,39,39,39,40,40,40,40,40,40
E01026669,EV motorcycles,Number,1,3,5,8,12,17,21,26,31,36,41,46,51,55,58,62,64,67,68,70,71,72,72,73,73,73,74,74,74,74
E01026670,EV motorcycles,Number,0,1,2,4,6,8,10,12,14,17,19,21,23,25,27,28,30,31,31,32,33,33,33,33,34,34,34,34,34,34
E01026671,EV motorcycles,Number,1,2,3,5,7,10,13,16,19,22,25,27,30,33,35,37,38,40,41,42,42,43,43,43,44,44,44,44,44,44
E01026672,EV motorcycles,Number,1,2,3,6,9,12,15,18,22,26,29,32,36,38,41,43,45,47,48,49,50,50,51,51,51,52,52,52,52,52
E01026673,EV motorcycles,Number,0,1,2,3,4,6,8,9,11,13,15,16,18,19,20,22,23,23,24,25,25,25,25,26,26,26,26,26,26,26
E01026674,EV motorcycles,Number,0,1,2,3,5,7,9,11,13,15,17,19,21,22,24,25,26,27,28,28,29,29,29,30,30,30,30,30,30,30
E01026675,EV motorcycles,Number,1,2,3,5,7,10,12,15,18,21,24,27,29,32,34,36,37,39,40,41,41,42,42,42,43,43,43,43,43,43
E01026676,EV motorcycles,Number,1,2,3,6,8,11,14,18,21,25,28,31,34,37,39,42,43,45,46,47,48,49,49,49,49,50,50,50,50,50
E01026677,EV motorcycles,Number,1,1,2,4,6,8,10,13,15,18,20,22,25,27,28,30,31,32,33,34,35,35,35,35,36,36,36,36,36,36
E01026678,EV motorcycles,Number,0,1,2,4,6,8,10,12,14,17,19,21,23,25,27,28,30,31,31,32,33,33,33,33,34,34,34,34,34,34
E01026679,EV motorcycles,Number,2,4,7,12,18,24,31,38,45,53,60,67,73,79,84,89,93,96,99,101,103,104,105,105,106,106,107,107,107,107
E01026680,EV motorcycles,Number,0,1,2,4,6,8,10,12,14,17,19,21,23,25,27,28,30,31,31,32,33,33,33,33,34,34,34,34,34,34
E01026681,EV motorcycles,Number,0,1,2,3,5,7,9,11,13,15,17,19,21,22,24,25,26,27,28,28,29,29,29,30,30,30,30,30,30,30
E01026682,EV motorcycles,Number,1,1,2,4,6,8,11,13,16,18,21,23,25,27,29,31,32,33,34,35,35,36,36,36,37,37,37,37,37,37
E01026683,EV motorcycles,Number,0,1,2,3,4,6,8,9,11,13,15,16,18,19,20,22,23,23,24,25,25,25,25,26,26,26,26,26,26,26
E01026684,EV motorcycles,Number,1,2,3,5,7,10,13,16,19,22,25,27,30,33,35,37,38,40,41,42,42,43,43,43,44,44,44,44,44,44
E01026685,EV motorcycles,Number,1,3,5,9,13,18,23,28,34,39,45,50,55,59,63,67,70,72,74,76,77,78,78,79,79,79,80,80,80,80
E01026686,EV motorcycles,Number,1,2,3,5,8,10,13,16,19,23,26,29,31,34,36,38,40,41,43,43,44,45,45,45,46,46,46,46,46,46
E01026687,EV motorcycles,Number,0,1,2,3,4,5,7,9,10,12,13,15,16,18,19,20,21,22,22,23,23,23,23,24,24,24,24,24,24,24
E01026688,EV motorcycles,Number,1,1,2,4,6,8,11,13,16,18,21,23,25,27,29,31,32,33,34,35,35,36,36,36,37,37,37,37,37,37
E01026689,EV motorcycles,Number,0,1,1,2,3,4,6,7,8,10,11,12,14,15,16,17,17,18,18,19,19,19,20,20,20,20,20,20,20,20
E01026690,EV motorcycles,Number,0,1,1,2,4,5,6,8,9,11,12,14,15,16,17,18,19,20,20,21,21,21,22,22,22,22,22,22,22,22
E01026691,EV motorcycles,Number,0,1,2,3,5,7,8,10,12,14,16,18,20,21,23,24,25,26,27,27,28,28,28,29,29,29,29,29,29,29
E01026692,EV motorcycles,Number,1,1,3,4,7,9,11,14,16,19,22,24,27,29,31,32,34,35,36,37,37,38,38,38,39,39,39,39,39,39
E01026693,EV motorcycles,Number,1,2,4,6,9,13,16,20,24,28,31,35,38,41,44,47,49,50,52,53,54,54,55,55,55,56,56,56,56,56
E01026694,EV motorcycles,Number,1,3,6,10,16,21,27,33,40,46,53,59,64,69,74,78,82,85,87,89,90,91,92,93,93,93,94,94,94,94
E01026695,EV motorcycles,Number,1,2,4,7,10,13,17,21,25,30,34,37,41,44,47,50,52,54,55,57,58,58,59,59,59,60,60,60,60,60
E01026696,EV motorcycles,Number,1,1,2,4,6,8,10,12,15,17,20,22,24,26,28,29,30,31,32,33,34,34,34,34,35,35,35,35,35,35
E01026697,EV motorcycles,Number,1,2,3,6,9,12,15,19,22,26,30,33,36,39,42,44,46,48,49,50,51,51,52,52,52,53,53,53,53,53
E01026698,EV motorcycles,Number,0,1,1,2,4,5,6,8,9,11,12,14,15,16,17,18,19,20,20,21,21,21,22,22,22,22,22,22,22,22
E01026699,EV motorcycles,Number,0,1,2,3,4,5,7,9,10,12,13,15,16,18,19,20,21,22,22,23,23,23,23,24,24,24,24,24,24,24
E01026700,EV motorcycles,Number,0,1,1,2,3,4,5,6,7,8,9,10,11,12,13,13,14,14,15,15,15,16,16,16,16,16,16,16,16,16
E01026701,EV motorcycles,Number,1,2,3,5,8,10,13,16,19,23,26,29,31,34,36,38,40,41,43,43,44,45,45,45,46,46,46,46,46,46
E01026702,EV motorcycles,Number,0,1,2,4,6,8,10,12,14,17,19,21,23,25,27,28,30,31,31,32,33,33,33,33,34,34,34,34,34,34
E01026703,EV motorcycles,Number,1,2,3,5,8,11,14,17,20,24,27,30,33,35,38,40,42,43,44,45,46,47,47,47,48,48,48,48,48,48
E01026704,EV motorcycles,Number,1,2,4,6,9,13,16,20,24,28,31,35,38,41,44,47,49,50,52,53,54,54,55,55,55,56,56,56,56,56
E01026705,EV motorcycles,Number,1,2,3,6,9,12,15,19,22,26,30,33,36,39,42,44,46,48,49,50,51,51,52,52,52,53,53,53,53,53
E01026706,EV motorcycles,Number,1,2,3,5,7,10,13,16,19,22,25,27,30,33,35,37,38,40,41,42,42,43,43,43,44,44,44,44,44,44
E01026707,EV motorcycles,Number,1,2,4,6,10,13,17,21,25,29,32,36,40,43,46,48,50,52,54,55,56,56,57,57,57,58,58,58,58,58
E01026708,EV motorcycles,Number,1,2,3,6,9,11,15,18,22,25,29,32,35,38,40,42,44,46,47,48,49,49,50,50,50,51,51,51,51,51
E01026709,EV motorcycles,Number,1,1,3,4,7,9,12,14,17,20,22,25,27,30,32,33,35,36,37,38,38,39,39,39,40,40,40,40,40,40
E01026710,EV motorcycles,Number,0,1,2,3,5,7,8,10,12,14,16,18,20,21,23,24,25,26,27,27,28,28,28,29,29,29,29,29,29,29
E01026711,EV motorcycles,Number,1,1,2,4,6,8,10,12,15,17,20,22,24,26,28,29,30,31,32,33,34,34,34,34,35,35,35,35,35,35
E01026712,EV motorcycles,Number,1,3,5,9,13,18,23,28,33,38,44,49,53,58,61,65,68,70,72,74,75,76,76,77,77,77,78,78,78,78
E01026713,EV motorcycles,Number,1,2,4,7,10,13,17,21,25,30,34,37,41,44,47,50,52,54,55,57,58,58,59,59,59,60,60,60,60,60
E01026714,EV motorcycles,Number,1,2,3,5,8,11,14,17,20,24,27,30,33,35,38,40,42,43,44,45,46,47,47,47,48,48,48,48,48,48
E01026715,EV motorcycles,Number,1,3,5,8,12,17,21,26,31,36,41,46,51,55,58,62,64,67,68,70,71,72,72,73,73,73,74,74,74,74
E01026716,EV motorcycles,Number,1,3,6,9,14,19,25,31,36,42,48,54,59,64,68,72,75,77,79,81,82,83,84,85,85,85,86,86,86,86
E01026717,EV motorcycles,Number,1,4,6,11,16,22,28,34,41,48,54,60,66,72,76,81,84,87,90,92,93,94,95,96,96,96,97,97,97,97
E01026718,EV motorcycles,Number,1,3,5,8,13,17,22,27,32,37,43,47,52,56,60,63,66,68,70,72,73,74,74,75,75,75,76,76,76,76
E01026719,EV motorcycles,Number,2,4,8,13,20,27,34,42,50,59,67,74,81,88,94,99,103,107,110,112,114,115,116,117,118,118,119,119,119,119
E01026720,EV motorcycles,Number,1,2,5,8,12,15,20,25,29,34,39,43,47,51,54,57,60,62,64,65,66,67,68,68,68,69,69,69,69,69
E01026721,EV motorcycles,Number,1,2,3,6,9,12,15,18,22,26,29,32,36,38,41,43,45,47,48,49,50,50,51,51,51,52,52,52,52,52
E01026722,EV motorcycles,Number,2,4,7,12,18,24,31,38,45,52,59,66,72,78,84,88,92,95,98,100,102,103,104,104,105,105,106,106,106,106
E01026723,EV motorcycles,Number,1,2,3,6,9,11,15,18,22,25,29,32,35,38,40,42,44,46,47,48,49,49,50,50,50,51,51,51,51,51
E01026724,EV motorcycles,Number,1,3,5,8,13,17,22,27,32,37,42,47,51,55,59,62,65,67,69,71,72,73,73,74,74,74,75,75,75,75
E01026725,EV motorcycles,Number,1,3,5,9,14,19,24,29,35,41,46,52,57,61,65,69,72,75,77,78,80,81,81,82,82,82,83,83,83,83
E01026726,EV motorcycles,Number,2,4,8,14,21,28,36,44,52,61,69,77,85,92,98,103,108,112,115,117,119,120,121,122,123,123,124,124,124,124
E01026727,EV motorcycles,Number,2,5,9,16,24,33,42,51,61,71,81,90,99,107,114,121,126,130,134,137,139,141,142,143,144,144,145,145,145,145
E01026728,EV motorcycles,Number,1,4,7,11,17,23,30,37,44,51,58,64,70,76,81,86,89,93,95,97,99,100,101,101,102,102,103,103,103,103
E01026729,EV motorcycles,Number,1,3,5,8,12,16,21,25,30,35,40,44,49,52,56,59,62,64,66,67,68,69,70,70,70,71,71,71,71,71
E01026730,EV motorcycles,Number,1,2,4,7,11,15,19,24,28,33,37,42,46,50,53,56,58,60,62,63,64,65,66,66,66,67,67,67,67,67
E01026731,EV motorcycles,Number,1,1,3,4,7,9,12,14,17,20,22,25,27,30,32,33,35,36,37,38,38,39,39,39,40,40,40,40,40,40
E01026732,EV motorcycles,Number,1,3,5,8,13,17,22,27,33,38,43,48,53,57,61,64,67,69,71,73,74,75,75,76,76,76,77,77,77,77
E01026733,EV motorcycles,Number,1,3,6,10,15,21,27,33,39,45,51,57,63,68,73,77,80,83,85,87,88,89,90,91,91,91,92,92,92,92
E01026734,EV motorcycles,Number,0,1,2,3,5,6,8,10,12,14,16,17,19,21,22,23,24,25,26,26,27,27,27,28,28,28,28,28,28,28
E01026735,EV motorcycles,Number,1,2,4,6,9,12,16,19,23,27,30,34,37,40,43,45,47,49,50,51,52,52,53,53,53,54,54,54,54,54
E01026736,EV motorcycles,Number,0,1,2,3,4,6,8,9,11,13,15,16,18,19,20,22,23,23,24,25,25,25,25,26,26,26,26,26,26,26
E01026737,EV motorcycles,Number,1,3,6,10,16,21,27,34,40,47,53,59,65,70,75,79,83,85,88,90,91,92,93,94,94,94,95,95,95,95
E01026738,EV motorcycles,Number,2,4,8,13,19,26,33,41,49,57,64,72,79,85,91,96,100,103,106,109,110,112,113,113,114,114,115,115,115,115
E01026739,EV motorcycles,Number,1,2,3,6,9,11,15,18,22,25,29,32,35,38,40,42,44,46,47,48,49,49,50,50,50,51,51,51,51,51
E01026740,EV motorcycles,Number,2,5,9,15,22,30,39,48,57,66,75,83,92,99,106,111,116,120,124,126,128,130,131,132,133,133,134,134,134,134
E01026741,EV motorcycles,Number,1,2,4,6,9,12,16,20,23,27,31,34,38,41,43,46,48,49,51,52,53,53,54,54,54,55,55,55,55,55
E01026742,EV motorcycles,Number,1,1,2,4,6,9,11,13,16,19,21,24,26,28,30,32,33,34,35,36,36,37,37,37,38,38,38,38,38,38
E01026743,EV motorcycles,Number,1,2,4,7,10,14,18,22,26,30,34,38,42,45,48,51,53,55,56,58,58,59,60,60,60,61,61,61,61,61
E01026744,EV motorcycles,Number,1,3,5,8,12,16,20,25,30,34,39,44,48,52,55,58,61,63,65,66,67,68,69,69,69,70,70,70,70,70
E01026745,EV motorcycles,Number,1,2,3,6,9,12,15,18,22,26,29,32,36,38,41,43,45,47,48,49,50,50,51,51,51,52,52,52,52,52
E01026746,EV motorcycles,Number,1,1,3,5,7,9,12,15,17,20,23,26,28,30,32,34,36,37,38,39,39,40,40,40,41,41,41,41,41,41
E01026747,EV motorcycles,Number,1,1,2,4,6,8,10,13,15,18,20,22,25,27,28,30,31,32,33,34,35,35,35,35,36,36,36,36,36,36
E01026748,EV motorcycles,Number,1,1,3,4,7,9,12,14,17,20,22,25,27,30,32,33,35,36,37,38,38,39,39,39,40,40,40,40,40,40
E01026749,EV motorcycles,Number,1,1,3,4,7,9,11,14,16,19,22,24,27,29,31,32,34,35,36,37,37,38,38,38,39,39,39,39,39,39
E01026750,EV motorcycles,Number,1,2,4,6,10,13,17,21,25,29,32,36,40,43,46,48,50,52,54,55,56,56,57,57,57,58,58,58,58,58
E01026751,EV motorcycles,Number,1,2,3,6,9,12,15,19,22,26,30,33,36,39,42,44,46,48,49,50,51,51,52,52,52,53,53,53,53,53
E01026752,EV motorcycles,Number,1,3,5,9,14,19,24,29,35,41,46,52,57,61,65,69,72,75,77,78,80,81,81,82,82,82,83,83,83,83
E01026753,EV motorcycles,Number,1,2,3,6,9,11,15,18,22,25,29,32,35,38,40,42,44,46,47,48,49,49,50,50,50,51,51,51,51,51
E01026754,EV motorcycles,Number,1,1,2,4,6,8,10,13,15,18,20,22,25,27,28,30,31,32,33,34,35,35,35,35,36,36,36,36,36,36
E01026755,EV motorcycles,Number,1,2,3,5,7,9,12,15,18,21,24,26,29,31,33,35,36,38,39,40,40,41,41,41,42,42,42,42,42,42
E01026756,EV motorcycles,Number,1,1,3,4,7,9,11,14,16,19,22,24,27,29,31,32,34,35,36,37,37,38,38,38,39,39,39,39,39,39
E01026757,EV motorcycles,Number,1,2,4,7,11,14,18,22,27,31,35,39,43,47,50,52,55,57,58,59,60,61,62,62,62,63,63,63,63,63
E01026758,EV motorcycles,Number,1,2,3,5,8,10,13,16,19,23,26,29,31,34,36,38,40,41,43,43,44,45,45,45,46,46,46,46,46,46
E01026759,EV motorcycles,Number,1,2,4,6,9,13,16,20,24,28,31,35,38,41,44,47,49,50,52,53,54,54,55,55,55,56,56,56,56,56
E01026760,EV motorcycles,Number,1,3,5,9,13,18,23,28,33,38,44,49,53,58,61,65,68,70,72,74,75,76,76,77,77,77,78,78,78,78
E01026761,EV motorcycles,Number,1,2,3,5,8,11,14,17,21,24,27,31,33,36,39,41,43,44,45,46,47,48,48,48,48,49,49,49,49,49
E01026762,EV motorcycles,Number,1,3,5,9,13,18,23,28,33,39,44,49,54,58,62,66,69,71,73,75,76,77,77,78,78,78,79,79,79,79
E01026763,EV motorcycles,Number,0,1,2,4,5,7,9,11,14,16,18,20,22,24,25,27,28,29,30,30,31,31,31,32,32,32,32,32,32,32
E01026764,EV motorcycles,Number,0,1,2,3,4,5,7,8,10,11,13,14,16,17,18,19,20,21,21,22,22,22,23,23,23,23,23,23,23,23
E01026765,EV motorcycles,Number,1,2,4,6,9,12,16,19,23,27,30,34,37,40,43,45,47,49,50,51,52,52,53,53,53,54,54,54,54,54
E01026766,EV motorcycles,Number,1,3,6,10,15,20,26,32,38,44,50,56,62,67,71,75,78,81,83,85,86,87,88,89,89,89,90,90,90,90
E01026767,EV motorcycles,Number,1,1,3,4,7,9,12,14,17,20,22,25,27,30,32,33,35,36,37,38,38,39,39,39,40,40,40,40,40,40
E01026768,EV motorcycles,Number,1,2,3,5,7,10,13,16,19,22,25,27,30,33,35,37,38,40,41,42,42,43,43,43,44,44,44,44,44,44
E01026769,EV motorcycles,Number,1,2,4,7,11,15,20,24,29,33,38,42,46,50,54,57,59,61,63,64,65,66,67,67,67,68,68,68,68,68
E01026770,EV motorcycles,Number,0,1,2,4,6,7,10,12,14,16,18,21,23,24,26,27,29,30,31,31,32,32,32,33,33,33,33,33,33,33
E01026771,EV motorcycles,Number,1,2,3,5,8,11,14,17,20,24,27,30,33,35,38,40,42,43,44,45,46,47,47,47,48,48,48,48,48,48
E01026772,EV motorcycles,Number,0,1,2,4,6,8,10,12,14,17,19,21,23,25,27,28,30,31,31,32,33,33,33,33,34,34,34,34,34,34
E01026773,EV motorcycles,Number,1,2,4,7,10,13,17,21,25,30,34,37,41,44,47,50,52,54,55,57,58,58,59,59,59,60,60,60,60,60
E01026774,EV motorcycles,Number,1,2,4,7,11,14,18,22,27,31,35,39,43,47,50,52,55,57,58,59,60,61,62,62,62,63,63,63,63,63
E01026775,EV motorcycles,Number,1,2,3,6,9,12,15,19,22,26,30,33,36,39,42,44,46,48,49,50,51,51,52,52,52,53,53,53,53,53
E01026776,EV motorcycles,Number,1,2,3,5,7,10,13,16,19,22,25,27,30,33,35,37,38,40,41,42,42,43,43,43,44,44,44,44,44,44
E01026777,EV motorcycles,Number,1,1,3,5,7,9,12,15,17,20,23,26,28,30,32,34,36,37,38,39,39,40,40,40,41,41,41,41,41,41
E01026778,EV motorcycles,Number,0,0,1,1,2,3,4,5,5,6,7,8,9,10,10,11,11,12,12,12,12,13,13,13,13,13,13,13,13,13
E01026779,EV motorcycles,Number,0,1,1,2,3,4,5,6,7,8,10,11,12,13,13,14,15,15,16,16,16,16,17,17,17,17,17,17,17,17
E01026780,EV motorcycles,Number,1,3,6,11,16,22,28,34,41,47,54,60,66,71,76,80,83,86,89,91,92,93,94,95,95,95,96,96,96,96
E01026781,EV motorcycles,Number,1,3,5,8,13,17,22,27,33,38,43,48,53,57,61,64,67,69,71,73,74,75,75,76,76,76,77,77,77,77
E01026782,EV motorcycles,Number,1,3,5,9,14,19,24,29,35,41,46,52,57,61,65,69,72,75,77,78,80,81,81,82,82,82,83,83,83,83
E01026783,EV motorcycles,Number,1,3,5,9,14,18,23,29,34,40,45,50,55,60,64,67,70,73,75,76,78,79,79,80,80,80,81,81,81,81
E01026784,EV motorcycles,Number,1,2,3,6,9,12,15,18,22,26,29,32,36,38,41,43,45,47,48,49,50,50,51,51,51,52,52,52,52,52
E01026785,EV motorcycles,Number,1,2,3,5,8,11,14,17,20,24,27,30,33,35,38,40,42,43,44,45,46,47,47,47,48,48,48,48,48,48
E01026786,EV motorcycles,Number,1,3,6,10,15,20,25,31,37,43,49,55,60,65,69,73,76,79,81,83,84,85,86,87,87,87,88,88,88,88
E01026787,EV motorcycles,Number,1,3,5,8,12,16,21,25,30,35,40,44,49,52,56,59,62,64,66,67,68,69,70,70,70,71,71,71,71,71
E01026788,EV motorcycles,Number,1,1,2,4,6,9,11,13,16,19,21,24,26,28,30,32,33,34,35,36,36,37,37,37,38,38,38,38,38,38
E01026789,EV motorcycles,Number,1,3,6,10,15,20,26,32,38,44,50,55,61,66,70,74,77,80,82,84,85,86,87,88,88,88,89,89,89,89
E01026790,EV motorcycles,Number,1,1,3,4,7,9,12,14,17,20,22,25,27,30,32,33,35,36,37,38,38,39,39,39,40,40,40,40,40,40
E01026791,EV motorcycles,Number,0,1,2,3,4,5,7,9,10,12,13,15,16,18,19,20,21,22,22,23,23,23,23,24,24,24,24,24,24,24
E01026792,EV motorcycles,Number,1,2,3,5,7,10,12,15,18,21,24,27,29,32,34,36,37,39,40,41,41,42,42,42,43,43,43,43,43,43
E01026793,EV motorcycles,Number,1,1,2,4,6,8,10,12,15,17,20,22,24,26,28,29,30,31,32,33,34,34,34,34,35,35,35,35,35,35
E01026794,EV motorcycles,Number,1,2,3,5,7,10,12,15,18,21,24,27,29,32,34,36,37,39,40,41,41,42,42,42,43,43,43,43,43,43
E01026796,EV motorcycles,Number,0,1,2,3,5,7,9,11,13,15,17,19,21,23,24,26,27,28,29,29,30,30,30,31,31,31,31,31,31,31
E01026797,EV motorcycles,Number,1,3,6,9,14,19,25,31,36,42,48,54,59,64,68,72,75,77,79,81,82,83,84,85,85,85,86,86,86,86
E01026798,EV motorcycles,Number,1,2,3,5,7,10,13,16,19,22,25,27,30,33,35,37,38,40,41,42,42,43,43,43,44,44,44,44,44,44
E01026799,EV motorcycles,Number,1,2,3,6,9,11,15,18,22,25,29,32,35,38,40,42,44,46,47,48,49,49,50,50,50,51,51,51,51,51
E01026800,EV motorcycles,Number,1,2,3,5,8,11,14,17,21,24,27,31,33,36,39,41,43,44,45,46,47,48,48,48,48,49,49,49,49,49
E01026801,EV motorcycles,Number,1,1,2,4,6,8,10,12,15,17,20,22,24,26,28,29,30,31,32,33,34,34,34,34,35,35,35,35,35,35
E01026802,EV motorcycles,Number,1,1,2,4,6,9,11,13,16,19,21,24,26,28,30,32,33,34,35,36,36,37,37,37,38,38,38,38,38,38
E01026803,EV motorcycles,Number,1,2,3,5,7,10,12,15,18,21,24,27,29,32,34,36,37,39,40,41,41,42,42,42,43,43,43,43,43,43
E01026804,EV motorcycles,Number,1,3,5,9,14,19,24,29,35,41,46,52,57,61,65,69,72,75,77,78,80,81,81,82,82,82,83,83,83,83
E01026805,EV motorcycles,Number,1,1,3,5,7,9,12,15,17,20,23,26,28,30,32,34,36,37,38,39,39,40,40,40,41,41,41,41,41,41
E01026806,EV motorcycles,Number,1,2,4,6,9,12,16,19,23,27,30,34,37,40,43,45,47,49,50,51,52,52,53,53,53,54,54,54,54,54
E01026807,EV motorcycles,Number,0,1,2,3,5,6,8,10,11,13,15,17,18,20,21,22,23,24,25,25,26,26,26,27,27,27,27,27,27,27
E01026808,EV motorcycles,Number,0,1,2,3,5,6,8,10,11,13,15,17,18,20,21,22,23,24,25,25,26,26,26,27,27,27,27,27,27,27
E01026809,EV motorcycles,Number,1,1,2,4,6,8,11,13,16,18,21,23,25,27,29,31,32,33,34,35,35,36,36,36,37,37,37,37,37,37
E01026810,EV motorcycles,Number,1,1,2,4,6,8,10,13,15,18,20,22,25,27,28,30,31,32,33,34,35,35,35,35,36,36,36,36,36,36
E01026811,EV motorcycles,Number,0,1,2,4,5,7,9,11,14,16,18,20,22,24,25,27,28,29,30,30,31,31,31,32,32,32,32,32,32,32
E01026812,EV motorcycles,Number,0,1,2,3,5,6,8,10,11,13,15,17,18,20,21,22,23,24,25,25,26,26,26,27,27,27,27,27,27,27
E01026813,EV motorcycles,Number,0,1,2,3,5,6,8,10,12,14,16,17,19,21,22,23,24,25,26,26,27,27,27,28,28,28,28,28,28,28
E01026814,EV motorcycles,Number,0,1,2,3,5,7,8,10,12,14,16,18,20,21,23,24,25,26,27,27,28,28,28,29,29,29,29,29,29,29
E01026815,EV motorcycles,Number,0,1,2,3,5,6,8,10,12,14,16,17,19,21,22,23,24,25,26,26,27,27,27,28,28,28,28,28,28,28
E01026816,EV motorcycles,Number,0,1,2,4,6,8,10,12,14,17,19,21,23,25,27,28,30,31,31,32,33,33,33,33,34,34,34,34,34,34
E01026817,EV motorcycles,Number,1,1,2,4,6,8,10,12,15,17,20,22,24,26,28,29,30,31,32,33,34,34,34,34,35,35,35,35,35,35
E01026818,EV motorcycles,Number,1,2,3,6,8,11,14,18,21,25,28,31,34,37,39,42,43,45,46,47,48,49,49,49,49,50,50,50,50,50
E01026819,EV motorcycles,Number,0,1,2,3,4,5,7,8,10,11,13,14,16,17,18,19,20,21,21,22,22,22,23,23,23,23,23,23,23,23
E01026820,EV motorcycles,Number,1,1,2,4,6,9,11,13,16,19,21,24,26,28,30,32,33,34,35,36,36,37,37,37,38,38,38,38,38,38
E01026821,EV motorcycles,Number,1,2,3,5,8,11,14,17,21,24,27,31,33,36,39,41,43,44,45,46,47,48,48,48,48,49,49,49,49,49
E01026822,EV motorcycles,Number,1,2,4,7,11,14,18,22,27,31,35,39,43,47,50,52,55,57,58,59,60,61,62,62,62,63,63,63,63,63
E01026823,EV motorcycles,Number,1,1,2,4,6,8,11,13,16,18,21,23,25,27,29,31,32,33,34,35,35,36,36,36,37,37,37,37,37,37
E01026824,EV motorcycles,Number,0,1,2,4,6,7,10,12,14,16,18,21,23,24,26,27,29,30,31,31,32,32,32,33,33,33,33,33,33,33
E01026825,EV motorcycles,Number,1,3,5,9,14,18,24,29,35,40,46,51,56,61,65,68,71,74,76,77,79,80,80,81,81,81,82,82,82,82
E01026826,EV motorcycles,Number,0,1,2,3,4,6,7,9,11,12,14,16,17,18,20,21,22,22,23,24,24,24,24,25,25,25,25,25,25,25
E01026827,EV motorcycles,Number,1,1,2,4,6,9,11,13,16,19,21,24,26,28,30,32,33,34,35,36,36,37,37,37,38,38,38,38,38,38
E01026828,EV motorcycles,Number,1,2,3,5,8,11,14,17,21,24,27,31,33,36,39,41,43,44,45,46,47,48,48,48,48,49,49,49,49,49
E01026829,EV motorcycles,Number,1,2,4,7,11,15,20,24,29,33,38,42,46,50,54,57,59,61,63,64,65,66,67,67,67,68,68,68,68,68
E01026830,EV motorcycles,Number,0,1,1,2,3,4,5,6,8,9,10,11,12,13,14,15,16,16,17,17,17,17,18,18,18,18,18,18,18,18
E01026831,EV motorcycles,Number,0,1,1,2,3,4,6,7,8,10,11,12,14,15,16,17,17,18,18,19,19,19,20,20,20,20,20,20,20,20
E01026832,EV motorcycles,Number,1,1,2,4,6,8,11,13,16,18,21,23,25,27,29,31,32,33,34,35,35,36,36,36,37,37,37,37,37,37
E01026833,EV motorcycles,Number,0,1,2,3,4,6,7,9,11,12,14,16,17,18,20,21,22,22,23,24,24,24,24,25,25,25,25,25,25,25
E01026834,EV motorcycles,Number,1,2,3,6,8,11,14,18,21,25,28,31,34,37,39,42,43,45,46,47,48,49,49,49,49,50,50,50,50,50
E01026835,EV motorcycles,Number,0,1,2,3,5,7,8,10,12,14,16,18,20,21,23,24,25,26,27,27,28,28,28,29,29,29,29,29,29,29
E01026836,EV motorcycles,Number,0,1,1,2,3,4,5,6,8,9,10,11,12,13,14,15,16,16,17,17,17,17,18,18,18,18,18,18,18,18
E01026837,EV motorcycles,Number,0,1,2,3,4,5,7,9,10,12,13,15,16,18,19,20,21,22,22,23,23,23,23,24,24,24,24,24,24,24
E01026838,EV motorcycles,Number,0,0,1,1,2,3,4,5,5,6,7,8,9,10,10,11,11,12,12,12,12,13,13,13,13,13,13,13,13,13
E01026839,EV motorcycles,Number,0,0,1,1,2,3,3,4,5,6,7,7,8,9,9,10,10,11,11,11,12,12,12,12,12,12,12,12,12,12
E01026840,EV motorcycles,Number,0,1,1,2,3,4,5,6,7,8,10,11,12,13,13,14,15,15,16,16,16,16,17,17,17,17,17,17,17,17
E01026841,EV motorcycles,Number,0,1,2,3,5,7,8,10,12,14,16,18,20,21,23,24,25,26,27,27,28,28,28,29,29,29,29,29,29,29
E01026842,EV motorcycles,Number,1,2,3,5,8,10,13,16,19,23,26,29,31,34,36,38,40,41,43,43,44,45,45,45,46,46,46,46,46,46
E01026843,EV motorcycles,Number,1,1,2,4,6,8,10,13,15,18,20,22,25,27,28,30,31,32,33,34,35,35,35,35,36,36,36,36,36,36
E01026844,EV motorcycles,Number,1,1,3,4,7,9,12,14,17,20,22,25,27,30,32,33,35,36,37,38,38,39,39,39,40,40,40,40,40,40
E01026845,EV motorcycles,Number,0,1,2,3,4,6,8,9,11,13,15,16,18,19,20,22,23,23,24,25,25,25,25,26,26,26,26,26,26,26
E01026846,EV motorcycles,Number,0,1,2,3,4,6,7,9,11,12,14,16,17,18,20,21,22,22,23,24,24,24,24,25,25,25,25,25,25,25
E01026848,EV motorcycles,Number,1,1,3,5,7,9,12,15,17,20,23,26,28,30,32,34,36,37,38,39,39,40,40,40,41,41,41,41,41,41
E01026849,EV motorcycles,Number,1,1,2,4,6,8,10,12,15,17,20,22,24,26,28,29,30,31,32,33,34,34,34,34,35,35,35,35,35,35
E01026850,EV motorcycles,Number,1,1,3,4,7,9,11,14,16,19,22,24,27,29,31,32,34,35,36,37,37,38,38,38,39,39,39,39,39,39
E01026852,EV motorcycles,Number,0,1,1,2,3,4,5,6,7,8,10,11,12,13,13,14,15,15,16,16,16,16,17,17,17,17,17,17,17,17
E01026853,EV motorcycles,Number,1,1,2,4,6,8,11,13,16,18,21,23,25,27,29,31,32,33,34,35,35,36,36,36,37,37,37,37,37,37
E01026855,EV motorcycles,Number,0,1,2,3,4,5,7,9,10,12,13,15,16,18,19,20,21,22,22,23,23,23,23,24,24,24,24,24,24,24
E01026856,EV motorcycles,Number,1,1,3,5,7,9,12,15,17,20,23,26,28,30,32,34,36,37,38,39,39,40,40,40,41,41,41,41,41,41
E01026857,EV motorcycles,Number,0,1,1,2,3,4,6,7,8,10,11,12,14,15,16,17,17,18,18,19,19,19,20,20,20,20,20,20,20,20
E01026858,EV motorcycles,Number,0,1,1,2,4,5,6,7,9,10,12,13,14,16,17,17,18,19,19,20,20,20,21,21,21,21,21,21,21,21
E01026859,EV motorcycles,Number,0,1,2,4,5,7,9,11,14,16,18,20,22,24,25,27,28,29,30,30,31,31,31,32,32,32,32,32,32,32
E01026860,EV motorcycles,Number,0,1,1,2,4,5,6,7,9,10,12,13,14,16,17,17,18,19,19,20,20,20,21,21,21,21,21,21,21,21
E01026861,EV motorcycles,Number,0,1,2,3,4,5,7,8,10,11,13,14,16,17,18,19,20,21,21,22,22,22,23,23,23,23,23,23,23,23
E01026862,EV motorcycles,Number,0,0,1,1,2,2,3,4,5,5,6,7,8,8,9,9,10,10,10,10,11,11,11,11,11,11,11,11,11,11
E01026863,EV motorcycles,Number,1,2,3,5,8,10,13,16,19,23,26,29,31,34,36,38,40,41,43,43,44,45,45,45,46,46,46,46,46,46
E01026864,EV motorcycles,Number,1,2,3,5,8,11,14,17,21,24,27,31,33,36,39,41,43,44,45,46,47,48,48,48,48,49,49,49,49,49
E01026865,EV motorcycles,Number,1,2,3,6,8,11,14,18,21,25,28,31,34,37,39,42,43,45,46,47,48,49,49,49,49,50,50,50,50,50
E01026866,EV motorcycles,Number,1,2,3,5,8,10,13,16,19,23,26,29,31,34,36,38,40,41,43,43,44,45,45,45,46,46,46,46,46,46
E01026867,EV motorcycles,Number,1,1,3,5,7,9,12,15,17,20,23,26,28,30,32,34,36,37,38,39,39,40,40,40,41,41,41,41,41,41
E01026868,EV motorcycles,Number,1,1,3,4,7,9,12,14,17,20,22,25,27,30,32,33,35,36,37,38,38,39,39,39,40,40,40,40,40,40
E01026869,EV motorcycles,Number,1,1,3,4,7,9,12,14,17,20,22,25,27,30,32,33,35,36,37,38,38,39,39,39,40,40,40,40,40,40
E01026870,EV motorcycles,Number,0,1,2,3,5,7,9,11,13,15,17,19,21,23,24,26,27,28,29,29,30,30,30,31,31,31,31,31,31,31
E01026871,EV motorcycles,Number,1,2,3,5,8,11,14,17,20,24,27,30,33,35,38,40,42,43,44,45,46,47,47,47,48,48,48,48,48,48
E01026872,EV motorcycles,Number,1,3,5,9,14,19,24,30,36,41,47,52,57,62,66,70,73,76,78,79,81,82,82,83,83,83,84,84,84,84
E01026873,EV motorcycles,Number,1,2,4,6,9,12,16,20,23,27,31,34,38,41,43,46,48,49,51,52,53,53,54,54,54,55,55,55,55,55
E01026874,EV motorcycles,Number,1,3,5,8,13,17,22,27,32,37,42,47,51,55,59,62,65,67,69,71,72,73,73,74,74,74,75,75,75,75
E01026875,EV motorcycles,Number,1,1,2,4,6,8,10,12,15,17,20,22,24,26,28,29,30,31,32,33,34,34,34,34,35,35,35,35,35,35
E01026876,EV motorcycles,Number,1,2,3,6,8,11,14,18,21,25,28,31,34,37,39,42,43,45,46,47,48,49,49,49,49,50,50,50,50,50
E01026877,EV motorcycles,Number,1,3,6,9,14,19,25,31,36,42,48,54,59,64,68,72,75,77,79,81,82,83,84,85,85,85,86,86,86,86
E01026878,EV motorcycles,Number,1,2,3,6,8,11,14,18,21,25,28,31,34,37,39,42,43,45,46,47,48,49,49,49,49,50,50,50,50,50
E01026879,EV motorcycles,Number,1,1,3,4,7,9,12,14,17,20,22,25,27,30,32,33,35,36,37,38,38,39,39,39,40,40,40,40,40,40
E01026880,EV motorcycles,Number,1,1,2,4,6,8,10,13,15,18,20,22,25,27,28,30,31,32,33,34,35,35,35,35,36,36,36,36,36,36
E01026881,EV motorcycles,Number,1,2,3,6,9,11,15,18,22,25,29,32,35,38,40,42,44,46,47,48,49,49,50,50,50,51,51,51,51,51
E01026882,EV motorcycles,Number,1,2,3,6,9,11,15,18,22,25,29,32,35,38,40,42,44,46,47,48,49,49,50,50,50,51,51,51,51,51
E01026883,EV motorcycles,Number,1,3,5,8,12,16,21,25,30,35,40,44,49,52,56,59,62,64,66,67,68,69,70,70,70,71,71,71,71,71
E01026884,EV motorcycles,Number,1,4,7,11,17,23,29,36,43,50,57,63,69,75,80,84,88,91,93,95,97,98,99,100,100,100,101,101,101,101
E01026885,EV motorcycles,Number,1,4,6,11,16,22,28,35,41,48,55,61,67,72,77,82,85,88,91,93,94,95,96,97,97,97,98,98,98,98
E01026886,EV motorcycles,Number,1,2,3,6,9,12,15,18,22,26,29,32,36,38,41,43,45,47,48,49,50,50,51,51,51,52,52,52,52,52
E01026887,EV motorcycles,Number,1,2,4,7,11,15,19,24,28,33,37,42,46,50,53,56,58,60,62,63,64,65,66,66,66,67,67,67,67,67
E01026888,EV motorcycles,Number,0,1,2,4,6,8,10,12,14,17,19,21,23,25,27,28,30,31,31,32,33,33,33,33,34,34,34,34,34,34
E01026889,EV motorcycles,Number,1,1,3,5,7,9,12,15,17,20,23,26,28,30,32,34,36,37,38,39,39,40,40,40,41,41,41,41,41,41
E01026891,EV motorcycles,Number,1,1,3,5,7,9,12,15,17,20,23,26,28,30,32,34,36,37,38,39,39,40,40,40,41,41,41,41,41,41
E01026892,EV motorcycles,Number,1,2,5,8,12,15,20,25,29,34,39,43,47,51,54,57,60,62,64,65,66,67,68,68,68,69,69,69,69,69
E01026893,EV motorcycles,Number,1,2,4,6,9,12,16,19,23,27,30,34,37,40,43,45,47,49,50,51,52,52,53,53,53,54,54,54,54,54
E01026894,EV motorcycles,Number,2,4,8,13,20,26,34,42,50,58,66,73,81,87,93,98,103,106,109,111,113,114,116,116,117,117,118,118,118,118
E01026895,EV motorcycles,Number,1,2,3,5,7,9,12,15,18,21,24,26,29,31,33,35,36,38,39,40,40,41,41,41,42,42,42,42,42,42
E01026896,EV motorcycles,Number,1,2,3,5,8,11,14,17,20,23,26,29,32,35,37,39,41,42,43,44,45,46,46,46,47,47,47,47,47,47
E01026897,EV motorcycles,Number,2,4,8,13,20,27,35,43,51,59,67,75,82,89,95,100,104,108,111,113,115,116,117,118,119,119,120,120,120,120
E01026898,EV motorcycles,Number,1,3,6,10,15,20,25,31,37,43,49,55,60,65,69,73,76,79,81,83,84,85,86,87,87,87,88,88,88,88
E01026899,EV motorcycles,Number,1,2,3,6,9,12,15,18,22,26,29,32,36,38,41,43,45,47,48,49,50,50,51,51,51,52,52,52,52,52
E01026900,EV motorcycles,Number,1,2,4,6,9,13,16,20,24,28,31,35,38,41,44,47,49,50,52,53,54,54,55,55,55,56,56,56,56,56
E01026901,EV motorcycles,Number,1,1,3,4,7,9,12,14,17,20,22,25,27,30,32,33,35,36,37,38,38,39,39,39,40,40,40,40,40,40
E01026902,EV motorcycles,Number,1,3,5,8,13,17,22,27,32,37,42,47,51,55,59,62,65,67,69,71,72,73,73,74,74,74,75,75,75,75
E01026903,EV motorcycles,Number,1,3,5,8,12,16,21,26,30,35,40,45,49,53,57,60,63,65,67,68,69,70,70,71,71,71,72,72,72,72
E01026904,EV motorcycles,Number,1,2,4,6,10,13,17,21,25,29,32,36,40,43,46,48,50,52,54,55,56,56,57,57,57,58,58,58,58,58
E01026905,EV motorcycles,Number,1,1,2,4,6,8,10,13,15,18,20,22,25,27,28,30,31,32,33,34,35,35,35,35,36,36,36,36,36,36
E01026906,EV motorcycles,Number,1,2,3,5,8,11,14,17,20,23,26,29,32,35,37,39,41,42,43,44,45,46,46,46,47,47,47,47,47,47
E01026907,EV motorcycles,Number,1,2,3,5,7,10,13,16,19,22,25,27,30,33,35,37,38,40,41,42,42,43,43,43,44,44,44,44,44,44
E01026908,EV motorcycles,Number,1,2,3,5,7,10,12,15,18,21,24,27,29,32,34,36,37,39,40,41,41,42,42,42,43,43,43,43,43,43
E01026909,EV motorcycles,Number,1,1,3,5,7,9,12,15,17,20,23,26,28,30,32,34,36,37,38,39,39,40,40,40,41,41,41,41,41,41
E01026910,EV motorcycles,Number,1,2,4,7,10,14,18,22,26,30,35,39,42,46,49,52,54,56,57,59,59,60,61,61,61,62,62,62,62,62
E01026911,EV motorcycles,Number,1,1,3,4,7,9,11,14,16,19,22,24,27,29,31,32,34,35,36,37,37,38,38,38,39,39,39,39,39,39
E01026912,EV motorcycles,Number,1,2,3,6,9,12,15,18,22,26,29,32,36,38,41,43,45,47,48,49,50,50,51,51,51,52,52,52,52,52
E01026913,EV motorcycles,Number,1,2,3,5,8,11,14,17,20,24,27,30,33,35,38,40,42,43,44,45,46,47,47,47,48,48,48,48,48,48
E01026914,EV motorcycles,Number,1,2,4,7,10,13,17,21,25,29,33,37,40,44,47,49,51,53,55,56,57,57,58,58,58,59,59,59,59,59
E01026915,EV motorcycles,Number,1,2,4,7,11,15,19,24,28,33,37,42,46,50,53,56,58,60,62,63,64,65,66,66,66,67,67,67,67,67
E01026916,EV motorcycles,Number,1,3,5,9,14,18,24,29,35,40,46,51,56,61,65,68,71,74,76,77,79,80,80,81,81,81,82,82,82,82
E01026917,EV motorcycles,Number,1,1,3,4,7,9,11,14,16,19,22,24,27,29,31,32,34,35,36,37,37,38,38,38,39,39,39,39,39,39
E01026918,EV motorcycles,Number,1,2,4,7,10,14,18,22,26,30,34,38,42,45,48,51,53,55,56,58,58,59,60,60,60,61,61,61,61,61
E01026919,EV motorcycles,Number,1,2,4,6,10,13,17,21,25,29,32,36,40,43,46,48,50,52,54,55,56,56,57,57,57,58,58,58,58,58
E01026920,EV motorcycles,Number,1,1,2,4,6,9,11,13,16,19,21,24,26,28,30,32,33,34,35,36,36,37,37,37,38,38,38,38,38,38
E01026921,EV motorcycles,Number,1,2,4,6,9,13,16,20,24,28,31,35,38,41,44,47,49,50,52,53,54,54,55,55,55,56,56,56,56,56
E01026922,EV motorcycles,Number,0,1,2,3,5,7,9,11,13,15,17,19,21,22,24,25,26,27,28,28,29,29,29,30,30,30,30,30,30,30
E01026924,EV motorcycles,Number,1,2,3,5,7,9,12,15,18,21,24,26,29,31,33,35,36,38,39,40,40,41,41,41,42,42,42,42,42,42
E01026925,EV motorcycles,Number,1,2,4,7,10,13,17,21,25,29,33,37,40,44,47,49,51,53,55,56,57,57,58,58,58,59,59,59,59,59
E01026926,EV motorcycles,Number,1,3,5,8,12,16,21,26,30,35,40,45,49,53,57,60,63,65,67,68,69,70,70,71,71,71,72,72,72,72
E01026927,EV motorcycles,Number,1,3,5,8,13,17,22,27,33,38,43,48,53,57,61,64,67,69,71,73,74,75,75,76,76,76,77,77,77,77
E01026928,EV motorcycles,Number,1,2,3,6,9,11,15,18,22,25,29,32,35,38,40,42,44,46,47,48,49,49,50,50,50,51,51,51,51,51
E01026929,EV motorcycles,Number,1,2,3,6,9,12,15,18,22,26,29,32,36,38,41,43,45,47,48,49,50,50,51,51,51,52,52,52,52,52
E01026930,EV motorcycles,Number,1,2,4,6,10,13,17,21,25,29,32,36,40,43,46,48,50,52,54,55,56,56,57,57,57,58,58,58,58,58
E01026931,EV motorcycles,Number,1,2,3,5,8,10,13,16,19,23,26,29,31,34,36,38,40,41,43,43,44,45,45,45,46,46,46,46,46,46
E01026932,EV motorcycles,Number,1,2,3,6,8,11,14,18,21,25,28,31,34,37,39,42,43,45,46,47,48,49,49,49,49,50,50,50,50,50
E01026933,EV motorcycles,Number,2,5,9,15,22,30,39,48,57,66,75,83,92,99,106,111,116,120,124,126,128,130,131,132,133,133,134,134,134,134
E01026934,EV motorcycles,Number,1,2,3,5,8,10,13,16,19,23,26,29,31,34,36,38,40,41,43,43,44,45,45,45,46,46,46,46,46,46
E01026935,EV motorcycles,Number,1,2,4,7,10,13,17,21,25,29,33,37,40,44,47,49,51,53,55,56,57,57,58,58,58,59,59,59,59,59
E01026936,EV motorcycles,Number,1,2,3,5,8,11,14,17,21,24,27,31,33,36,39,41,43,44,45,46,47,48,48,48,48,49,49,49,49,49
E01026937,EV motorcycles,Number,1,1,2,4,6,9,11,13,16,19,21,24,26,28,30,32,33,34,35,36,36,37,37,37,38,38,38,38,38,38
E01026938,EV motorcycles,Number,1,3,5,9,14,18,24,29,35,40,46,51,56,61,65,68,71,74,76,77,79,80,80,81,81,81,82,82,82,82
E01026939,EV motorcycles,Number,1,2,4,6,9,13,16,20,24,28,31,35,38,41,44,47,49,50,52,53,54,54,55,55,55,56,56,56,56,56
E01026940,EV motorcycles,Number,1,3,5,9,13,18,23,28,33,39,44,49,54,58,62,66,69,71,73,75,76,77,77,78,78,78,79,79,79,79
E01026941,EV motorcycles,Number,0,1,2,3,5,7,9,11,13,15,17,19,21,22,24,25,26,27,28,28,29,29,29,30,30,30,30,30,30,30
E01026942,EV motorcycles,Number,1,1,3,4,7,9,12,14,17,20,22,25,27,30,32,33,35,36,37,38,38,39,39,39,40,40,40,40,40,40
E01026943,EV motorcycles,Number,2,4,7,12,18,24,31,38,46,53,60,67,74,80,85,90,94,97,100,102,104,105,106,106,107,107,108,108,108,108
E01026944,EV motorcycles,Number,1,2,4,6,10,13,17,21,25,29,32,36,40,43,46,48,50,52,54,55,56,56,57,57,57,58,58,58,58,58
E01026945,EV motorcycles,Number,1,3,5,9,13,18,23,28,33,38,44,49,53,58,61,65,68,70,72,74,75,76,76,77,77,77,78,78,78,78
E01026946,EV motorcycles,Number,0,1,1,2,4,5,6,8,9,11,12,14,15,16,17,18,19,20,20,21,21,21,22,22,22,22,22,22,22,22
E01026947,EV motorcycles,Number,1,1,3,4,7,9,11,14,16,19,22,24,27,29,31,32,34,35,36,37,37,38,38,38,39,39,39,39,39,39
E01026948,EV motorcycles,Number,1,2,4,7,10,14,18,22,26,30,34,38,42,45,48,51,53,55,56,58,58,59,60,60,60,61,61,61,61,61
E01027044,EV motorcycles,Number,0,0,0,0,0,0,0,0,0,0,0,0,0,0,0,0,0,0,0,0,0,0,0,0,0,0,0,0,0,0
E01028500,EV motorcycles,Number,0,0,0,0,0,0,0,0,0,0,0,0,1,1,1,1,1,1,1,1,1,1,1,1,1,1,1,1,1,1
E01028598,EV motorcycles,Number,0,1,2,3,5,7,9,11,13,15,17,19,21,23,24,25,27,27,28,29,29,30,30,30,30,30,31,31,31,31
E01028613,EV motorcycles,Number,1,1,2,4,6,8,10,12,15,17,20,22,24,26,28,29,30,31,32,33,34,34,34,34,35,35,35,35,35,35
E01028614,EV motorcycles,Number,1,2,4,7,11,14,19,23,27,31,36,40,44,47,50,53,56,58,59,60,61,62,63,63,63,64,64,64,64,64
E01028615,EV motorcycles,Number,1,2,4,6,9,12,16,19,23,27,30,34,37,40,43,45,47,49,50,51,52,53,53,53,54,54,54,54,54,54
E01028616,EV motorcycles,Number,1,2,3,6,9,12,15,18,22,26,29,32,36,38,41,43,45,47,48,49,50,50,51,51,51,52,52,52,52,52
E01028647,EV motorcycles,Number,0,0,0,0,0,1,1,1,1,1,2,2,2,2,2,2,2,3,3,3,3,3,3,3,3,3,3,3,3,3
E01028666,EV motorcycles,Number,1,1,3,4,7,9,12,14,17,20,22,25,27,30,32,33,35,36,37,38,38,39,39,39,40,40,40,40,40,40
E01028667,EV motorcycles,Number,0,1,2,3,5,6,8,10,12,14,16,17,19,21,22,23,24,25,26,26,27,27,27,28,28,28,28,28,28,28
E01028668,EV motorcycles,Number,0,1,2,4,6,7,10,12,14,16,18,21,23,24,26,27,29,30,31,31,32,32,32,33,33,33,33,33,33,33
E01028669,EV motorcycles,Number,0,1,2,3,5,7,9,11,13,15,17,19,21,23,24,26,27,28,29,29,30,30,30,31,31,31,31,31,31,31
E01028670,EV motorcycles,Number,1,1,3,5,7,9,12,15,17,20,23,26,28,30,32,34,36,37,38,39,39,40,40,40,41,41,41,41,41,41
E01028671,EV motorcycles,Number,0,1,1,2,3,4,6,7,8,10,11,12,14,15,16,17,17,18,18,19,19,19,20,20,20,20,20,20,20,20
E01028672,EV motorcycles,Number,1,3,5,8,12,16,20,25,30,34,39,44,48,52,55,58,61,63,65,66,67,68,69,69,69,70,70,70,70,70
E01028673,EV motorcycles,Number,1,2,3,5,8,11,14,17,20,23,26,29,32,35,37,39,41,42,43,44,45,46,46,46,47,47,47,47,47,47
E01029870,EV motorcycles,Number,1,2,3,5,7,9,12,15,18,21,24,26,29,31,33,35,36,38,39,40,40,41,41,41,42,42,42,42,42,42
E01029871,EV motorcycles,Number,1,2,4,7,10,14,18,22,26,30,35,39,42,46,49,52,54,56,57,59,59,60,61,61,61,62,62,62,62,62
E01029872,EV motorcycles,Number,1,2,3,6,9,11,15,18,22,25,29,32,35,38,40,42,44,46,47,48,49,49,50,50,50,51,51,51,51,51
E01029873,EV motorcycles,Number,1,3,6,10,16,21,27,33,39,46,52,58,64,69,73,77,81,84,86,88,89,90,91,92,92,92,93,93,93,93
E01029874,EV motorcycles,Number,1,2,4,7,11,14,18,22,27,31,35,39,43,47,50,52,55,57,58,59,60,61,62,62,62,63,63,63,63,63
E01029875,EV motorcycles,Number,1,4,6,11,16,22,28,34,41,48,54,60,66,72,76,81,84,87,90,92,93,94,95,96,96,96,97,97,97,97
E01029876,EV motorcycles,Number,1,3,5,9,13,18,23,28,34,39,45,50,55,59,63,67,70,72,74,76,77,78,78,79,79,79,80,80,80,80
E01029877,EV motorcycles,Number,1,2,4,7,11,14,19,23,27,31,36,40,44,47,50,53,56,58,59,60,61,62,63,63,63,64,64,64,64,64
E01029878,EV motorcycles,Number,1,1,3,4,7,9,11,14,16,19,22,24,27,29,31,32,34,35,36,37,37,38,38,38,39,39,39,39,39,39
E01029879,EV motorcycles,Number,1,3,6,10,15,21,27,33,39,45,51,57,63,68,73,77,80,83,85,87,88,89,90,91,91,91,92,92,92,92
E01029880,EV motorcycles,Number,1,3,6,10,16,21,27,34,40,47,53,59,65,70,75,79,83,85,88,90,91,92,93,94,94,94,95,95,95,95
E01029881,EV motorcycles,Number,1,4,7,11,17,22,29,36,42,49,56,62,68,74,79,83,87,90,92,94,96,97,98,99,99,99,100,100,100,100
E01029882,EV motorcycles,Number,1,2,3,5,7,9,12,15,18,21,24,26,29,31,33,35,36,38,39,40,40,41,41,41,42,42,42,42,42,42
E01029883,EV motorcycles,Number,1,3,5,8,12,16,20,25,30,34,39,44,48,52,55,58,61,63,65,66,67,68,69,69,69,70,70,70,70,70
E01029884,EV motorcycles,Number,1,3,5,8,13,17,22,27,32,37,42,47,51,55,59,62,65,67,69,71,72,73,73,74,74,74,75,75,75,75
E01029885,EV motorcycles,Number,2,4,7,12,18,24,31,38,46,53,60,67,74,80,85,90,94,97,100,102,104,105,106,106,107,107,108,108,108,108
E01029886,EV motorcycles,Number,1,2,3,5,7,10,13,16,19,22,25,27,30,33,35,37,38,40,41,42,42,43,43,43,44,44,44,44,44,44
E01029887,EV motorcycles,Number,1,2,4,6,9,12,16,19,23,27,30,34,37,40,43,45,47,49,50,51,52,52,53,53,53,54,54,54,54,54
E01029888,EV motorcycles,Number,1,2,4,6,9,13,16,20,24,28,31,35,38,41,44,47,49,50,52,53,54,54,55,55,55,56,56,56,56,56
E01029889,EV motorcycles,Number,1,1,3,4,7,9,11,14,16,19,22,24,27,29,31,32,34,35,36,37,37,38,38,38,39,39,39,39,39,39
E01029890,EV motorcycles,Number,1,2,4,7,10,14,18,22,26,30,35,39,42,46,49,52,54,56,57,59,59,60,61,61,61,62,62,62,62,62
E01029891,EV motorcycles,Number,1,3,5,9,14,18,24,29,35,40,46,51,56,61,65,68,71,74,76,77,79,80,80,81,81,81,82,82,82,82
E01029892,EV motorcycles,Number,1,1,2,4,6,8,10,12,15,17,20,22,24,26,28,29,30,31,32,33,34,34,34,34,35,35,35,35,35,35
E01029893,EV motorcycles,Number,1,3,5,9,13,18,23,28,33,39,44,49,54,58,62,66,69,71,73,75,76,77,77,78,78,78,79,79,79,79
E01029894,EV motorcycles,Number,0,1,1,2,3,4,5,7,8,9,11,12,13,14,15,16,17,17,18,18,18,18,19,19,19,19,19,19,19,19
E01029895,EV motorcycles,Number,0,1,1,2,3,4,5,6,7,8,10,11,12,13,13,14,15,15,16,16,16,16,17,17,17,17,17,17,17,17
E01029896,EV motorcycles,Number,0,1,1,2,3,4,5,6,7,8,10,11,12,13,13,14,15,15,16,16,16,16,17,17,17,17,17,17,17,17
E01029897,EV motorcycles,Number,1,2,4,7,11,14,19,23,27,31,36,40,44,47,50,53,56,58,59,60,61,62,63,63,63,64,64,64,64,64
E01029898,EV motorcycles,Number,1,2,3,5,7,10,13,16,19,22,25,27,30,33,35,37,38,40,41,42,42,43,43,43,44,44,44,44,44,44
E01029899,EV motorcycles,Number,1,2,4,6,9,12,16,20,23,27,31,34,38,41,43,46,48,49,51,52,53,53,54,54,54,55,55,55,55,55
E01029900,EV motorcycles,Number,1,2,3,5,8,10,13,16,19,23,26,29,31,34,36,38,40,41,43,43,44,45,45,45,46,46,46,46,46,46
E01029901,EV motorcycles,Number,1,2,4,6,10,13,17,21,25,29,32,36,40,43,46,48,50,52,54,55,56,56,57,57,57,58,58,58,58,58
E01029902,EV motorcycles,Number,1,3,6,10,16,21,27,33,40,46,53,59,64,69,74,78,82,85,87,89,90,91,92,93,93,93,94,94,94,94
E01029903,EV motorcycles,Number,1,1,3,5,7,9,12,15,17,20,23,26,28,30,32,34,36,37,38,39,39,40,40,40,41,41,41,41,41,41
E01029904,EV motorcycles,Number,1,2,4,6,10,13,16,20,24,28,32,35,39,42,45,47,50,51,53,54,55,55,56,56,56,57,57,57,57,57
E01029905,EV motorcycles,Number,1,2,3,5,8,11,14,17,21,24,27,31,33,36,39,41,43,44,45,46,47,48,48,48,48,49,49,49,49,49
E01029906,EV motorcycles,Number,1,2,3,5,8,11,14,17,21,24,27,31,33,36,39,41,43,44,45,46,47,48,48,48,48,49,49,49,49,49
E01029907,EV motorcycles,Number,1,3,6,9,14,19,25,31,36,42,48,54,59,64,68,72,75,77,79,81,82,83,84,85,85,85,86,86,86,86
E01029908,EV motorcycles,Number,0,1,2,3,5,6,8,10,12,14,16,17,19,21,22,23,24,25,26,26,27,27,27,28,28,28,28,28,28,28
E01029909,EV motorcycles,Number,1,2,4,6,10,13,16,20,24,28,32,35,39,42,45,47,50,51,53,54,55,55,56,56,56,57,57,57,57,57
E01029910,EV motorcycles,Number,0,1,1,2,3,4,5,6,7,8,9,10,11,12,13,13,14,14,15,15,15,16,16,16,16,16,16,16,16,16
E01029911,EV motorcycles,Number,2,4,7,12,18,24,30,37,44,52,59,65,72,78,83,87,91,94,97,99,101,102,103,103,104,104,105,105,105,105
E01029912,EV motorcycles,Number,1,2,3,5,8,11,14,17,20,24,27,30,33,35,38,40,42,43,44,45,46,47,47,47,48,48,48,48,48,48
E01029913,EV motorcycles,Number,1,2,4,7,10,13,17,21,25,29,33,37,40,44,47,49,51,53,55,56,57,57,58,58,58,59,59,59,59,59
E01029914,EV motorcycles,Number,1,1,2,4,6,8,10,12,15,17,20,22,24,26,28,29,30,31,32,33,34,34,34,34,35,35,35,35,35,35
E01029915,EV motorcycles,Number,0,1,2,4,6,8,10,12,14,17,19,21,23,25,27,28,30,31,31,32,33,33,33,33,34,34,34,34,34,34
E01029916,EV motorcycles,Number,0,1,1,2,2,3,4,5,6,7,8,9,10,10,11,12,12,13,13,13,13,14,14,14,14,14,14,14,14,14
E01029917,EV motorcycles,Number,1,3,5,8,12,16,20,25,30,34,39,44,48,52,55,58,61,63,65,66,67,68,69,69,69,70,70,70,70,70
E01029918,EV motorcycles,Number,1,1,3,4,7,9,11,14,16,19,22,24,27,29,31,32,34,35,36,37,37,38,38,38,39,39,39,39,39,39
E01029919,EV motorcycles,Number,1,2,3,5,8,11,14,17,20,24,27,30,33,35,38,40,42,43,44,45,46,47,47,47,48,48,48,48,48,48
E01029920,EV motorcycles,Number,1,1,3,5,7,9,12,15,17,20,23,26,28,30,32,34,36,37,38,39,39,40,40,40,41,41,41,41,41,41
E01029921,EV motorcycles,Number,1,3,5,8,12,16,21,26,30,35,40,45,49,53,57,60,63,65,67,68,69,70,70,71,71,71,72,72,72,72
E01029922,EV motorcycles,Number,1,2,4,6,9,12,16,19,23,27,30,34,37,40,43,45,47,49,50,51,52,52,53,53,53,54,54,54,54,54
E01029923,EV motorcycles,Number,1,2,4,7,11,15,20,24,29,33,38,42,46,50,54,57,59,61,63,64,65,66,67,67,67,68,68,68,68,68
E01029925,EV motorcycles,Number,0,1,2,3,5,7,9,11,13,15,17,19,21,23,24,26,27,28,29,29,30,30,30,31,31,31,31,31,31,31
E01029926,EV motorcycles,Number,1,2,5,8,12,15,20,25,29,34,39,43,47,51,54,57,60,62,64,65,66,67,68,68,68,69,69,69,69,69
E01029927,EV motorcycles,Number,1,3,5,8,12,16,21,25,30,35,40,44,49,52,56,59,62,64,66,67,68,69,70,70,70,71,71,71,71,71
E01029928,EV motorcycles,Number,1,2,4,6,9,12,16,19,23,27,30,34,37,40,43,45,47,49,50,51,52,52,53,53,53,54,54,54,54,54
E01029929,EV motorcycles,Number,1,2,4,7,11,14,19,23,27,31,36,40,44,47,50,53,56,58,59,60,61,62,63,63,63,64,64,64,64,64
E01029930,EV motorcycles,Number,1,2,3,5,8,10,13,16,19,23,26,29,31,34,36,38,40,41,43,43,44,45,45,45,46,46,46,46,46,46
E01029937,EV motorcycles,Number,1,3,6,10,15,20,25,31,37,43,49,54,59,64,69,72,76,78,80,82,83,84,85,86,86,86,87,87,87,87
E01029938,EV motorcycles,Number,1,1,2,4,6,8,11,13,16,18,21,23,25,27,29,31,32,33,34,35,35,36,36,36,37,37,37,37,37,37
E01029939,EV motorcycles,Number,1,2,3,5,8,10,13,16,19,23,26,29,31,34,36,38,40,41,43,43,44,45,45,45,46,46,46,46,46,46
E01029940,EV motorcycles,Number,1,1,2,4,6,8,11,13,16,18,21,23,25,27,29,31,32,33,34,35,35,36,36,36,37,37,37,37,37,37
E01029941,EV motorcycles,Number,1,3,5,8,12,17,21,26,31,36,41,46,51,55,58,62,64,67,68,70,71,72,72,73,73,73,74,74,74,74
E01029942,EV motorcycles,Number,1,2,3,5,8,11,14,17,21,24,27,31,33,36,39,41,43,44,45,46,47,48,48,48,48,49,49,49,49,49
E01029944,EV motorcycles,Number,1,2,4,7,11,15,19,23,28,32,37,41,45,49,52,55,57,59,61,62,63,64,65,65,65,66,66,66,66,66
E01029945,EV motorcycles,Number,2,6,10,17,26,34,44,54,65,75,86,95,105,113,121,127,133,138,141,144,147,148,150,151,151,152,153,153,153,153
E01029946,EV motorcycles,Number,1,2,4,6,9,13,16,20,24,28,31,35,38,41,44,47,49,50,52,53,54,54,55,55,55,56,56,56,56,56
E01029947,EV motorcycles,Number,1,2,3,6,9,12,15,18,22,26,29,32,36,38,41,43,45,47,48,49,50,50,51,51,51,52,52,52,52,52
E01029949,EV motorcycles,Number,0,1,2,3,4,6,8,9,11,13,15,16,18,19,20,22,23,23,24,25,25,25,25,26,26,26,26,26,26,26
E01029950,EV motorcycles,Number,0,1,2,3,5,6,8,10,11,13,15,17,18,20,21,22,23,24,25,25,26,26,26,27,27,27,27,27,27,27
E01029951,EV motorcycles,Number,1,1,2,4,6,9,11,13,16,19,21,24,26,28,30,32,33,34,35,36,36,37,37,37,38,38,38,38,38,38
E01029952,EV motorcycles,Number,0,1,2,3,5,7,8,10,12,14,16,18,20,21,23,24,25,26,27,27,28,28,28,29,29,29,29,29,29,29
E01029953,EV motorcycles,Number,1,2,3,6,8,11,14,18,21,25,28,31,34,37,39,42,43,45,46,47,48,49,49,49,49,50,50,50,50,50
E01029954,EV motorcycles,Number,0,1,2,4,6,8,10,12,14,17,19,21,23,25,27,28,30,31,31,32,33,33,33,33,34,34,34,34,34,34
E01029955,EV motorcycles,Number,0,1,2,3,5,6,8,10,12,14,16,17,19,21,22,23,24,25,26,26,27,27,27,28,28,28,28,28,28,28
E01029956,EV motorcycles,Number,0,1,2,3,5,7,9,11,13,15,17,19,21,22,24,25,26,27,28,28,29,29,29,30,30,30,30,30,30,30
E01029957,EV motorcycles,Number,1,2,3,5,8,11,14,17,20,23,26,29,32,35,37,39,41,42,43,44,45,46,46,46,47,47,47,47,47,47
E01029958,EV motorcycles,Number,1,1,2,4,6,8,11,13,16,18,21,23,25,27,29,31,32,33,34,35,35,36,36,36,37,37,37,37,37,37
E01029960,EV motorcycles,Number,0,1,2,4,6,7,10,12,14,16,18,21,23,24,26,27,29,30,31,31,32,32,32,33,33,33,33,33,33,33
E01029961,EV motorcycles,Number,0,1,1,2,3,4,5,6,7,8,9,10,11,12,13,13,14,14,15,15,15,16,16,16,16,16,16,16,16,16
E01029962,EV motorcycles,Number,0,1,2,3,4,6,8,9,11,13,15,16,18,19,20,22,23,23,24,25,25,25,25,26,26,26,26,26,26,26
E01029963,EV motorcycles,Number,1,2,4,7,10,13,17,21,25,30,34,37,41,44,47,50,52,54,55,57,58,58,59,59,59,60,60,60,60,60
E01029964,EV motorcycles,Number,1,1,2,4,6,8,10,12,15,17,20,22,24,26,28,29,30,31,32,33,34,34,34,34,35,35,35,35,35,35
E01029965,EV motorcycles,Number,0,1,2,3,5,7,8,10,12,14,16,18,20,21,23,24,25,26,27,27,28,28,28,29,29,29,29,29,29,29
E01029966,EV motorcycles,Number,1,1,3,5,7,9,12,15,17,20,23,26,28,30,32,34,36,37,38,39,39,40,40,40,41,41,41,41,41,41
E01029967,EV motorcycles,Number,0,1,2,3,5,7,9,11,13,15,17,19,21,23,24,26,27,28,29,29,30,30,30,31,31,31,31,31,31,31
E01029968,EV motorcycles,Number,0,1,1,2,3,4,5,6,8,9,10,11,12,13,14,15,16,16,17,17,17,17,18,18,18,18,18,18,18,18
E01029969,EV motorcycles,Number,1,2,3,5,8,11,14,17,20,24,27,30,33,35,38,40,42,43,44,45,46,47,47,47,48,48,48,48,48,48
E01029970,EV motorcycles,Number,1,1,3,4,7,9,12,14,17,20,22,25,27,30,32,33,35,36,37,38,38,39,39,39,40,40,40,40,40,40
E01029971,EV motorcycles,Number,0,1,2,4,6,7,10,12,14,16,18,21,23,24,26,27,29,30,31,31,32,32,32,33,33,33,33,33,33,33
E01029973,EV motorcycles,Number,0,1,2,3,5,6,8,10,12,14,16,17,19,21,22,23,24,25,26,26,27,27,27,28,28,28,28,28,28,28
E01029974,EV motorcycles,Number,1,2,3,5,7,9,12,15,18,21,24,26,29,31,33,35,36,38,39,40,40,41,41,41,42,42,42,42,42,42
E01029975,EV motorcycles,Number,0,1,2,3,5,6,8,10,12,14,16,17,19,21,22,23,24,25,26,26,27,27,27,28,28,28,28,28,28,28
E01029976,EV motorcycles,Number,1,2,4,7,10,13,17,21,25,30,34,37,41,44,47,50,52,54,55,57,58,58,59,59,59,60,60,60,60,60
E01029977,EV motorcycles,Number,1,2,4,7,11,15,19,24,28,33,37,42,46,50,53,56,58,60,62,63,64,65,66,66,66,67,67,67,67,67
E01029978,EV motorcycles,Number,1,3,5,8,12,16,21,26,30,35,40,45,49,53,57,60,63,65,67,68,69,70,70,71,71,71,72,72,72,72
E01029979,EV motorcycles,Number,1,2,3,5,7,10,12,15,18,21,24,27,29,32,34,36,37,39,40,41,41,42,42,42,43,43,43,43,43,43
E01029980,EV motorcycles,Number,0,1,2,4,6,8,10,12,14,17,19,21,23,25,27,28,30,31,31,32,33,33,33,33,34,34,34,34,34,34
E01029981,EV motorcycles,Number,1,2,3,5,7,10,13,16,19,22,25,27,30,33,35,37,38,40,41,42,42,43,43,43,44,44,44,44,44,44
E01029982,EV motorcycles,Number,1,1,2,4,6,8,10,12,15,17,20,22,24,26,28,29,30,31,32,33,34,34,34,34,35,35,35,35,35,35
E01029983,EV motorcycles,Number,1,2,3,6,8,11,14,18,21,25,28,31,34,37,39,42,43,45,46,47,48,49,49,49,49,50,50,50,50,50
E01029984,EV motorcycles,Number,0,1,2,4,6,7,10,12,14,16,18,21,23,24,26,27,29,30,31,31,32,32,32,33,33,33,33,33,33,33
E01029985,EV motorcycles,Number,1,2,4,6,9,13,16,20,24,28,31,35,38,41,44,47,49,50,52,53,54,54,55,55,55,56,56,56,56,56
E01029986,EV motorcycles,Number,0,1,1,2,4,5,6,8,9,11,12,14,15,16,17,18,19,20,20,21,21,21,22,22,22,22,22,22,22,22
E01029987,EV motorcycles,Number,1,1,2,4,6,8,11,13,16,18,21,23,25,27,29,31,32,33,34,35,35,36,36,36,37,37,37,37,37,37
E01029988,EV motorcycles,Number,0,1,2,3,5,7,9,11,13,15,17,19,21,22,24,25,26,27,28,28,29,29,29,30,30,30,30,30,30,30
E01029990,EV motorcycles,Number,1,1,3,4,7,9,11,14,16,19,22,24,27,29,31,32,34,35,36,37,37,38,38,38,39,39,39,39,39,39
E01029991,EV motorcycles,Number,1,2,4,6,10,13,16,20,24,28,32,35,39,42,45,47,50,51,53,54,55,55,56,56,56,57,57,57,57,57
E01029992,EV motorcycles,Number,0,1,2,3,5,7,8,10,12,14,16,18,20,21,23,24,25,26,27,27,28,28,28,29,29,29,29,29,29,29
E01029994,EV motorcycles,Number,1,1,3,5,7,9,12,15,17,20,23,26,28,30,32,34,36,37,38,39,39,40,40,40,41,41,41,41,41,41
E01029995,EV motorcycles,Number,1,1,3,4,7,9,11,14,16,19,22,24,27,29,31,32,34,35,36,37,37,38,38,38,39,39,39,39,39,39
E01029996,EV motorcycles,Number,1,3,5,8,12,16,20,25,30,34,39,44,48,52,55,58,61,63,65,66,67,68,69,69,69,70,70,70,70,70
E01029997,EV motorcycles,Number,1,2,3,5,7,9,12,15,18,21,24,26,29,31,33,35,36,38,39,40,40,41,41,41,42,42,42,42,42,42
E01029998,EV motorcycles,Number,1,3,5,9,14,19,24,30,36,41,47,52,57,62,66,70,73,76,78,79,81,82,82,83,83,83,84,84,84,84
E01029999,EV motorcycles,Number,1,1,2,4,6,8,11,13,16,18,21,23,25,27,29,31,32,33,34,35,35,36,36,36,37,37,37,37,37,37
E01030000,EV motorcycles,Number,0,1,2,4,6,7,10,12,14,16,18,21,23,24,26,27,29,30,31,31,32,32,32,33,33,33,33,33,33,33
E01030001,EV motorcycles,Number,1,1,3,4,7,9,12,14,17,20,22,25,27,30,32,33,35,36,37,38,38,39,39,39,40,40,40,40,40,40
E01030002,EV motorcycles,Number,1,2,4,7,11,15,19,23,28,32,37,41,45,49,52,55,57,59,61,62,63,64,65,65,65,66,66,66,66,66
E01030003,EV motorcycles,Number,0,1,2,4,5,7,9,11,14,16,18,20,22,24,25,27,28,29,30,30,31,31,31,32,32,32,32,32,32,32
E01030004,EV motorcycles,Number,1,1,2,4,6,8,10,12,15,17,20,22,24,26,28,29,30,31,32,33,34,34,34,34,35,35,35,35,35,35
E01030005,EV motorcycles,Number,1,2,4,6,9,12,16,20,23,27,31,34,38,41,43,46,48,49,51,52,53,53,54,54,54,55,55,55,55,55
E01030006,EV motorcycles,Number,1,1,2,4,6,8,10,13,15,18,20,22,25,27,28,30,31,32,33,34,35,35,35,35,36,36,36,36,36,36
E01030007,EV motorcycles,Number,1,1,2,4,6,8,10,12,15,17,20,22,24,26,28,29,30,31,32,33,34,34,34,34,35,35,35,35,35,35
E01030008,EV motorcycles,Number,0,1,2,3,5,7,9,11,13,15,17,19,21,22,24,25,26,27,28,28,29,29,29,30,30,30,30,30,30,30
E01030009,EV motorcycles,Number,0,1,1,2,3,3,4,5,6,7,8,9,10,11,12,12,13,13,14,14,14,15,15,15,15,15,15,15,15,15
E01030010,EV motorcycles,Number,0,1,1,2,4,5,6,7,9,10,12,13,14,16,17,17,18,19,19,20,20,20,21,21,21,21,21,21,21,21
E01030011,EV motorcycles,Number,1,2,3,5,7,10,12,15,18,21,24,27,29,32,34,36,37,39,40,41,41,42,42,42,43,43,43,43,43,43
E01030012,EV motorcycles,Number,0,1,2,3,4,5,7,8,10,11,13,14,16,17,18,19,20,21,21,22,22,22,23,23,23,23,23,23,23,23
E01030013,EV motorcycles,Number,0,1,2,3,5,7,8,10,12,14,16,18,20,21,23,24,25,26,27,27,28,28,28,29,29,29,29,29,29,29
E01030014,EV motorcycles,Number,0,1,2,3,4,6,7,9,11,12,14,16,17,18,20,21,22,22,23,24,24,24,24,25,25,25,25,25,25,25
E01030015,EV motorcycles,Number,1,2,3,6,9,12,15,19,22,26,30,33,36,39,42,44,46,48,49,50,51,51,52,52,52,53,53,53,53,53
E01030016,EV motorcycles,Number,0,1,2,4,5,7,9,11,14,16,18,20,22,24,25,27,28,29,30,30,31,31,31,32,32,32,32,32,32,32
E01030017,EV motorcycles,Number,0,1,2,3,5,6,8,10,11,13,15,17,18,20,21,22,23,24,25,25,26,26,26,27,27,27,27,27,27,27
E01030018,EV motorcycles,Number,0,1,2,3,4,5,7,9,10,12,13,15,16,18,19,20,21,22,22,23,23,23,23,24,24,24,24,24,24,24
E01030019,EV motorcycles,Number,1,2,3,6,9,12,15,19,22,26,30,33,36,39,42,44,46,48,49,50,51,51,52,52,52,53,53,53,53,53
E01030020,EV motorcycles,Number,1,2,3,5,7,9,12,15,18,21,24,26,29,31,33,35,36,38,39,40,40,41,41,41,42,42,42,42,42,42
E01030021,EV motorcycles,Number,1,1,3,5,7,9,12,15,17,20,23,26,28,30,32,34,36,37,38,39,39,40,40,40,41,41,41,41,41,41
E01030022,EV motorcycles,Number,1,1,2,4,6,9,11,13,16,19,21,24,26,28,30,32,33,34,35,36,36,37,37,37,38,38,38,38,38,38
E01030023,EV motorcycles,Number,0,1,2,3,5,7,9,11,13,15,17,19,21,23,24,26,27,28,29,29,30,30,30,31,31,31,31,31,31,31
E01030024,EV motorcycles,Number,0,1,2,3,4,6,8,9,11,13,15,16,18,19,20,22,23,23,24,25,25,25,25,26,26,26,26,26,26,26
E01030025,EV motorcycles,Number,0,1,2,3,4,5,7,8,10,11,13,14,16,17,18,19,20,21,21,22,22,22,23,23,23,23,23,23,23,23
E01030026,EV motorcycles,Number,0,1,2,3,5,7,9,11,13,15,17,19,21,22,24,25,26,27,28,28,29,29,29,30,30,30,30,30,30,30
E01030027,EV motorcycles,Number,1,1,3,4,7,9,11,14,16,19,22,24,27,29,31,32,34,35,36,37,37,38,38,38,39,39,39,39,39,39
E01030028,EV motorcycles,Number,1,2,3,5,7,10,13,16,19,22,25,27,30,33,35,37,38,40,41,42,42,43,43,43,44,44,44,44,44,44
E01030029,EV motorcycles,Number,0,1,1,2,3,4,5,6,7,8,9,10,11,12,13,13,14,14,15,15,15,16,16,16,16,16,16,16,16,16
E01030030,EV motorcycles,Number,1,2,3,6,9,12,15,18,22,26,29,32,36,38,41,43,45,47,48,49,50,50,51,51,51,52,52,52,52,52
E01030031,EV motorcycles,Number,1,2,3,5,7,10,12,15,18,21,24,27,29,32,34,36,37,39,40,41,41,42,42,42,43,43,43,43,43,43
E01030032,EV motorcycles,Number,1,2,3,5,7,10,12,15,18,21,24,27,29,32,34,36,37,39,40,41,41,42,42,42,43,43,43,43,43,43
E01030033,EV motorcycles,Number,1,2,3,6,8,11,14,18,21,25,28,31,34,37,39,42,43,45,46,47,48,49,49,49,49,50,50,50,50,50
E01030034,EV motorcycles,Number,1,2,4,6,9,13,16,20,24,28,31,35,38,41,44,47,49,50,52,53,54,54,55,55,55,56,56,56,56,56
E01030035,EV motorcycles,Number,1,2,3,6,9,11,15,18,22,25,29,32,35,38,40,42,44,46,47,48,49,49,50,50,50,51,51,51,51,51
E01030036,EV motorcycles,Number,1,2,3,5,7,10,12,15,18,21,24,27,29,32,34,36,37,39,40,41,41,42,42,42,43,43,43,43,43,43
E01030037,EV motorcycles,Number,0,1,2,4,6,7,10,12,14,16,18,21,23,24,26,27,29,30,31,31,32,32,32,33,33,33,33,33,33,33
E01030038,EV motorcycles,Number,1,2,3,5,8,11,14,17,20,23,26,29,32,35,37,39,41,42,43,44,45,46,46,46,47,47,47,47,47,47
E01030039,EV motorcycles,Number,1,2,4,7,10,14,18,22,26,30,34,38,42,45,48,51,53,55,56,58,58,59,60,60,60,61,61,61,61,61
E01030040,EV motorcycles,Number,1,3,5,9,13,18,23,28,33,38,44,49,53,58,61,65,68,70,72,74,75,76,76,77,77,77,78,78,78,78
E01030041,EV motorcycles,Number,2,4,7,12,18,24,31,38,45,52,59,66,72,78,84,88,92,95,98,100,102,103,104,104,105,105,106,106,106,106
E01030042,EV motorcycles,Number,1,2,3,6,9,12,15,19,22,26,30,33,36,39,42,44,46,48,49,50,51,51,52,52,52,53,53,53,53,53
E01030043,EV motorcycles,Number,1,3,6,10,15,20,25,31,37,43,49,54,59,64,69,72,76,78,80,82,83,84,85,86,86,86,87,87,87,87
E01030044,EV motorcycles,Number,1,1,3,4,7,9,11,14,16,19,22,24,27,29,31,32,34,35,36,37,37,38,38,38,39,39,39,39,39,39
E01030045,EV motorcycles,Number,1,2,4,7,11,15,19,23,27,32,36,40,44,48,51,54,56,58,60,61,62,63,64,64,64,65,65,65,65,65
E01030046,EV motorcycles,Number,1,3,6,10,15,20,26,32,38,44,50,56,62,67,71,75,78,81,83,85,86,87,88,89,89,89,90,90,90,90
E01030047,EV motorcycles,Number,0,1,2,3,5,6,8,10,11,13,15,17,18,20,21,22,23,24,25,25,26,26,26,27,27,27,27,27,27,27
E01030048,EV motorcycles,Number,1,3,5,8,13,17,22,27,33,38,43,48,53,57,61,64,67,69,71,73,74,75,75,76,76,76,77,77,77,77
E01030049,EV motorcycles,Number,1,3,5,8,12,16,20,25,30,34,39,44,48,52,55,58,61,63,65,66,67,68,69,69,69,70,70,70,70,70
E01030050,EV motorcycles,Number,1,3,5,9,14,18,24,29,35,40,46,51,56,61,65,68,71,74,76,77,79,80,80,81,81,81,82,82,82,82
E01030051,EV motorcycles,Number,1,2,4,6,9,12,16,20,23,27,31,34,38,41,43,46,48,49,51,52,53,53,54,54,54,55,55,55,55,55
E01030052,EV motorcycles,Number,1,2,4,6,10,13,16,20,24,28,32,35,39,42,45,47,50,51,53,54,55,55,56,56,56,57,57,57,57,57
E01030053,EV motorcycles,Number,1,3,6,10,16,21,27,34,40,47,53,59,65,70,75,79,83,85,88,90,91,92,93,94,94,94,95,95,95,95
E01030054,EV motorcycles,Number,1,2,3,5,8,11,14,17,20,23,26,29,32,35,37,39,41,42,43,44,45,46,46,46,47,47,47,47,47,47
E01030055,EV motorcycles,Number,1,2,3,6,9,12,15,19,22,26,30,33,36,39,42,44,46,48,49,50,51,51,52,52,52,53,53,53,53,53
E01030056,EV motorcycles,Number,2,5,9,15,23,30,39,48,57,66,76,84,92,100,106,112,117,121,125,127,129,131,132,133,134,134,135,135,135,135
E01030057,EV motorcycles,Number,2,4,8,13,20,27,35,43,52,60,68,76,83,90,96,101,106,110,113,115,117,118,119,120,121,121,122,122,122,122
E01030058,EV motorcycles,Number,1,3,6,10,15,20,26,32,38,44,50,55,61,66,70,74,77,80,82,84,85,86,87,88,88,88,89,89,89,89
E01030059,EV motorcycles,Number,1,3,6,9,14,19,25,30,36,42,48,53,58,63,67,71,74,76,79,80,82,82,83,84,84,84,85,85,85,85
E01030060,EV motorcycles,Number,1,2,4,7,11,14,19,23,27,31,36,40,44,47,50,53,56,58,59,60,61,62,63,63,63,64,64,64,64,64
E01030061,EV motorcycles,Number,1,1,3,4,7,9,11,14,16,19,22,24,27,29,31,32,34,35,36,37,37,38,38,38,39,39,39,39,39,39
E01030062,EV motorcycles,Number,1,1,3,5,7,9,12,15,17,20,23,26,28,30,32,34,36,37,38,39,39,40,40,40,41,41,41,41,41,41
E01030063,EV motorcycles,Number,1,4,7,11,17,23,30,37,44,51,58,64,70,76,81,86,89,93,95,97,99,100,101,101,102,102,103,103,103,103
E01030064,EV motorcycles,Number,1,4,7,11,17,22,29,36,42,49,56,62,68,74,79,83,87,90,92,94,96,97,98,99,99,99,100,100,100,100
E01030065,EV motorcycles,Number,1,3,6,11,16,22,28,34,41,47,54,60,66,71,76,80,83,86,89,91,92,93,94,95,95,95,96,96,96,96
E01030066,EV motorcycles,Number,1,3,6,10,15,20,26,32,38,44,50,55,61,66,70,74,77,80,82,84,85,86,87,88,88,88,89,89,89,89
E01030067,EV motorcycles,Number,1,2,4,7,11,14,18,22,27,31,35,39,43,47,50,52,55,57,58,59,60,61,62,62,62,63,63,63,63,63
E01030068,EV motorcycles,Number,1,2,4,7,11,14,18,22,27,31,35,39,43,47,50,52,55,57,58,59,60,61,62,62,62,63,63,63,63,63
E01030069,EV motorcycles,Number,1,3,5,8,12,17,21,26,31,36,41,46,51,55,58,62,64,67,68,70,71,72,72,73,73,73,74,74,74,74
E01030070,EV motorcycles,Number,1,2,3,5,8,11,14,17,20,24,27,30,33,35,38,40,42,43,44,45,46,47,47,47,48,48,48,48,48,48
E01030071,EV motorcycles,Number,1,2,3,5,8,10,13,16,19,23,26,29,31,34,36,38,40,41,43,43,44,45,45,45,46,46,46,46,46,46
E01030072,EV motorcycles,Number,1,2,3,5,8,11,14,17,21,24,27,31,33,36,39,41,43,44,45,46,47,48,48,48,48,49,49,49,49,49
E01030073,EV motorcycles,Number,0,1,2,3,5,7,9,11,13,15,17,19,21,23,24,26,27,28,29,29,30,30,30,31,31,31,31,31,31,31
E01030075,EV motorcycles,Number,1,2,4,6,10,13,17,21,25,29,32,36,40,43,46,48,50,52,54,55,56,56,57,57,57,58,58,58,58,58
E01030076,EV motorcycles,Number,1,1,3,4,7,9,12,14,17,20,22,25,27,30,32,33,35,36,37,38,38,39,39,39,40,40,40,40,40,40
E01030077,EV motorcycles,Number,0,1,2,3,5,7,8,10,12,14,16,18,20,21,23,24,25,26,27,27,28,28,28,29,29,29,29,29,29,29
E01030078,EV motorcycles,Number,1,2,4,7,11,15,20,24,29,33,38,42,46,50,54,57,59,61,63,64,65,66,67,67,67,68,68,68,68,68
E01030079,EV motorcycles,Number,1,1,3,5,7,9,12,15,17,20,23,26,28,30,32,34,36,37,38,39,39,40,40,40,41,41,41,41,41,41
E01030080,EV motorcycles,Number,1,3,5,8,13,17,22,27,32,37,42,47,51,55,59,62,65,67,69,71,72,73,73,74,74,74,75,75,75,75
E01030081,EV motorcycles,Number,2,4,7,12,19,25,32,39,47,55,62,69,76,82,88,92,96,100,103,105,106,108,109,109,110,110,111,111,111,111
E01030082,EV motorcycles,Number,2,5,9,15,22,30,39,48,57,66,75,83,92,99,106,111,116,120,124,126,128,130,131,132,133,133,134,134,134,134
E01030083,EV motorcycles,Number,2,4,7,12,18,24,31,38,45,53,60,67,73,79,84,89,93,96,99,101,103,104,105,105,106,106,107,107,107,107
E01030084,EV motorcycles,Number,1,2,4,7,11,15,19,24,28,33,37,42,46,50,53,56,58,60,62,63,64,65,66,66,66,67,67,67,67,67
E01030085,EV motorcycles,Number,1,2,3,6,9,12,15,18,22,26,29,32,36,38,41,43,45,47,48,49,50,50,51,51,51,52,52,52,52,52
E01030086,EV motorcycles,Number,1,2,3,5,8,11,14,17,21,24,27,31,33,36,39,41,43,44,45,46,47,48,48,48,48,49,49,49,49,49
E01030087,EV motorcycles,Number,1,3,5,8,12,16,20,25,30,34,39,44,48,52,55,58,61,63,65,66,67,68,69,69,69,70,70,70,70,70
E01030088,EV motorcycles,Number,0,1,2,3,5,7,8,10,12,14,16,18,20,21,23,24,25,26,27,27,28,28,28,29,29,29,29,29,29,29
E01030089,EV motorcycles,Number,1,3,5,9,13,18,23,28,33,38,44,49,53,58,61,65,68,70,72,74,75,76,76,77,77,77,78,78,78,78
E01030090,EV motorcycles,Number,1,4,7,11,17,23,30,37,44,51,58,64,70,76,81,86,89,93,95,97,99,100,101,101,102,102,103,103,103,103
E01030091,EV motorcycles,Number,0,1,1,2,4,5,6,7,9,10,12,13,14,16,17,17,18,19,19,20,20,20,21,21,21,21,21,21,21,21
E01030092,EV motorcycles,Number,0,1,2,3,4,6,8,9,11,13,15,16,18,19,20,22,23,23,24,25,25,25,25,26,26,26,26,26,26,26
E01030093,EV motorcycles,Number,0,1,2,3,4,6,8,9,11,13,15,16,18,19,20,22,23,23,24,25,25,25,25,26,26,26,26,26,26,26
E01030094,EV motorcycles,Number,1,2,3,6,9,11,15,18,22,25,29,32,35,38,40,42,44,46,47,48,49,49,50,50,50,51,51,51,51,51
E01030095,EV motorcycles,Number,1,2,3,5,8,11,14,17,20,23,26,29,32,35,37,39,41,42,43,44,45,46,46,46,47,47,47,47,47,47
E01030096,EV motorcycles,Number,1,3,5,8,12,16,21,26,31,36,41,45,50,54,58,61,63,66,67,69,70,71,71,72,72,72,73,73,73,73
E01030097,EV motorcycles,Number,1,2,3,6,9,11,15,18,22,25,29,32,35,38,40,42,44,46,47,48,49,49,50,50,50,51,51,51,51,51
E01030098,EV motorcycles,Number,1,3,5,8,13,17,22,27,32,37,42,47,51,55,59,62,65,67,69,71,72,73,73,74,74,74,75,75,75,75
E01030099,EV motorcycles,Number,1,2,4,7,11,15,19,23,28,32,37,41,45,49,52,55,57,59,61,62,63,64,65,65,65,66,66,66,66,66
E01030100,EV motorcycles,Number,1,3,6,10,15,21,27,33,39,45,51,57,63,68,73,77,80,83,85,87,88,89,90,91,91,91,92,92,92,92
E01030101,EV motorcycles,Number,1,2,4,7,10,14,18,22,26,30,34,38,42,45,48,51,53,55,56,58,58,59,60,60,60,61,61,61,61,61
E01030103,EV motorcycles,Number,2,4,7,12,18,24,32,39,46,54,61,68,75,81,86,91,95,98,101,103,105,106,107,107,108,108,109,109,109,109
E01030104,EV motorcycles,Number,1,2,4,7,10,14,18,22,26,30,35,39,42,46,49,52,54,56,57,59,59,60,61,61,61,62,62,62,62,62
E01030105,EV motorcycles,Number,0,1,2,3,5,6,8,10,11,13,15,17,18,20,21,22,23,24,25,25,26,26,26,27,27,27,27,27,27,27
E01030106,EV motorcycles,Number,1,2,4,7,11,14,18,22,27,31,35,39,43,47,50,52,55,57,58,59,60,61,62,62,62,63,63,63,63,63
E01030107,EV motorcycles,Number,1,2,3,5,7,10,12,15,18,21,24,27,29,32,34,36,37,39,40,41,41,42,42,42,43,43,43,43,43,43
E01030108,EV motorcycles,Number,1,1,2,4,6,9,11,13,16,19,21,24,26,28,30,32,33,34,35,36,36,37,37,37,38,38,38,38,38,38
E01030109,EV motorcycles,Number,0,1,2,3,5,7,9,11,13,15,17,19,21,23,24,26,27,28,29,29,30,30,30,31,31,31,31,31,31,31
E01030110,EV motorcycles,Number,1,1,2,4,6,8,10,13,15,18,20,22,25,27,28,30,31,32,33,34,35,35,35,35,36,36,36,36,36,36
E01030111,EV motorcycles,Number,0,1,2,3,5,6,8,10,11,13,15,17,18,20,21,22,23,24,25,25,26,26,26,27,27,27,27,27,27,27
E01030112,EV motorcycles,Number,1,2,3,5,8,10,13,16,19,23,26,29,31,34,36,38,40,41,43,43,44,45,45,45,46,46,46,46,46,46
E01030113,EV motorcycles,Number,0,1,2,4,5,7,9,11,14,16,18,20,22,24,25,27,28,29,30,30,31,31,31,32,32,32,32,32,32,32
E01030114,EV motorcycles,Number,0,1,2,3,4,5,7,9,10,12,13,15,16,18,19,20,21,22,22,23,23,23,23,24,24,24,24,24,24,24
E01030115,EV motorcycles,Number,1,1,2,4,6,8,11,13,16,18,21,23,25,27,29,31,32,33,34,35,35,36,36,36,37,37,37,37,37,37
E01030116,EV motorcycles,Number,1,2,3,5,8,11,14,17,20,24,27,30,33,35,38,40,42,43,44,45,46,47,47,47,48,48,48,48,48,48
E01030117,EV motorcycles,Number,1,1,3,5,7,9,12,15,17,20,23,26,28,30,32,34,36,37,38,39,39,40,40,40,41,41,41,41,41,41
E01030118,EV motorcycles,Number,0,1,2,3,4,5,7,9,10,12,13,15,16,18,19,20,21,22,22,23,23,23,23,24,24,24,24,24,24,24
E01030119,EV motorcycles,Number,1,3,5,8,12,16,21,26,31,36,41,45,50,54,58,61,63,66,67,69,70,71,71,72,72,72,73,73,73,73
E01030120,EV motorcycles,Number,1,3,6,10,15,20,26,32,38,44,50,55,61,66,70,74,77,80,82,84,85,86,87,88,88,88,89,89,89,89
E01030121,EV motorcycles,Number,1,3,5,8,13,17,22,27,33,38,43,48,53,57,61,64,67,69,71,73,74,75,75,76,76,76,77,77,77,77
E01030122,EV motorcycles,Number,1,2,3,6,9,11,15,18,22,25,29,32,35,38,40,42,44,46,47,48,49,49,50,50,50,51,51,51,51,51
E01030123,EV motorcycles,Number,0,1,2,3,5,6,8,10,11,13,15,17,18,20,21,22,23,24,25,25,26,26,26,27,27,27,27,27,27,27
E01030124,EV motorcycles,Number,1,1,3,5,7,9,12,15,17,20,23,26,28,30,32,34,36,37,38,39,39,40,40,40,41,41,41,41,41,41
E01030125,EV motorcycles,Number,1,1,2,4,6,8,10,12,15,17,20,22,24,26,28,29,30,31,32,33,34,34,34,34,35,35,35,35,35,35
E01030127,EV motorcycles,Number,0,1,2,3,4,6,7,9,11,12,14,16,17,18,20,21,22,22,23,24,24,24,24,25,25,25,25,25,25,25
E01030128,EV motorcycles,Number,0,1,1,2,3,4,6,7,8,10,11,12,14,15,16,17,17,18,18,19,19,19,20,20,20,20,20,20,20,20
E01030129,EV motorcycles,Number,0,1,2,3,5,7,9,11,13,15,17,19,21,23,24,26,27,28,29,29,30,30,30,31,31,31,31,31,31,31
E01030130,EV motorcycles,Number,1,2,3,5,7,9,12,15,18,21,24,26,29,31,33,35,36,38,39,40,40,41,41,41,42,42,42,42,42,42
E01030131,EV motorcycles,Number,0,1,2,3,5,7,9,11,13,15,17,19,21,22,24,25,26,27,28,28,29,29,29,30,30,30,30,30,30,30
E01030132,EV motorcycles,Number,1,2,3,5,7,9,12,15,18,21,24,26,29,31,33,35,36,38,39,40,40,41,41,41,42,42,42,42,42,42
E01030133,EV motorcycles,Number,1,2,4,6,9,12,16,20,23,27,31,34,38,41,43,46,48,49,51,52,53,53,54,54,54,55,55,55,55,55
E01030134,EV motorcycles,Number,0,1,2,4,6,8,10,12,14,17,19,21,23,25,27,28,30,31,31,32,33,33,33,33,34,34,34,34,34,34
E01030135,EV motorcycles,Number,1,2,4,7,11,15,20,24,29,33,38,42,46,50,54,57,59,61,63,64,65,66,67,67,67,68,68,68,68,68
E01030137,EV motorcycles,Number,0,1,2,3,5,7,8,10,12,14,16,18,20,21,23,24,25,26,27,27,28,28,28,29,29,29,29,29,29,29
E01030138,EV motorcycles,Number,1,4,7,11,17,22,29,36,42,49,56,62,68,74,79,83,87,90,92,94,96,97,98,99,99,99,100,100,100,100
E01030139,EV motorcycles,Number,1,1,2,4,6,8,10,13,15,18,20,22,25,27,28,30,31,32,33,34,35,35,35,35,36,36,36,36,36,36
E01030140,EV motorcycles,Number,0,1,2,3,4,5,7,9,10,12,13,15,16,18,19,20,21,22,22,23,23,23,23,24,24,24,24,24,24,24
E01030141,EV motorcycles,Number,0,1,2,4,6,8,10,12,14,17,19,21,23,25,27,28,30,31,31,32,33,33,33,33,34,34,34,34,34,34
E01030142,EV motorcycles,Number,1,1,2,4,6,8,10,12,15,17,20,22,24,26,28,29,30,31,32,33,34,34,34,34,35,35,35,35,35,35
E01030143,EV motorcycles,Number,0,1,2,4,6,7,10,12,14,16,18,21,23,24,26,27,29,30,31,31,32,32,32,33,33,33,33,33,33,33
E01030144,EV motorcycles,Number,1,1,2,4,6,8,10,13,15,18,20,22,25,27,28,30,31,32,33,34,35,35,35,35,36,36,36,36,36,36
E01030145,EV motorcycles,Number,1,3,5,8,13,17,22,27,32,37,43,47,52,56,60,63,66,68,70,72,73,74,74,75,75,75,76,76,76,76
E01030146,EV motorcycles,Number,1,1,2,4,6,8,10,13,15,18,20,22,25,27,28,30,31,32,33,34,35,35,35,35,36,36,36,36,36,36
E01030147,EV motorcycles,Number,0,1,2,4,6,8,10,12,14,17,19,21,23,25,27,28,30,31,31,32,33,33,33,33,34,34,34,34,34,34
E01030148,EV motorcycles,Number,1,1,2,4,6,8,10,12,15,17,20,22,24,26,28,29,30,31,32,33,34,34,34,34,35,35,35,35,35,35
E01030149,EV motorcycles,Number,0,1,2,3,4,6,8,9,11,13,15,16,18,19,20,22,23,23,24,25,25,25,25,26,26,26,26,26,26,26
E01030150,EV motorcycles,Number,2,4,7,12,19,25,33,40,48,56,63,70,77,83,89,94,98,102,104,107,108,110,111,111,112,112,113,113,113,113
E01030151,EV motorcycles,Number,1,3,6,10,16,21,27,33,39,46,52,58,64,69,73,77,81,84,86,88,89,90,91,92,92,92,93,93,93,93
E01030152,EV motorcycles,Number,1,3,6,9,14,19,25,31,36,42,48,54,59,64,68,72,75,77,79,81,82,83,84,85,85,85,86,86,86,86
E01030153,EV motorcycles,Number,1,2,3,5,7,9,12,15,18,21,24,26,29,31,33,35,36,38,39,40,40,41,41,41,42,42,42,42,42,42
E01030154,EV motorcycles,Number,1,4,7,11,17,23,30,37,44,51,58,64,70,76,81,86,89,93,95,97,99,100,101,101,102,102,103,103,103,103
E01030155,EV motorcycles,Number,1,2,4,6,9,13,16,20,24,28,31,35,38,41,44,47,49,50,52,53,54,54,55,55,55,56,56,56,56,56
E01030158,EV motorcycles,Number,1,2,3,5,8,10,13,16,19,22,25,28,31,33,35,37,39,40,42,42,43,44,44,44,45,45,45,45,45,45
E01030159,EV motorcycles,Number,1,2,3,5,8,11,14,17,20,23,26,29,32,35,37,39,41,42,43,44,45,46,46,46,47,47,47,47,47,47
E01030160,EV motorcycles,Number,1,2,4,7,11,15,19,24,28,33,37,42,46,50,53,56,58,60,62,63,64,65,66,66,66,67,67,67,67,67
E01030161,EV motorcycles,Number,1,1,2,4,6,8,11,13,16,18,21,23,25,27,29,31,32,33,34,35,35,36,36,36,37,37,37,37,37,37
E01030162,EV motorcycles,Number,0,1,2,4,6,7,10,12,14,16,18,21,23,24,26,27,29,30,31,31,32,32,32,33,33,33,33,33,33,33
E01030163,EV motorcycles,Number,1,2,4,6,9,12,16,19,23,27,30,34,37,40,43,45,47,49,50,51,52,52,53,53,53,54,54,54,54,54
E01030164,EV motorcycles,Number,1,2,3,5,8,11,14,17,20,24,27,30,33,35,38,40,42,43,44,45,46,47,47,47,48,48,48,48,48,48
E01030165,EV motorcycles,Number,1,2,3,5,8,11,14,17,20,24,27,30,33,35,38,40,42,43,44,45,46,47,47,47,48,48,48,48,48,48
E01030166,EV motorcycles,Number,1,2,3,5,8,11,14,17,20,24,27,30,33,35,38,40,42,43,44,45,46,47,47,47,48,48,48,48,48,48
E01030167,EV motorcycles,Number,1,2,3,5,7,9,12,15,18,21,24,26,29,31,33,35,36,38,39,40,40,41,41,41,42,42,42,42,42,42
E01030168,EV motorcycles,Number,1,2,3,5,8,10,13,16,19,23,26,29,31,34,36,38,40,41,43,43,44,45,45,45,46,46,46,46,46,46
E01030169,EV motorcycles,Number,1,2,3,6,9,12,15,18,22,26,29,32,36,38,41,43,45,47,48,49,50,50,51,51,51,52,52,52,52,52
E01030170,EV motorcycles,Number,1,3,5,8,13,17,22,27,32,37,43,47,52,56,60,63,66,68,70,72,73,74,74,75,75,75,76,76,76,76
E01030171,EV motorcycles,Number,1,3,5,9,14,18,24,29,35,40,46,51,56,61,65,68,71,74,76,77,79,80,80,81,81,81,82,82,82,82
E01030172,EV motorcycles,Number,1,3,5,9,14,19,24,29,35,41,46,52,57,61,65,69,72,75,77,78,80,81,81,82,82,82,83,83,83,83
E01030173,EV motorcycles,Number,2,5,9,15,23,31,39,48,57,67,76,85,93,100,107,113,118,122,126,128,130,132,133,134,135,135,136,136,136,136
E01030174,EV motorcycles,Number,1,2,4,7,11,14,18,22,27,31,35,39,43,47,50,52,55,57,58,59,60,61,62,62,62,63,63,63,63,63
E01030175,EV motorcycles,Number,1,3,5,8,13,17,22,27,32,37,43,47,52,56,60,63,66,68,70,72,73,74,74,75,75,75,76,76,76,76
E01030176,EV motorcycles,Number,1,4,7,11,17,23,30,37,44,51,58,64,70,76,81,86,89,93,95,97,99,100,101,101,102,102,103,103,103,103
E01030179,EV motorcycles,Number,1,2,4,7,11,15,19,23,28,32,37,41,45,49,52,55,57,59,61,62,63,64,65,65,65,66,66,66,66,66
E01030180,EV motorcycles,Number,1,2,3,5,8,10,13,16,19,23,26,29,31,34,36,38,40,41,43,43,44,45,45,45,46,46,46,46,46,46
E01030181,EV motorcycles,Number,1,1,3,4,7,9,11,14,16,19,22,24,27,29,31,32,34,35,36,37,37,38,38,38,39,39,39,39,39,39
E01030183,EV motorcycles,Number,2,4,7,12,18,24,30,37,44,52,59,65,72,78,83,87,91,94,97,99,101,102,103,103,104,104,105,105,105,105
E01030184,EV motorcycles,Number,1,3,5,8,12,16,21,26,30,35,40,45,49,53,57,60,63,65,67,68,69,70,70,71,71,71,72,72,72,72
E01030185,EV motorcycles,Number,1,3,5,8,13,17,22,27,32,37,43,47,52,56,60,63,66,68,70,72,73,74,74,75,75,75,76,76,76,76
E01030186,EV motorcycles,Number,1,3,5,9,14,19,24,30,36,41,47,52,57,62,66,70,73,76,78,79,81,82,82,83,83,83,84,84,84,84
E01030187,EV motorcycles,Number,1,3,5,8,12,16,21,26,30,35,40,45,49,53,57,60,63,65,67,68,69,70,70,71,71,71,72,72,72,72
E01030188,EV motorcycles,Number,1,3,5,8,12,17,21,26,31,36,41,46,51,55,58,62,64,67,68,70,71,72,72,73,73,73,74,74,74,74
E01030189,EV motorcycles,Number,1,3,5,8,12,16,21,26,31,36,41,45,50,54,58,61,63,66,67,69,70,71,71,72,72,72,73,73,73,73
E01030190,EV motorcycles,Number,1,3,5,8,12,16,21,25,30,35,40,44,49,52,56,59,62,64,66,67,68,69,70,70,70,71,71,71,71,71
E01030191,EV motorcycles,Number,1,2,4,7,11,15,19,24,28,33,37,42,46,50,53,56,58,60,62,63,64,65,66,66,66,67,67,67,67,67
E01030192,EV motorcycles,Number,0,1,2,3,4,6,8,9,11,13,15,16,18,19,20,22,23,23,24,25,25,25,25,26,26,26,26,26,26,26
E01030193,EV motorcycles,Number,1,2,4,7,11,15,20,24,29,33,38,42,46,50,54,57,59,61,63,64,65,66,67,67,67,68,68,68,68,68
E01030194,EV motorcycles,Number,1,2,4,7,11,15,19,24,28,33,37,42,46,50,53,56,58,60,62,63,64,65,66,66,66,67,67,67,67,67
E01030195,EV motorcycles,Number,0,1,2,3,5,7,8,10,12,14,16,18,20,21,23,24,25,26,27,27,28,28,28,29,29,29,29,29,29,29
E01030196,EV motorcycles,Number,1,2,3,6,9,12,15,18,22,26,29,32,36,38,41,43,45,47,48,49,50,50,51,51,51,52,52,52,52,52
E01030197,EV motorcycles,Number,1,3,5,9,13,18,23,28,34,39,45,50,55,59,63,67,70,72,74,76,77,78,78,79,79,79,80,80,80,80
E01030198,EV motorcycles,Number,1,3,6,11,16,22,28,34,41,47,54,60,66,71,76,80,83,86,89,91,92,93,94,95,95,95,96,96,96,96
E01030199,EV motorcycles,Number,1,3,5,8,12,16,21,26,30,35,40,45,49,53,57,60,63,65,67,68,69,70,70,71,71,71,72,72,72,72
E01030200,EV motorcycles,Number,1,3,6,10,15,20,25,31,37,43,49,54,59,64,69,72,76,78,80,82,83,84,85,86,86,86,87,87,87,87
E01030201,EV motorcycles,Number,1,4,6,11,17,22,29,35,42,49,55,62,68,73,78,82,86,89,92,93,95,96,97,98,98,98,99,99,99,99
E01030203,EV motorcycles,Number,1,2,5,8,12,15,20,25,29,34,39,43,47,51,54,57,60,62,64,65,66,67,68,68,68,69,69,69,69,69
E01030204,EV motorcycles,Number,1,3,5,9,13,18,23,28,33,39,44,49,54,58,62,66,69,71,73,75,76,77,77,78,78,78,79,79,79,79
E01030205,EV motorcycles,Number,1,2,3,5,7,10,12,15,18,21,24,27,29,32,34,36,37,39,40,41,41,42,42,42,43,43,43,43,43,43
E01030206,EV motorcycles,Number,1,1,2,4,6,8,11,13,16,18,21,23,25,27,29,31,32,33,34,35,35,36,36,36,37,37,37,37,37,37
E01030207,EV motorcycles,Number,1,2,4,7,11,15,19,23,28,32,37,41,45,49,52,55,57,59,61,62,63,64,65,65,65,66,66,66,66,66
E01030208,EV motorcycles,Number,1,3,5,8,13,17,22,27,32,37,42,47,51,55,59,62,65,67,69,71,72,73,73,74,74,74,75,75,75,75
E01030209,EV motorcycles,Number,1,2,4,7,11,15,19,24,28,33,37,42,46,50,53,56,58,60,62,63,64,65,66,66,66,67,67,67,67,67
E01030210,EV motorcycles,Number,1,2,4,7,11,15,19,23,27,32,36,40,44,48,51,54,56,58,60,61,62,63,64,64,64,65,65,65,65,65
E01030211,EV motorcycles,Number,0,1,2,3,5,7,9,11,13,15,17,19,21,23,24,26,27,28,29,29,30,30,30,31,31,31,31,31,31,31
E01030212,EV motorcycles,Number,2,4,8,13,20,27,34,42,50,59,67,74,81,88,94,99,103,107,110,112,114,115,116,117,118,118,119,119,119,119
E01030214,EV motorcycles,Number,0,1,2,3,5,6,8,10,11,13,15,17,18,20,21,22,23,24,25,25,26,26,26,27,27,27,27,27,27,27
E01030215,EV motorcycles,Number,1,2,4,6,9,13,16,20,24,28,31,35,38,41,44,47,49,50,52,53,54,54,55,55,55,56,56,56,56,56
E01030216,EV motorcycles,Number,1,3,5,8,12,16,21,25,30,35,40,44,49,52,56,59,62,64,66,67,68,69,70,70,70,71,71,71,71,71
E01030217,EV motorcycles,Number,1,4,6,11,16,22,28,34,41,48,54,60,66,72,76,81,84,87,90,92,93,94,95,96,96,96,97,97,97,97
E01030218,EV motorcycles,Number,2,4,7,12,18,24,30,37,44,52,59,65,72,78,83,87,91,94,97,99,101,102,103,103,104,104,105,105,105,105
E01030219,EV motorcycles,Number,1,3,5,8,12,16,21,25,30,35,40,44,49,52,56,59,62,64,66,67,68,69,70,70,70,71,71,71,71,71
E01030220,EV motorcycles,Number,1,3,6,10,16,21,27,33,39,46,52,58,64,69,73,77,81,84,86,88,89,90,91,92,92,92,93,93,93,93
E01030221,EV motorcycles,Number,1,3,5,8,13,17,22,27,32,37,43,47,52,56,60,63,66,68,70,72,73,74,74,75,75,75,76,76,76,76
E01030222,EV motorcycles,Number,1,3,5,9,14,19,24,30,36,41,47,52,57,62,66,70,73,76,78,79,81,82,82,83,83,83,84,84,84,84
E01030223,EV motorcycles,Number,1,1,2,4,6,9,11,13,16,19,21,24,26,28,30,32,33,34,35,36,36,37,37,37,38,38,38,38,38,38
E01030224,EV motorcycles,Number,1,2,3,5,8,11,14,17,20,24,27,30,33,35,38,40,42,43,44,45,46,47,47,47,48,48,48,48,48,48
E01030225,EV motorcycles,Number,0,1,2,4,5,7,9,11,14,16,18,20,22,24,25,27,28,29,30,30,31,31,31,32,32,32,32,32,32,32
E01030226,EV motorcycles,Number,1,2,4,7,11,14,19,23,27,31,36,40,44,47,50,53,56,58,59,60,61,62,63,63,63,64,64,64,64,64
E01030227,EV motorcycles,Number,1,2,3,5,7,10,13,16,19,22,25,27,30,33,35,37,38,40,41,42,42,43,43,43,44,44,44,44,44,44
E01030228,EV motorcycles,Number,1,2,4,7,11,14,19,23,27,31,36,40,44,47,50,53,56,58,59,60,61,62,63,63,63,64,64,64,64,64
E01030229,EV motorcycles,Number,1,2,4,7,11,15,19,23,28,32,37,41,45,49,52,55,57,59,61,62,63,64,65,65,65,66,66,66,66,66
E01030230,EV motorcycles,Number,1,3,5,8,12,16,21,25,30,35,40,44,49,52,56,59,62,64,66,67,68,69,70,70,70,71,71,71,71,71
E01030231,EV motorcycles,Number,1,2,4,7,10,14,18,22,26,30,35,39,42,46,49,52,54,56,57,59,59,60,61,61,61,62,62,62,62,62
E01030232,EV motorcycles,Number,1,2,4,7,11,15,19,23,27,32,36,40,44,48,51,54,56,58,60,61,62,63,64,64,64,65,65,65,65,65
E01030233,EV motorcycles,Number,1,2,4,7,11,14,18,22,27,31,35,39,43,47,50,52,55,57,58,59,60,61,62,62,62,63,63,63,63,63
E01030234,EV motorcycles,Number,1,2,3,6,8,11,14,18,21,25,28,31,34,37,39,42,43,45,46,47,48,49,49,49,49,50,50,50,50,50
E01030235,EV motorcycles,Number,1,2,3,5,8,10,13,16,19,22,25,28,31,33,35,37,39,40,42,42,43,44,44,44,45,45,45,45,45,45
E01030236,EV motorcycles,Number,1,3,6,10,15,20,25,31,37,43,49,54,59,64,69,72,76,78,80,82,83,84,85,86,86,86,87,87,87,87
E01030237,EV motorcycles,Number,1,4,6,11,16,22,28,34,41,48,54,60,66,72,76,81,84,87,90,92,93,94,95,96,96,96,97,97,97,97
E01030238,EV motorcycles,Number,1,1,3,4,7,9,12,14,17,20,22,25,27,30,32,33,35,36,37,38,38,39,39,39,40,40,40,40,40,40
E01030239,EV motorcycles,Number,1,1,3,5,7,9,12,15,17,20,23,26,28,30,32,34,36,37,38,39,39,40,40,40,41,41,41,41,41,41
E01030240,EV motorcycles,Number,1,2,3,5,7,9,12,15,18,21,24,26,29,31,33,35,36,38,39,40,40,41,41,41,42,42,42,42,42,42
E01030241,EV motorcycles,Number,1,2,4,7,11,14,19,23,27,31,36,40,44,47,50,53,56,58,59,60,61,62,63,63,63,64,64,64,64,64
E01030242,EV motorcycles,Number,1,1,2,4,6,8,11,13,16,18,21,23,25,27,29,31,32,33,34,35,35,36,36,36,37,37,37,37,37,37
E01030243,EV motorcycles,Number,1,2,4,7,11,14,19,23,27,31,36,40,44,47,50,53,56,58,59,60,61,62,63,63,63,64,64,64,64,64
E01030244,EV motorcycles,Number,1,2,3,6,8,11,14,18,21,25,28,31,34,37,39,42,43,45,46,47,48,49,49,49,49,50,50,50,50,50
E01030245,EV motorcycles,Number,1,2,3,5,7,10,13,16,19,22,25,27,30,33,35,37,38,40,41,42,42,43,43,43,44,44,44,44,44,44
E01030246,EV motorcycles,Number,0,1,2,3,4,5,7,9,10,12,13,15,16,18,19,20,21,22,22,23,23,23,23,24,24,24,24,24,24,24
E01030247,EV motorcycles,Number,0,1,2,4,6,8,10,12,14,17,19,21,23,25,27,28,30,31,31,32,33,33,33,33,34,34,34,34,34,34
E01030248,EV motorcycles,Number,0,1,2,4,6,8,10,12,14,17,19,21,23,25,27,28,30,31,31,32,33,33,33,33,34,34,34,34,34,34
E01030249,EV motorcycles,Number,1,1,2,4,6,9,11,13,16,19,21,24,26,28,30,32,33,34,35,36,36,37,37,37,38,38,38,38,38,38
E01030250,EV motorcycles,Number,1,2,4,7,10,14,18,22,26,30,35,39,42,46,49,52,54,56,57,59,59,60,61,61,61,62,62,62,62,62
E01030251,EV motorcycles,Number,1,2,4,7,10,13,17,21,25,29,33,37,40,44,47,49,51,53,55,56,57,57,58,58,58,59,59,59,59,59
E01030252,EV motorcycles,Number,1,3,6,9,14,19,25,30,36,42,48,53,58,63,67,71,74,76,79,80,82,82,83,84,84,84,85,85,85,85
E01030253,EV motorcycles,Number,1,3,5,9,14,19,24,29,35,41,46,52,57,61,65,69,72,75,77,78,80,81,81,82,82,82,83,83,83,83
E01030254,EV motorcycles,Number,0,1,1,2,4,5,6,8,9,11,12,14,15,16,17,18,19,20,20,21,21,21,22,22,22,22,22,22,22,22
E01030255,EV motorcycles,Number,1,2,3,5,7,9,12,15,18,21,24,26,29,31,33,35,36,38,39,40,40,41,41,41,42,42,42,42,42,42
E01030256,EV motorcycles,Number,1,2,3,5,7,10,13,16,19,22,25,27,30,33,35,37,38,40,41,42,42,43,43,43,44,44,44,44,44,44
E01030257,EV motorcycles,Number,1,1,2,4,6,8,10,12,15,17,20,22,24,26,28,29,30,31,32,33,34,34,34,34,35,35,35,35,35,35
E01030258,EV motorcycles,Number,0,1,1,2,2,3,4,5,6,7,8,9,10,10,11,12,12,13,13,13,13,14,14,14,14,14,14,14,14,14
E01030259,EV motorcycles,Number,1,1,3,4,7,9,11,14,16,19,22,24,27,29,31,32,34,35,36,37,37,38,38,38,39,39,39,39,39,39
E01030260,EV motorcycles,Number,1,2,3,6,8,11,14,18,21,25,28,31,34,37,39,42,43,45,46,47,48,49,49,49,49,50,50,50,50,50
E01030261,EV motorcycles,Number,0,1,2,3,4,6,8,9,11,13,15,16,18,19,20,22,23,23,24,25,25,25,25,26,26,26,26,26,26,26
E01030262,EV motorcycles,Number,1,2,3,5,7,9,12,15,18,21,24,26,29,31,33,35,36,38,39,40,40,41,41,41,42,42,42,42,42,42
E01030263,EV motorcycles,Number,1,2,3,6,9,12,15,19,22,26,30,33,36,39,42,44,46,48,49,50,51,51,52,52,52,53,53,53,53,53
E01030264,EV motorcycles,Number,0,1,2,4,6,8,10,12,14,17,19,21,23,25,27,28,30,31,31,32,33,33,33,33,34,34,34,34,34,34
E01030265,EV motorcycles,Number,0,1,2,3,5,7,9,11,13,15,17,19,21,23,24,26,27,28,29,29,30,30,30,31,31,31,31,31,31,31
E01030266,EV motorcycles,Number,1,2,4,6,10,13,17,21,25,29,32,36,40,43,46,48,50,52,54,55,56,56,57,57,57,58,58,58,58,58
E01030267,EV motorcycles,Number,1,3,5,8,13,17,22,27,32,37,42,47,51,55,59,62,65,67,69,71,72,73,73,74,74,74,75,75,75,75
E01030268,EV motorcycles,Number,1,2,4,7,11,14,18,22,27,31,35,39,43,47,50,52,55,57,58,59,60,61,62,62,62,63,63,63,63,63
E01030269,EV motorcycles,Number,1,2,5,8,12,15,20,25,29,34,39,43,47,51,54,57,60,62,64,65,66,67,68,68,68,69,69,69,69,69
E01030270,EV motorcycles,Number,1,2,3,6,8,11,14,18,21,25,28,31,34,37,39,42,43,45,46,47,48,49,49,49,49,50,50,50,50,50
E01030271,EV motorcycles,Number,1,1,3,5,7,9,12,15,17,20,23,26,28,30,32,34,36,37,38,39,39,40,40,40,41,41,41,41,41,41
E01030272,EV motorcycles,Number,0,1,2,3,4,5,7,8,10,11,13,14,16,17,18,19,20,21,21,22,22,22,23,23,23,23,23,23,23,23
E01030273,EV motorcycles,Number,1,1,2,4,6,8,10,12,15,17,20,22,24,26,28,29,30,31,32,33,34,34,34,34,35,35,35,35,35,35
E01030274,EV motorcycles,Number,0,1,2,3,5,6,8,10,12,14,16,17,19,21,22,23,24,25,26,26,27,27,27,28,28,28,28,28,28,28
E01030275,EV motorcycles,Number,0,1,2,3,4,6,8,9,11,13,15,16,18,19,20,22,23,23,24,25,25,25,25,26,26,26,26,26,26,26
E01030276,EV motorcycles,Number,0,1,1,2,3,4,5,6,8,9,10,11,12,13,14,15,16,16,17,17,17,17,18,18,18,18,18,18,18,18
E01030277,EV motorcycles,Number,0,1,2,3,5,7,9,11,13,15,17,19,21,22,24,25,26,27,28,28,29,29,29,30,30,30,30,30,30,30
E01030278,EV motorcycles,Number,1,2,3,5,8,10,13,16,19,22,25,28,31,33,35,37,39,40,42,42,43,44,44,44,45,45,45,45,45,45
E01030279,EV motorcycles,Number,0,1,2,3,5,7,9,11,13,15,17,19,21,23,24,26,27,28,29,29,30,30,30,31,31,31,31,31,31,31
E01030280,EV motorcycles,Number,0,1,2,4,5,7,9,11,14,16,18,20,22,24,25,27,28,29,30,30,31,31,31,32,32,32,32,32,32,32
E01030281,EV motorcycles,Number,1,3,5,8,13,17,22,27,33,38,43,48,53,57,61,64,67,69,71,73,74,75,75,76,76,76,77,77,77,77
E01030282,EV motorcycles,Number,0,1,1,2,2,3,4,5,6,7,8,9,10,10,11,12,12,13,13,13,13,14,14,14,14,14,14,14,14,14
E01030283,EV motorcycles,Number,0,1,2,4,6,8,10,12,14,17,19,21,23,25,27,28,30,31,31,32,33,33,33,33,34,34,34,34,34,34
E01030284,EV motorcycles,Number,1,1,3,5,7,9,12,15,17,20,23,26,28,30,32,34,36,37,38,39,39,40,40,40,41,41,41,41,41,41
E01030285,EV motorcycles,Number,1,3,6,10,16,21,27,34,40,47,53,59,65,70,75,79,83,85,88,90,91,92,93,94,94,94,95,95,95,95
E01030286,EV motorcycles,Number,1,3,6,10,15,20,26,32,38,44,50,55,61,66,70,74,77,80,82,84,85,86,87,88,88,88,89,89,89,89
E01030287,EV motorcycles,Number,0,1,2,4,6,7,10,12,14,16,18,21,23,24,26,27,29,30,31,31,32,32,32,33,33,33,33,33,33,33
E01030288,EV motorcycles,Number,1,2,3,5,8,10,13,16,19,22,25,28,31,33,35,37,39,40,42,42,43,44,44,44,45,45,45,45,45,45
E01030289,EV motorcycles,Number,1,1,3,5,7,9,12,15,17,20,23,26,28,30,32,34,36,37,38,39,39,40,40,40,41,41,41,41,41,41
E01030290,EV motorcycles,Number,1,2,4,6,9,12,16,20,23,27,31,34,38,41,43,46,48,49,51,52,53,53,54,54,54,55,55,55,55,55
E01030291,EV motorcycles,Number,0,1,2,3,5,7,8,10,12,14,16,18,20,21,23,24,25,26,27,27,28,28,28,29,29,29,29,29,29,29
E01030292,EV motorcycles,Number,1,2,3,5,7,9,12,15,18,21,24,26,29,31,33,35,36,38,39,40,40,41,41,41,42,42,42,42,42,42
E01030293,EV motorcycles,Number,1,3,5,9,13,18,23,28,33,38,44,49,53,58,61,65,68,70,72,74,75,76,76,77,77,77,78,78,78,78
E01030294,EV motorcycles,Number,1,1,2,4,6,8,11,13,16,18,21,23,25,27,29,31,32,33,34,35,35,36,36,36,37,37,37,37,37,37
E01030295,EV motorcycles,Number,2,4,8,13,20,27,35,43,51,60,68,75,83,89,95,101,105,109,112,114,116,117,118,119,120,120,121,121,121,121
E01030296,EV motorcycles,Number,1,2,3,5,7,10,13,16,19,22,25,27,30,33,35,37,38,40,41,42,42,43,43,43,44,44,44,44,44,44
E01030297,EV motorcycles,Number,1,1,2,4,6,8,10,13,15,18,20,22,25,27,28,30,31,32,33,34,35,35,35,35,36,36,36,36,36,36
E01030298,EV motorcycles,Number,0,1,2,4,6,7,10,12,14,16,18,21,23,24,26,27,29,30,31,31,32,32,32,33,33,33,33,33,33,33
E01030299,EV motorcycles,Number,0,1,2,3,4,6,7,9,11,12,14,16,17,18,20,21,22,22,23,24,24,24,24,25,25,25,25,25,25,25
E01030300,EV motorcycles,Number,1,1,2,4,6,8,10,13,15,18,20,22,25,27,28,30,31,32,33,34,35,35,35,35,36,36,36,36,36,36
E01030301,EV motorcycles,Number,1,1,2,4,6,8,10,13,15,18,20,22,25,27,28,30,31,32,33,34,35,35,35,35,36,36,36,36,36,36
E01030302,EV motorcycles,Number,1,2,3,5,7,10,12,15,18,21,24,27,29,32,34,36,37,39,40,41,41,42,42,42,43,43,43,43,43,43
E01030303,EV motorcycles,Number,1,1,2,4,6,9,11,13,16,19,21,24,26,28,30,32,33,34,35,36,36,37,37,37,38,38,38,38,38,38
E01030304,EV motorcycles,Number,0,1,2,3,5,7,8,10,12,14,16,18,20,21,23,24,25,26,27,27,28,28,28,29,29,29,29,29,29,29
E01030305,EV motorcycles,Number,0,1,1,2,3,4,5,6,8,9,10,11,12,13,14,15,16,16,17,17,17,17,18,18,18,18,18,18,18,18
E01030306,EV motorcycles,Number,1,2,3,6,8,11,14,18,21,25,28,31,34,37,39,42,43,45,46,47,48,49,49,49,49,50,50,50,50,50
E01030307,EV motorcycles,Number,1,2,4,7,11,14,18,22,27,31,35,39,43,47,50,52,55,57,58,59,60,61,62,62,62,63,63,63,63,63
E01030308,EV motorcycles,Number,0,1,2,4,5,7,9,11,14,16,18,20,22,24,25,27,28,29,30,30,31,31,31,32,32,32,32,32,32,32
E01030309,EV motorcycles,Number,0,1,2,3,4,6,8,9,11,13,15,16,18,19,20,22,23,23,24,25,25,25,25,26,26,26,26,26,26,26
E01030310,EV motorcycles,Number,1,2,4,6,9,12,16,20,23,27,31,34,38,41,43,46,48,49,51,52,53,53,54,54,54,55,55,55,55,55
E01030311,EV motorcycles,Number,1,2,3,5,7,10,13,16,19,22,25,27,30,33,35,37,38,40,41,42,42,43,43,43,44,44,44,44,44,44
E01030312,EV motorcycles,Number,1,1,3,4,7,9,12,14,17,20,22,25,27,30,32,33,35,36,37,38,38,39,39,39,40,40,40,40,40,40
E01030313,EV motorcycles,Number,1,2,3,5,7,10,12,15,18,21,24,27,29,32,34,36,37,39,40,41,41,42,42,42,43,43,43,43,43,43
E01030314,EV motorcycles,Number,0,1,2,3,4,6,8,9,11,13,15,16,18,19,20,22,23,23,24,25,25,25,25,26,26,26,26,26,26,26
E01030315,EV motorcycles,Number,1,2,4,6,9,12,16,20,23,27,31,34,38,41,43,46,48,49,51,52,53,53,54,54,54,55,55,55,55,55
E01030316,EV motorcycles,Number,0,1,2,3,4,5,7,9,10,12,13,15,16,18,19,20,21,22,22,23,23,23,23,24,24,24,24,24,24,24
E01030317,EV motorcycles,Number,0,1,2,4,6,8,10,12,14,17,19,21,23,25,27,28,30,31,31,32,33,33,33,33,34,34,34,34,34,34
E01030318,EV motorcycles,Number,0,1,1,2,3,4,5,6,8,9,10,11,12,13,14,15,16,16,17,17,17,17,18,18,18,18,18,18,18,18
E01030319,EV motorcycles,Number,1,2,3,6,8,11,14,18,21,25,28,31,34,37,39,42,43,45,46,47,48,49,49,49,49,50,50,50,50,50
E01030320,EV motorcycles,Number,1,2,4,6,10,13,17,21,25,29,32,36,40,43,46,48,50,52,54,55,56,56,57,57,57,58,58,58,58,58
E01030321,EV motorcycles,Number,1,1,2,4,6,8,10,13,15,18,20,22,25,27,28,30,31,32,33,34,35,35,35,35,36,36,36,36,36,36
E01030322,EV motorcycles,Number,0,1,2,4,6,7,10,12,14,16,18,21,23,24,26,27,29,30,31,31,32,32,32,33,33,33,33,33,33,33
E01030323,EV motorcycles,Number,0,1,2,4,6,7,10,12,14,16,18,21,23,24,26,27,29,30,31,31,32,32,32,33,33,33,33,33,33,33
E01030324,EV motorcycles,Number,0,1,2,4,6,7,10,12,14,16,18,21,23,24,26,27,29,30,31,31,32,32,32,33,33,33,33,33,33,33
E01030325,EV motorcycles,Number,1,2,3,6,8,11,14,18,21,25,28,31,34,37,39,42,43,45,46,47,48,49,49,49,49,50,50,50,50,50
E01030326,EV motorcycles,Number,1,1,3,4,7,9,12,14,17,20,22,25,27,30,32,33,35,36,37,38,38,39,39,39,40,40,40,40,40,40
E01030327,EV motorcycles,Number,0,1,2,3,5,7,9,11,13,15,17,19,21,22,24,25,26,27,28,28,29,29,29,30,30,30,30,30,30,30
E01030328,EV motorcycles,Number,0,1,2,4,6,8,10,12,14,17,19,21,23,25,27,28,30,31,31,32,33,33,33,33,34,34,34,34,34,34
E01030329,EV motorcycles,Number,1,2,3,5,7,10,13,16,19,22,25,27,30,33,35,37,38,40,41,42,42,43,43,43,44,44,44,44,44,44
E01030330,EV motorcycles,Number,1,2,4,6,10,13,17,21,25,29,32,36,40,43,46,48,50,52,54,55,56,56,57,57,57,58,58,58,58,58
E01030331,EV motorcycles,Number,1,2,3,5,8,11,14,17,20,23,26,29,32,35,37,39,41,42,43,44,45,46,46,46,47,47,47,47,47,47
E01030332,EV motorcycles,Number,0,1,2,3,5,7,9,11,13,15,17,19,21,23,24,26,27,28,29,29,30,30,30,31,31,31,31,31,31,31
E01030333,EV motorcycles,Number,1,1,3,4,7,9,12,14,17,20,22,25,27,30,32,33,35,36,37,38,38,39,39,39,40,40,40,40,40,40
E01030334,EV motorcycles,Number,0,1,2,3,5,7,9,11,13,15,17,19,21,22,24,25,26,27,28,28,29,29,29,30,30,30,30,30,30,30
E01030335,EV motorcycles,Number,1,3,5,8,13,17,22,27,32,37,43,47,52,56,60,63,66,68,70,72,73,74,74,75,75,75,76,76,76,76
E01030336,EV motorcycles,Number,1,3,5,8,13,17,22,27,32,37,42,47,51,55,59,62,65,67,69,71,72,73,73,74,74,74,75,75,75,75
E01030337,EV motorcycles,Number,1,1,2,4,6,9,11,13,16,19,21,24,26,28,30,32,33,34,35,36,36,37,37,37,38,38,38,38,38,38
E01030338,EV motorcycles,Number,0,1,2,3,5,7,9,11,13,15,17,19,21,23,24,26,27,28,29,29,30,30,30,31,31,31,31,31,31,31
E01030339,EV motorcycles,Number,0,1,2,3,5,7,9,11,13,15,17,19,21,23,24,26,27,28,29,29,30,30,30,31,31,31,31,31,31,31
E01030340,EV motorcycles,Number,0,1,1,2,4,5,6,8,9,11,12,14,15,16,17,18,19,20,20,21,21,21,22,22,22,22,22,22,22,22
E01030341,EV motorcycles,Number,1,1,2,4,6,8,10,13,15,18,20,22,25,27,28,30,31,32,33,34,35,35,35,35,36,36,36,36,36,36
E01030342,EV motorcycles,Number,1,1,2,4,6,9,11,13,16,19,21,24,26,28,30,32,33,34,35,36,36,37,37,37,38,38,38,38,38,38
E01030343,EV motorcycles,Number,1,1,2,4,6,8,10,12,15,17,20,22,24,26,28,29,30,31,32,33,34,34,34,34,35,35,35,35,35,35
E01030344,EV motorcycles,Number,0,1,1,2,4,5,6,7,9,10,12,13,14,16,17,17,18,19,19,20,20,20,21,21,21,21,21,21,21,21
E01030345,EV motorcycles,Number,1,2,3,5,7,9,12,15,18,21,24,26,29,31,33,35,36,38,39,40,40,41,41,41,42,42,42,42,42,42
E01030346,EV motorcycles,Number,0,1,2,4,5,7,9,11,14,16,18,20,22,24,25,27,28,29,30,30,31,31,31,32,32,32,32,32,32,32
E01030347,EV motorcycles,Number,1,2,3,5,8,11,14,17,20,23,26,29,32,35,37,39,41,42,43,44,45,46,46,46,47,47,47,47,47,47
E01030348,EV motorcycles,Number,0,1,2,3,4,6,8,9,11,13,15,16,18,19,20,22,23,23,24,25,25,25,25,26,26,26,26,26,26,26
E01030349,EV motorcycles,Number,1,2,4,7,11,15,19,23,28,32,37,41,45,49,52,55,57,59,61,62,63,64,65,65,65,66,66,66,66,66
E01030350,EV motorcycles,Number,0,1,2,4,5,7,9,11,14,16,18,20,22,24,25,27,28,29,30,30,31,31,31,32,32,32,32,32,32,32
E01030351,EV motorcycles,Number,0,1,2,3,5,7,9,11,13,15,17,19,21,23,24,26,27,28,29,29,30,30,30,31,31,31,31,31,31,31
E01030352,EV motorcycles,Number,0,1,2,3,4,5,7,8,10,11,13,14,16,17,18,19,20,21,21,22,22,22,23,23,23,23,23,23,23,23
E01030353,EV motorcycles,Number,0,1,1,2,3,4,6,7,8,10,11,12,14,15,16,17,17,18,18,19,19,19,20,20,20,20,20,20,20,20
E01030354,EV motorcycles,Number,1,1,2,4,6,8,11,13,16,18,21,23,25,27,29,31,32,33,34,35,35,36,36,36,37,37,37,37,37,37
E01030355,EV motorcycles,Number,0,1,2,4,6,7,10,12,14,16,18,21,23,24,26,27,29,30,31,31,32,32,32,33,33,33,33,33,33,33
E01030356,EV motorcycles,Number,0,1,2,3,5,7,9,11,13,15,17,19,21,22,24,25,26,27,28,28,29,29,29,30,30,30,30,30,30,30
E01030357,EV motorcycles,Number,0,1,2,4,6,8,10,12,14,17,19,21,23,25,27,28,30,31,31,32,33,33,33,33,34,34,34,34,34,34
E01030358,EV motorcycles,Number,1,2,3,5,7,10,12,15,18,21,24,27,29,32,34,36,37,39,40,41,41,42,42,42,43,43,43,43,43,43
E01030359,EV motorcycles,Number,1,1,2,4,6,9,11,13,16,19,21,24,26,28,30,32,33,34,35,36,36,37,37,37,38,38,38,38,38,38
E01030360,EV motorcycles,Number,0,1,2,3,5,7,9,11,13,15,17,19,21,23,24,26,27,28,29,29,30,30,30,31,31,31,31,31,31,31
E01030361,EV motorcycles,Number,1,2,3,5,8,11,14,17,21,24,27,31,33,36,39,41,43,44,45,46,47,48,48,48,48,49,49,49,49,49
E01030362,EV motorcycles,Number,1,1,3,4,7,9,11,14,16,19,22,24,27,29,31,32,34,35,36,37,37,38,38,38,39,39,39,39,39,39
E01030363,EV motorcycles,Number,1,2,4,6,10,13,16,20,24,28,32,35,39,42,45,47,50,51,53,54,55,55,56,56,56,57,57,57,57,57
E01030364,EV motorcycles,Number,1,2,4,6,9,12,16,20,23,27,31,34,38,41,43,46,48,49,51,52,53,53,54,54,54,55,55,55,55,55
E01030365,EV motorcycles,Number,1,1,3,4,7,9,11,14,16,19,22,24,27,29,31,32,34,35,36,37,37,38,38,38,39,39,39,39,39,39
E01030366,EV motorcycles,Number,1,2,3,5,7,10,12,15,18,21,24,27,29,32,34,36,37,39,40,41,41,42,42,42,43,43,43,43,43,43
E01030367,EV motorcycles,Number,1,1,3,4,7,9,12,14,17,20,22,25,27,30,32,33,35,36,37,38,38,39,39,39,40,40,40,40,40,40
E01030368,EV motorcycles,Number,0,1,1,2,3,4,5,7,8,9,11,12,13,14,15,16,17,17,18,18,18,18,19,19,19,19,19,19,19,19
E01030369,EV motorcycles,Number,1,1,2,4,6,8,11,13,16,18,21,23,25,27,29,31,32,33,34,35,35,36,36,36,37,37,37,37,37,37
E01030370,EV motorcycles,Number,1,2,3,5,7,9,12,15,18,21,24,26,29,31,33,35,36,38,39,40,40,41,41,41,42,42,42,42,42,42
E01030371,EV motorcycles,Number,0,1,2,3,4,6,8,9,11,13,15,16,18,19,20,22,23,23,24,25,25,25,25,26,26,26,26,26,26,26
E01030372,EV motorcycles,Number,0,1,2,3,4,5,7,8,10,11,13,14,16,17,18,19,20,21,21,22,22,22,23,23,23,23,23,23,23,23
E01030373,EV motorcycles,Number,0,1,2,4,6,7,10,12,14,16,18,21,23,24,26,27,29,30,31,31,32,32,32,33,33,33,33,33,33,33
E01030374,EV motorcycles,Number,0,1,2,3,5,6,8,10,12,14,16,17,19,21,22,23,24,25,26,26,27,27,27,28,28,28,28,28,28,28
E01030375,EV motorcycles,Number,0,1,2,3,4,6,7,9,11,12,14,16,17,18,20,21,22,22,23,24,24,24,24,25,25,25,25,25,25,25
E01030376,EV motorcycles,Number,0,1,1,2,3,4,5,7,8,9,11,12,13,14,15,16,17,17,18,18,18,18,19,19,19,19,19,19,19,19
E01030377,EV motorcycles,Number,1,2,3,6,9,11,15,18,22,25,29,32,35,38,40,42,44,46,47,48,49,49,50,50,50,51,51,51,51,51
E01030378,EV motorcycles,Number,1,2,3,5,7,9,12,15,18,21,24,26,29,31,33,35,36,38,39,40,40,41,41,41,42,42,42,42,42,42
E01030379,EV motorcycles,Number,0,1,1,2,3,4,5,6,7,8,10,11,12,13,13,14,15,15,16,16,16,16,17,17,17,17,17,17,17,17
E01030380,EV motorcycles,Number,1,1,3,4,7,9,12,14,17,20,22,25,27,30,32,33,35,36,37,38,38,39,39,39,40,40,40,40,40,40
E01030381,EV motorcycles,Number,0,1,2,3,4,6,7,9,11,12,14,16,17,18,20,21,22,22,23,24,24,24,24,25,25,25,25,25,25,25
E01030382,EV motorcycles,Number,0,1,2,4,5,7,9,11,14,16,18,20,22,24,25,27,28,29,30,30,31,31,31,32,32,32,32,32,32,32
E01030383,EV motorcycles,Number,1,2,3,6,9,12,15,18,22,26,29,32,36,38,41,43,45,47,48,49,50,50,51,51,51,52,52,52,52,52
E01030384,EV motorcycles,Number,1,2,4,6,10,13,17,21,25,29,32,36,40,43,46,48,50,52,54,55,56,56,57,57,57,58,58,58,58,58
E01030385,EV motorcycles,Number,1,1,2,4,6,8,11,13,16,18,21,23,25,27,29,31,32,33,34,35,35,36,36,36,37,37,37,37,37,37
E01030386,EV motorcycles,Number,0,1,2,4,6,8,10,12,14,17,19,21,23,25,27,28,30,31,31,32,33,33,33,33,34,34,34,34,34,34
E01030387,EV motorcycles,Number,0,1,1,2,3,4,6,7,8,10,11,12,14,15,16,17,17,18,18,19,19,19,20,20,20,20,20,20,20,20
E01030388,EV motorcycles,Number,1,1,2,4,6,8,10,13,15,18,20,22,25,27,28,30,31,32,33,34,35,35,35,35,36,36,36,36,36,36
E01030389,EV motorcycles,Number,0,1,2,4,5,7,9,11,14,16,18,20,22,24,25,27,28,29,30,30,31,31,31,32,32,32,32,32,32,32
E01030390,EV motorcycles,Number,1,1,3,4,7,9,12,14,17,20,22,25,27,30,32,33,35,36,37,38,38,39,39,39,40,40,40,40,40,40
E01030391,EV motorcycles,Number,0,1,2,4,5,7,9,11,14,16,18,20,22,24,25,27,28,29,30,30,31,31,31,32,32,32,32,32,32,32
E01030392,EV motorcycles,Number,0,1,2,4,6,7,10,12,14,16,18,21,23,24,26,27,29,30,31,31,32,32,32,33,33,33,33,33,33,33
E01030393,EV motorcycles,Number,1,2,3,6,9,12,15,19,22,26,30,33,36,39,42,44,46,48,49,50,51,51,52,52,52,53,53,53,53,53
E01030394,EV motorcycles,Number,1,2,3,5,8,10,13,16,19,22,25,28,31,33,35,37,39,40,42,42,43,44,44,44,45,45,45,45,45,45
E01030395,EV motorcycles,Number,1,1,2,4,6,8,11,13,16,18,21,23,25,27,29,31,32,33,34,35,35,36,36,36,37,37,37,37,37,37
E01030396,EV motorcycles,Number,1,2,4,7,10,13,17,21,25,29,33,37,40,44,47,49,51,53,55,56,57,57,58,58,58,59,59,59,59,59
E01030398,EV motorcycles,Number,0,1,1,2,4,5,6,7,9,10,12,13,14,16,17,17,18,19,19,20,20,20,21,21,21,21,21,21,21,21
E01030399,EV motorcycles,Number,1,2,4,7,11,15,19,24,28,33,37,42,46,50,53,56,58,60,62,63,64,65,66,66,66,67,67,67,67,67
E01030400,EV motorcycles,Number,0,1,2,3,4,5,7,8,10,11,13,14,16,17,18,19,20,21,21,22,22,22,23,23,23,23,23,23,23,23
E01030401,EV motorcycles,Number,1,2,4,7,10,13,17,21,25,29,33,37,40,44,47,49,51,53,55,56,57,57,58,58,58,59,59,59,59,59
E01030402,EV motorcycles,Number,1,2,3,5,8,11,14,17,20,23,26,29,32,35,37,39,41,42,43,44,45,46,46,46,47,47,47,47,47,47
E01030403,EV motorcycles,Number,0,1,2,3,4,6,8,9,11,13,15,16,18,19,20,22,23,23,24,25,25,25,25,26,26,26,26,26,26,26
E01030404,EV motorcycles,Number,1,1,2,4,6,9,11,13,16,19,21,24,26,28,30,32,33,34,35,36,36,37,37,37,38,38,38,38,38,38
E01030405,EV motorcycles,Number,1,2,4,6,9,12,16,19,23,27,30,34,37,40,43,45,47,49,50,51,52,52,53,53,53,54,54,54,54,54
E01030406,EV motorcycles,Number,0,1,2,4,5,7,9,11,14,16,18,20,22,24,25,27,28,29,30,30,31,31,31,32,32,32,32,32,32,32
E01030407,EV motorcycles,Number,0,1,2,3,4,5,7,9,10,12,13,15,16,18,19,20,21,22,22,23,23,23,23,24,24,24,24,24,24,24
E01030408,EV motorcycles,Number,0,1,1,2,3,4,6,7,8,10,11,12,14,15,16,17,17,18,18,19,19,19,20,20,20,20,20,20,20,20
E01030409,EV motorcycles,Number,0,1,2,4,6,8,10,12,14,17,19,21,23,25,27,28,30,31,31,32,33,33,33,33,34,34,34,34,34,34
E01030410,EV motorcycles,Number,0,1,2,3,5,7,9,11,13,15,17,19,21,22,24,25,26,27,28,28,29,29,29,30,30,30,30,30,30,30
E01030411,EV motorcycles,Number,1,2,3,5,8,11,14,17,21,24,27,31,33,36,39,41,43,44,45,46,47,48,48,48,48,49,49,49,49,49
E01030412,EV motorcycles,Number,1,1,3,5,7,9,12,15,17,20,23,26,28,30,32,34,36,37,38,39,39,40,40,40,41,41,41,41,41,41
E01030413,EV motorcycles,Number,1,3,5,8,12,17,21,26,31,36,41,46,51,55,58,62,64,67,68,70,71,72,72,73,73,73,74,74,74,74
E01030414,EV motorcycles,Number,1,2,3,5,7,10,13,16,19,22,25,27,30,33,35,37,38,40,41,42,42,43,43,43,44,44,44,44,44,44
E01030415,EV motorcycles,Number,0,1,2,3,5,7,9,11,13,15,17,19,21,23,24,26,27,28,29,29,30,30,30,31,31,31,31,31,31,31
E01030416,EV motorcycles,Number,0,1,2,3,5,7,9,11,13,15,17,19,21,23,24,26,27,28,29,29,30,30,30,31,31,31,31,31,31,31
E01030417,EV motorcycles,Number,0,1,2,3,4,5,7,8,10,11,13,14,16,17,18,19,20,21,21,22,22,22,23,23,23,23,23,23,23,23
E01030418,EV motorcycles,Number,1,2,3,5,8,10,13,16,19,23,26,29,31,34,36,38,40,41,43,43,44,45,45,45,46,46,46,46,46,46
E01030419,EV motorcycles,Number,0,1,2,4,5,7,9,11,14,16,18,20,22,24,25,27,28,29,30,30,31,31,31,32,32,32,32,32,32,32
E01030420,EV motorcycles,Number,0,1,2,3,4,5,7,8,10,11,13,14,16,17,18,19,20,21,21,22,22,22,23,23,23,23,23,23,23,23
E01030434,EV motorcycles,Number,0,1,1,2,4,5,6,8,9,11,12,14,15,16,17,18,19,20,20,21,21,21,22,22,22,22,22,22,22,22
E01030435,EV motorcycles,Number,0,1,2,3,5,7,9,11,13,15,17,19,21,23,24,26,27,28,29,29,30,30,30,31,31,31,31,31,31,31
E01030436,EV motorcycles,Number,1,2,3,5,8,11,14,17,20,23,26,29,32,35,37,39,41,42,43,44,45,46,46,46,47,47,47,47,47,47
E01030437,EV motorcycles,Number,1,2,3,5,7,10,12,15,18,21,24,27,29,32,34,36,37,39,40,41,41,42,42,42,43,43,43,43,43,43
E01030438,EV motorcycles,Number,1,2,3,5,7,9,12,15,18,21,24,26,29,31,33,35,36,38,39,40,40,41,41,41,42,42,42,42,42,42
E01030439,EV motorcycles,Number,0,1,2,3,5,7,8,10,12,14,16,18,20,21,23,24,25,26,27,27,28,28,28,29,29,29,29,29,29,29
E01030440,EV motorcycles,Number,1,2,4,6,9,12,16,20,23,27,31,34,38,41,43,46,48,49,51,52,53,53,54,54,54,55,55,55,55,55
E01030441,EV motorcycles,Number,1,1,3,4,7,9,12,14,17,20,22,25,27,30,32,33,35,36,37,38,38,39,39,39,40,40,40,40,40,40
E01030442,EV motorcycles,Number,0,1,2,3,4,6,8,9,11,13,15,16,18,19,20,22,23,23,24,25,25,25,25,26,26,26,26,26,26,26
E01030443,EV motorcycles,Number,0,1,1,2,4,5,6,8,9,11,12,14,15,16,17,18,19,20,20,21,21,21,22,22,22,22,22,22,22,22
E01030444,EV motorcycles,Number,1,2,3,6,9,11,15,18,22,25,29,32,35,38,40,42,44,46,47,48,49,49,50,50,50,51,51,51,51,51
E01030445,EV motorcycles,Number,0,1,1,2,3,4,5,6,7,8,10,11,12,13,13,14,15,15,16,16,16,16,17,17,17,17,17,17,17,17
E01030446,EV motorcycles,Number,1,2,3,6,9,11,15,18,22,25,29,32,35,38,40,42,44,46,47,48,49,49,50,50,50,51,51,51,51,51
E01030447,EV motorcycles,Number,1,1,2,4,6,9,11,13,16,19,21,24,26,28,30,32,33,34,35,36,36,37,37,37,38,38,38,38,38,38
E01030448,EV motorcycles,Number,0,1,2,3,4,5,7,8,10,11,13,14,16,17,18,19,20,21,21,22,22,22,23,23,23,23,23,23,23,23
E01030449,EV motorcycles,Number,0,1,1,2,3,4,5,6,7,8,10,11,12,13,13,14,15,15,16,16,16,16,17,17,17,17,17,17,17,17
E01030450,EV motorcycles,Number,1,2,3,5,7,10,12,15,18,21,24,27,29,32,34,36,37,39,40,41,41,42,42,42,43,43,43,43,43,43
E01030451,EV motorcycles,Number,0,1,2,3,5,6,8,10,12,14,16,17,19,21,22,23,24,25,26,26,27,27,27,28,28,28,28,28,28,28
E01030452,EV motorcycles,Number,0,1,2,4,5,7,9,11,14,16,18,20,22,24,25,27,28,29,30,30,31,31,31,32,32,32,32,32,32,32
E01030453,EV motorcycles,Number,1,2,3,5,7,10,12,15,18,21,24,27,29,32,34,36,37,39,40,41,41,42,42,42,43,43,43,43,43,43
E01030454,EV motorcycles,Number,1,1,2,4,6,9,11,13,16,19,21,24,26,28,30,32,33,34,35,36,36,37,37,37,38,38,38,38,38,38
E01030455,EV motorcycles,Number,1,1,2,4,6,8,11,13,16,18,21,23,25,27,29,31,32,33,34,35,35,36,36,36,37,37,37,37,37,37
E01030456,EV motorcycles,Number,1,1,3,4,7,9,12,14,17,20,22,25,27,30,32,33,35,36,37,38,38,39,39,39,40,40,40,40,40,40
E01030457,EV motorcycles,Number,0,1,2,3,4,5,7,9,10,12,13,15,16,18,19,20,21,22,22,23,23,23,23,24,24,24,24,24,24,24
E01030458,EV motorcycles,Number,1,2,3,6,8,11,14,18,21,25,28,31,34,37,39,42,43,45,46,47,48,49,49,49,49,50,50,50,50,50
E01030459,EV motorcycles,Number,1,2,3,5,7,10,13,16,19,22,25,27,30,33,35,37,38,40,41,42,42,43,43,43,44,44,44,44,44,44
E01030460,EV motorcycles,Number,1,1,2,4,6,8,10,12,15,17,20,22,24,26,28,29,30,31,32,33,34,34,34,34,35,35,35,35,35,35
E01030461,EV motorcycles,Number,1,2,4,6,10,13,17,21,25,29,32,36,40,43,46,48,50,52,54,55,56,56,57,57,57,58,58,58,58,58
E01030462,EV motorcycles,Number,0,1,1,2,4,5,6,8,9,11,12,14,15,16,17,18,19,20,20,21,21,21,22,22,22,22,22,22,22,22
E01030463,EV motorcycles,Number,1,1,3,5,7,9,12,15,17,20,23,26,28,30,32,34,36,37,38,39,39,40,40,40,41,41,41,41,41,41
E01030464,EV motorcycles,Number,1,2,3,5,8,10,13,16,19,23,26,29,31,34,36,38,40,41,43,43,44,45,45,45,46,46,46,46,46,46
E01030466,EV motorcycles,Number,0,1,1,2,3,4,5,6,7,8,10,11,12,13,13,14,15,15,16,16,16,17,17,17,17,17,17,17,17,17
E01030467,EV motorcycles,Number,1,1,3,4,7,9,12,14,17,20,22,25,27,30,32,33,35,36,37,38,38,39,39,39,40,40,40,40,40,40
E01030468,EV motorcycles,Number,0,0,1,1,2,3,3,4,5,6,7,7,8,9,9,10,10,11,11,11,12,12,12,12,12,12,12,12,12,12
E01030469,EV motorcycles,Number,0,1,2,3,5,6,8,10,12,14,16,17,19,21,22,23,24,25,26,26,27,27,27,28,28,28,28,28,28,28
E01030470,EV motorcycles,Number,0,1,1,2,3,4,5,6,7,8,10,11,12,13,13,14,15,15,16,16,16,16,17,17,17,17,17,17,17,17
E01030471,EV motorcycles,Number,0,0,0,0,0,0,0,0,0,0,0,0,0,0,0,0,0,0,0,0,0,0,0,0,0,0,0,0,0,0
E01030473,EV motorcycles,Number,1,2,4,6,9,13,16,20,24,28,31,35,38,41,44,47,49,50,52,53,54,54,55,55,55,56,56,56,56,56
E01030474,EV motorcycles,Number,0,1,2,3,5,6,8,10,11,13,15,17,18,20,21,22,23,24,25,25,26,26,26,27,27,27,27,27,27,27
E01030475,EV motorcycles,Number,1,1,2,4,6,9,11,13,16,19,21,24,26,28,30,32,33,34,35,36,36,37,37,37,38,38,38,38,38,38
E01030476,EV motorcycles,Number,0,1,2,4,6,7,10,12,14,16,18,21,23,24,26,27,29,30,31,31,32,32,32,33,33,33,33,33,33,33
E01030477,EV motorcycles,Number,1,2,4,7,10,14,18,22,26,30,34,38,42,45,48,51,53,55,56,58,58,59,60,60,60,61,61,61,61,61
E01030478,EV motorcycles,Number,1,1,3,5,7,9,12,15,17,20,23,26,28,30,32,34,36,37,38,39,39,40,40,40,41,41,41,41,41,41
E01030479,EV motorcycles,Number,1,2,4,7,10,14,18,22,26,30,34,38,42,45,48,51,53,55,56,58,58,59,60,60,60,61,61,61,61,61
E01030480,EV motorcycles,Number,1,2,3,5,8,11,14,17,20,24,27,30,33,35,38,40,42,43,44,45,46,47,47,47,48,48,48,48,48,48
E01030481,EV motorcycles,Number,1,2,4,6,10,13,16,20,24,28,32,35,39,42,45,47,50,51,53,54,55,55,56,56,56,57,57,57,57,57
E01030482,EV motorcycles,Number,1,1,2,4,6,8,10,13,15,18,20,22,25,27,28,30,31,32,33,34,35,35,35,35,36,36,36,36,36,36
E01030483,EV motorcycles,Number,1,1,3,5,7,9,12,15,17,20,23,26,28,30,32,34,36,37,38,39,39,40,40,40,41,41,41,41,41,41
E01030484,EV motorcycles,Number,1,3,5,8,12,16,20,25,30,34,39,44,48,52,55,58,61,63,65,66,67,68,69,69,69,70,70,70,70,70
E01030485,EV motorcycles,Number,1,1,2,4,6,8,10,12,15,17,20,22,24,26,28,29,30,31,32,33,34,34,34,34,35,35,35,35,35,35
E01030486,EV motorcycles,Number,1,2,4,6,10,13,16,20,24,28,32,35,39,42,45,47,50,51,53,54,55,55,56,56,56,57,57,57,57,57
E01030487,EV motorcycles,Number,0,1,2,3,5,7,9,11,13,15,17,19,21,22,24,25,26,27,28,28,29,29,29,30,30,30,30,30,30,30
E01030488,EV motorcycles,Number,1,1,3,4,7,9,11,14,16,19,22,24,27,29,31,32,34,35,36,37,37,38,38,38,39,39,39,39,39,39
E01030489,EV motorcycles,Number,1,3,5,8,12,16,21,26,30,35,40,45,49,53,57,60,63,65,67,68,69,70,70,71,71,71,72,72,72,72
E01030490,EV motorcycles,Number,1,2,3,5,8,10,13,16,19,23,26,29,31,34,36,38,40,41,43,43,44,45,45,45,46,46,46,46,46,46
E01030491,EV motorcycles,Number,1,2,4,7,11,15,19,23,28,32,37,41,45,49,52,55,57,59,61,62,63,64,65,65,65,66,66,66,66,66
E01030492,EV motorcycles,Number,2,5,9,15,22,30,39,48,57,66,75,83,92,99,106,111,116,120,124,126,128,130,131,132,133,133,134,134,134,134
E01030493,EV motorcycles,Number,0,1,2,3,4,6,7,9,11,12,14,16,17,18,20,21,22,22,23,24,24,24,24,25,25,25,25,25,25,25
E01030494,EV motorcycles,Number,1,2,3,5,7,9,12,15,18,21,24,26,29,31,33,35,36,38,39,40,40,41,41,41,42,42,42,42,42,42
E01030495,EV motorcycles,Number,1,1,2,4,6,9,11,13,16,19,21,24,26,28,30,32,33,34,35,36,36,37,37,37,38,38,38,38,38,38
E01030496,EV motorcycles,Number,0,1,2,3,4,6,7,9,11,12,14,16,17,18,20,21,22,22,23,24,24,24,24,25,25,25,25,25,25,25
E01030497,EV motorcycles,Number,1,1,3,4,7,9,11,14,16,19,22,24,27,29,31,32,34,35,36,37,37,38,38,38,39,39,39,39,39,39
E01030498,EV motorcycles,Number,1,1,2,4,6,8,10,12,15,17,20,22,24,26,28,29,30,31,32,33,34,34,34,34,35,35,35,35,35,35
E01030499,EV motorcycles,Number,1,1,3,4,7,9,11,14,16,19,22,24,27,29,31,32,34,35,36,37,37,38,38,38,39,39,39,39,39,39
E01030500,EV motorcycles,Number,1,2,3,6,8,11,14,18,21,25,28,31,34,37,39,42,43,45,46,47,48,49,49,49,49,50,50,50,50,50
E01030501,EV motorcycles,Number,1,2,4,6,9,12,16,20,23,27,31,34,38,41,43,46,48,49,51,52,53,53,54,54,54,55,55,55,55,55
E01030502,EV motorcycles,Number,1,1,3,4,7,9,12,14,17,20,23,25,28,30,32,34,35,37,38,38,39,40,40,40,40,40,41,41,41,41
E01030503,EV motorcycles,Number,0,1,2,3,4,6,7,9,11,13,14,16,18,19,20,21,22,23,24,24,25,25,25,25,25,26,26,26,26,26
E01030504,EV motorcycles,Number,1,1,2,4,6,8,11,13,16,18,21,23,25,27,29,31,32,33,34,35,35,36,36,36,37,37,37,37,37,37
E01030505,EV motorcycles,Number,1,1,2,4,6,8,10,13,15,18,20,22,25,27,28,30,31,32,33,34,35,35,35,35,36,36,36,36,36,36
E01030506,EV motorcycles,Number,0,1,2,3,4,5,7,9,10,12,13,15,16,18,19,20,21,22,22,23,23,23,23,24,24,24,24,24,24,24
E01030507,EV motorcycles,Number,0,1,2,3,5,6,8,10,12,14,16,17,19,21,22,23,24,25,26,26,27,27,27,28,28,28,28,28,28,28
E01030508,EV motorcycles,Number,0,1,2,3,5,7,9,11,13,15,17,19,21,22,24,25,26,27,28,28,29,29,29,30,30,30,30,30,30,30
E01030509,EV motorcycles,Number,0,1,2,3,5,7,9,11,13,15,17,19,21,23,24,26,27,28,29,29,30,30,30,31,31,31,31,31,31,31
E01030510,EV motorcycles,Number,1,2,3,5,7,10,13,16,19,22,25,27,30,33,35,37,38,40,41,42,42,43,43,43,44,44,44,44,44,44
E01030511,EV motorcycles,Number,0,1,2,4,6,8,10,12,14,17,19,21,23,25,27,28,30,31,31,32,33,33,33,33,34,34,34,34,34,34
E01030512,EV motorcycles,Number,0,1,1,2,4,5,6,7,9,10,12,13,14,16,17,17,18,19,19,20,20,20,21,21,21,21,21,21,21,21
E01030513,EV motorcycles,Number,0,1,2,3,5,6,8,10,12,14,16,17,19,21,22,23,24,25,26,26,27,27,27,28,28,28,28,28,28,28
E01030514,EV motorcycles,Number,1,1,3,4,7,9,12,14,17,20,22,25,27,30,32,33,35,36,37,38,38,39,39,39,40,40,40,40,40,40
E01030515,EV motorcycles,Number,1,3,5,9,13,18,23,28,33,39,44,49,54,58,62,66,69,71,73,75,76,77,77,78,78,78,79,79,79,79
E01030516,EV motorcycles,Number,0,1,1,2,4,5,6,7,9,10,12,13,14,16,17,17,18,19,19,20,20,20,21,21,21,21,21,21,21,21
E01030517,EV motorcycles,Number,1,2,4,6,9,12,16,20,23,27,31,34,38,41,43,46,48,49,51,52,53,53,54,54,54,55,55,55,55,55
E01030518,EV motorcycles,Number,0,1,2,3,5,7,8,10,12,14,16,18,20,21,23,24,25,26,27,27,28,28,28,29,29,29,29,29,29,29
E01030519,EV motorcycles,Number,1,1,2,4,6,9,11,13,16,19,21,24,26,28,30,32,33,34,35,36,36,37,37,37,38,38,38,38,38,38
E01030520,EV motorcycles,Number,1,1,3,4,7,9,11,14,16,19,22,24,27,29,31,32,34,35,36,37,37,38,38,38,39,39,39,39,39,39
E01030521,EV motorcycles,Number,1,2,4,7,10,13,17,21,25,30,34,37,41,44,47,50,52,54,55,57,58,58,59,59,59,60,60,60,60,60
E01030522,EV motorcycles,Number,0,1,2,4,6,8,10,12,14,17,19,21,23,25,27,28,30,31,31,32,33,33,33,33,34,34,34,34,34,34
E01030523,EV motorcycles,Number,0,1,2,4,6,7,10,12,14,16,18,21,23,24,26,27,29,30,31,31,32,32,32,33,33,33,33,33,33,33
E01030524,EV motorcycles,Number,1,3,6,10,15,20,25,31,37,43,49,55,60,65,69,73,76,79,81,83,84,85,86,87,87,87,88,88,88,88
E01030525,EV motorcycles,Number,1,2,3,6,9,11,15,18,22,25,29,32,35,38,40,42,44,46,47,48,49,49,50,50,50,51,51,51,51,51
E01030526,EV motorcycles,Number,1,2,4,7,10,14,18,22,26,30,34,38,42,45,48,51,53,55,56,58,58,59,60,60,60,61,61,61,61,61
E01030527,EV motorcycles,Number,1,3,5,8,12,16,21,26,30,35,40,45,49,53,57,60,63,65,67,68,69,70,70,71,71,71,72,72,72,72
E01030528,EV motorcycles,Number,1,2,4,6,9,13,16,20,24,28,31,35,38,41,44,47,49,50,52,53,54,54,55,55,55,56,56,56,56,56
E01030529,EV motorcycles,Number,1,3,5,9,14,19,24,29,35,41,46,52,57,61,65,69,72,75,77,78,80,81,81,82,82,82,83,83,83,83
E01030530,EV motorcycles,Number,1,2,4,7,11,14,19,23,27,31,36,40,44,47,50,53,56,58,59,60,61,62,63,63,63,64,64,64,64,64
E01030531,EV motorcycles,Number,1,3,5,8,12,16,21,25,30,35,40,44,49,52,56,59,62,64,66,67,68,69,70,70,70,71,71,71,71,71
E01030532,EV motorcycles,Number,0,1,2,3,5,7,9,11,13,15,17,19,21,22,24,25,26,27,28,28,29,29,29,30,30,30,30,30,30,30
E01030533,EV motorcycles,Number,1,1,3,5,7,9,12,15,17,20,23,26,28,30,32,34,36,37,38,39,39,40,40,40,41,41,41,41,41,41
E01030534,EV motorcycles,Number,1,2,4,7,11,14,19,23,27,31,36,40,44,47,50,53,56,58,59,60,61,62,63,63,63,64,64,64,64,64
E01030535,EV motorcycles,Number,1,1,3,4,7,9,12,14,17,20,22,25,27,30,32,33,35,36,37,38,38,39,39,39,40,40,40,40,40,40
E01030536,EV motorcycles,Number,1,2,3,5,7,10,13,16,19,22,25,27,30,33,35,37,38,40,41,42,42,43,43,43,44,44,44,44,44,44
E01030537,EV motorcycles,Number,0,1,2,4,6,7,10,12,14,16,18,21,23,24,26,27,29,30,31,31,32,32,32,33,33,33,33,33,33,33
E01030538,EV motorcycles,Number,0,1,2,4,6,8,10,12,14,17,19,21,23,25,27,28,30,31,31,32,33,33,33,33,34,34,34,34,34,34
E01030539,EV motorcycles,Number,1,2,4,7,11,14,19,23,27,31,36,40,44,47,50,53,56,58,59,60,61,62,63,63,63,64,64,64,64,64
E01030540,EV motorcycles,Number,1,2,4,6,10,13,16,20,24,28,32,35,39,42,45,47,50,51,53,54,55,55,56,56,56,57,57,57,57,57
E01030541,EV motorcycles,Number,1,2,3,5,7,10,12,15,18,21,24,27,29,32,34,36,37,39,40,41,41,42,42,42,43,43,43,43,43,43
E01030542,EV motorcycles,Number,1,2,3,6,8,11,14,18,21,25,28,31,34,37,39,42,43,45,46,47,48,49,49,49,49,50,50,50,50,50
E01030543,EV motorcycles,Number,1,1,2,4,6,8,10,13,15,18,20,22,25,27,28,30,31,32,33,34,35,35,35,35,36,36,36,36,36,36
E01030544,EV motorcycles,Number,1,2,4,6,9,12,16,20,23,27,31,34,38,41,43,46,48,49,51,52,53,53,54,54,54,55,55,55,55,55
E01030545,EV motorcycles,Number,1,2,3,5,7,9,12,15,18,21,24,26,29,31,33,35,36,38,39,40,40,41,41,41,42,42,42,42,42,42
E01030546,EV motorcycles,Number,1,1,3,5,7,9,12,15,17,20,23,26,28,30,32,34,36,37,38,39,39,40,40,40,41,41,41,41,41,41
E01030547,EV motorcycles,Number,1,1,2,4,6,9,11,13,16,19,21,24,26,28,30,32,33,34,35,36,36,37,37,37,38,38,38,38,38,38
E01030548,EV motorcycles,Number,1,1,2,4,6,8,11,13,16,18,21,23,25,27,29,31,32,33,34,35,35,36,36,36,37,37,37,37,37,37
E01030549,EV motorcycles,Number,1,2,3,6,9,11,15,18,22,25,29,32,35,38,40,42,44,46,47,48,49,49,50,50,50,51,51,51,51,51
E01030550,EV motorcycles,Number,0,1,2,3,4,6,8,9,11,13,15,16,18,19,20,22,23,23,24,25,25,25,25,26,26,26,26,26,26,26
E01030551,EV motorcycles,Number,1,2,3,5,7,10,13,16,19,22,25,27,30,33,35,37,38,40,41,42,42,43,43,43,44,44,44,44,44,44
E01030552,EV motorcycles,Number,0,1,2,3,5,7,9,11,13,15,17,19,21,22,24,25,26,27,28,28,29,29,29,30,30,30,30,30,30,30
E01030553,EV motorcycles,Number,1,2,4,6,9,12,16,20,23,27,31,34,38,41,43,46,48,49,51,52,53,53,54,54,54,55,55,55,55,55
E01030554,EV motorcycles,Number,1,1,2,4,6,9,11,13,16,19,21,24,26,28,30,32,33,34,35,36,36,37,37,37,38,38,38,38,38,38
E01030555,EV motorcycles,Number,1,2,3,6,8,11,14,18,21,25,28,31,34,37,39,42,43,45,46,47,48,49,49,49,49,50,50,50,50,50
E01030556,EV motorcycles,Number,1,2,4,7,10,14,18,22,26,30,34,38,42,45,48,51,53,55,56,58,58,59,60,60,60,61,61,61,61,61
E01030557,EV motorcycles,Number,2,4,7,12,19,25,32,39,47,55,62,69,76,82,88,92,96,100,103,105,106,108,109,109,110,110,111,111,111,111
E01030558,EV motorcycles,Number,1,3,5,8,13,17,22,27,33,38,43,48,53,57,61,64,67,69,71,73,74,75,75,76,76,76,77,77,77,77
E01030559,EV motorcycles,Number,0,1,2,3,5,7,9,11,13,15,17,19,21,23,24,26,27,28,29,29,30,30,30,31,31,31,31,31,31,31
E01030560,EV motorcycles,Number,0,0,1,1,2,2,3,3,4,4,5,6,6,7,7,7,8,8,8,8,9,9,9,9,9,9,9,9,9,9
E01030561,EV motorcycles,Number,1,2,4,6,9,13,16,20,24,28,31,35,38,41,44,47,49,50,52,53,54,54,55,55,55,56,56,56,56,56
E01030562,EV motorcycles,Number,0,1,2,3,4,5,7,9,10,12,13,15,16,18,19,20,21,22,22,23,23,23,23,24,24,24,24,24,24,24
E01030563,EV motorcycles,Number,0,1,2,3,4,5,7,8,10,11,13,14,16,17,18,19,20,21,21,22,22,22,23,23,23,23,23,23,23,23
E01030564,EV motorcycles,Number,1,2,3,5,7,9,12,15,18,21,24,26,29,31,33,35,36,38,39,40,40,41,41,41,42,42,42,42,42,42
E01030565,EV motorcycles,Number,0,1,1,2,4,5,6,8,9,11,12,14,15,16,17,18,19,20,20,21,21,21,22,22,22,22,22,22,22,22
E01030566,EV motorcycles,Number,1,2,4,6,9,13,16,20,24,28,31,35,38,41,44,47,49,50,52,53,54,54,55,55,55,56,56,56,56,56
E01030567,EV motorcycles,Number,1,2,3,5,8,10,13,16,19,22,25,28,31,33,35,37,39,40,42,42,43,44,44,44,45,45,45,45,45,45
E01030568,EV motorcycles,Number,0,1,2,3,5,7,9,11,13,15,17,19,21,22,24,25,26,27,28,28,29,29,29,30,30,30,30,30,30,30
E01030569,EV motorcycles,Number,1,2,4,7,11,15,20,24,29,33,38,42,46,50,54,57,59,61,63,64,65,66,67,67,67,68,68,68,68,68
E01030570,EV motorcycles,Number,1,2,3,5,8,11,14,17,21,24,27,31,33,36,39,41,43,44,45,46,47,48,48,48,48,49,49,49,49,49
E01030571,EV motorcycles,Number,1,2,3,5,8,10,13,16,19,23,26,29,31,34,36,38,40,41,43,43,44,45,45,45,46,46,46,46,46,46
E01030572,EV motorcycles,Number,0,1,2,3,5,7,8,10,12,14,16,18,20,21,23,24,25,26,27,27,28,28,28,29,29,29,29,29,29,29
E01030573,EV motorcycles,Number,0,1,2,3,5,6,8,10,11,13,15,17,18,20,21,22,23,24,25,25,26,26,26,27,27,27,27,27,27,27
E01030574,EV motorcycles,Number,0,1,2,3,5,6,8,10,11,13,15,17,18,20,21,22,23,24,25,25,26,26,26,27,27,27,27,27,27,27
E01030575,EV motorcycles,Number,1,2,4,7,10,13,17,21,25,30,34,37,41,44,47,50,52,54,55,57,58,58,59,59,59,60,60,60,60,60
E01030576,EV motorcycles,Number,1,3,5,8,12,16,21,25,30,35,40,44,49,52,56,59,62,64,66,67,68,69,70,70,70,71,71,71,71,71
E01030577,EV motorcycles,Number,1,1,3,5,7,9,12,15,17,20,23,26,28,30,32,34,36,37,38,39,39,40,40,40,41,41,41,41,41,41
E01030578,EV motorcycles,Number,0,1,1,2,4,5,6,7,9,10,12,13,14,16,17,17,18,19,19,20,20,20,21,21,21,21,21,21,21,21
E01030579,EV motorcycles,Number,0,1,2,3,5,7,9,11,13,15,17,19,21,23,24,26,27,28,29,29,30,30,30,31,31,31,31,31,31,31
E01030580,EV motorcycles,Number,1,2,3,5,8,11,14,17,20,23,26,29,32,35,37,39,41,42,43,44,45,46,46,46,47,47,47,47,47,47
E01030581,EV motorcycles,Number,1,1,3,5,7,9,12,15,17,20,23,26,28,30,32,34,36,37,38,39,39,40,40,40,41,41,41,41,41,41
E01030582,EV motorcycles,Number,0,1,2,3,5,7,8,10,12,14,16,18,20,21,23,24,25,26,27,27,28,28,28,29,29,29,29,29,29,29
E01030583,EV motorcycles,Number,1,2,3,6,8,11,14,18,21,25,28,31,34,37,39,42,43,45,46,47,48,49,49,49,49,50,50,50,50,50
E01030584,EV motorcycles,Number,1,3,6,10,15,20,25,31,37,43,49,54,59,64,69,72,76,78,80,82,83,84,85,86,86,86,87,87,87,87
E01030585,EV motorcycles,Number,0,1,2,4,6,8,10,12,14,17,19,21,23,25,27,28,30,31,31,32,33,33,33,33,34,34,34,34,34,34
E01030586,EV motorcycles,Number,1,2,4,7,10,14,18,22,26,30,35,39,42,46,49,52,54,56,57,59,59,60,61,61,61,62,62,62,62,62
E01030587,EV motorcycles,Number,1,1,3,4,7,9,11,14,16,19,22,24,27,29,31,32,34,35,36,37,37,38,38,38,39,39,39,39,39,39
E01030588,EV motorcycles,Number,0,1,2,3,5,7,9,11,13,15,17,19,21,23,24,26,27,28,29,29,30,30,30,31,31,31,31,31,31,31
E01030589,EV motorcycles,Number,0,1,2,4,6,7,10,12,14,16,18,21,23,24,26,27,29,30,31,31,32,32,32,33,33,33,33,33,33,33
E01030590,EV motorcycles,Number,1,2,4,7,10,14,18,22,26,30,34,38,42,45,48,51,53,55,56,58,58,59,60,60,60,61,61,61,61,61
E01030591,EV motorcycles,Number,1,2,3,5,7,10,12,15,18,21,24,27,29,32,34,36,37,39,40,41,41,42,42,42,43,43,43,43,43,43
E01030592,EV motorcycles,Number,1,2,4,7,10,14,18,22,26,30,35,39,42,46,49,52,54,56,57,59,59,60,61,61,61,62,62,62,62,62
E01030593,EV motorcycles,Number,0,1,2,4,5,7,9,11,14,16,18,20,22,24,25,27,28,29,30,30,31,31,31,32,32,32,32,32,32,32
E01030594,EV motorcycles,Number,1,2,3,5,7,10,13,16,19,22,25,27,30,33,35,37,38,40,41,42,42,43,43,43,44,44,44,44,44,44
E01030595,EV motorcycles,Number,1,1,2,4,6,8,10,13,15,18,20,22,25,27,28,30,31,32,33,34,35,35,35,35,36,36,36,36,36,36
E01030596,EV motorcycles,Number,1,2,3,5,7,10,12,15,18,21,24,27,29,32,34,36,37,39,40,41,41,42,42,42,43,43,43,43,43,43
E01030597,EV motorcycles,Number,0,1,2,3,4,5,7,9,10,12,13,15,16,18,19,20,21,22,22,23,23,23,23,24,24,24,24,24,24,24
E01030598,EV motorcycles,Number,0,1,2,3,5,7,8,10,12,14,16,18,20,21,23,24,25,26,27,27,28,28,28,29,29,29,29,29,29,29
E01030599,EV motorcycles,Number,0,1,2,3,4,6,7,9,11,12,14,16,17,18,20,21,22,22,23,24,24,24,24,25,25,25,25,25,25,25
E01030600,EV motorcycles,Number,0,1,2,3,5,7,9,11,13,15,17,19,21,22,24,25,26,27,28,28,29,29,29,30,30,30,30,30,30,30
E01030601,EV motorcycles,Number,0,1,2,3,4,5,7,9,10,12,13,15,16,18,19,20,21,22,22,23,23,23,23,24,24,24,24,24,24,24
E01030602,EV motorcycles,Number,0,1,2,4,6,8,10,12,14,17,19,21,23,25,27,28,30,31,31,32,33,33,33,33,34,34,34,34,34,34
E01030603,EV motorcycles,Number,1,2,3,5,7,10,13,16,19,22,25,27,30,33,35,37,38,40,41,42,42,43,43,43,44,44,44,44,44,44
E01030604,EV motorcycles,Number,0,1,2,3,5,6,8,10,12,14,16,17,19,21,22,23,24,25,26,26,27,27,27,28,28,28,28,28,28,28
E01030605,EV motorcycles,Number,1,2,3,6,8,11,14,18,21,25,28,31,34,37,39,42,43,45,46,47,48,49,49,49,49,50,50,50,50,50
E01030606,EV motorcycles,Number,0,1,2,4,5,7,9,11,14,16,18,20,22,24,25,27,28,29,30,30,31,31,31,32,32,32,32,32,32,32
E01030607,EV motorcycles,Number,0,1,2,3,5,7,9,11,13,15,17,19,21,22,24,25,26,27,28,28,29,29,29,30,30,30,30,30,30,30
E01030608,EV motorcycles,Number,1,2,3,6,8,11,14,18,21,25,28,31,34,37,39,42,43,45,46,47,48,49,49,49,49,50,50,50,50,50
E01030609,EV motorcycles,Number,1,2,3,6,9,11,15,18,22,25,29,32,35,38,40,42,44,46,47,48,49,49,50,50,50,51,51,51,51,51
E01030610,EV motorcycles,Number,0,1,2,4,5,7,9,11,14,16,18,20,22,24,25,27,28,29,30,30,31,31,31,32,32,32,32,32,32,32
E01030611,EV motorcycles,Number,1,2,4,7,10,14,18,22,26,30,35,39,42,46,49,52,54,56,57,59,59,60,61,61,61,62,62,62,62,62
E01030612,EV motorcycles,Number,1,2,3,6,8,11,14,18,21,25,28,31,34,37,39,42,43,45,46,47,48,49,49,49,49,50,50,50,50,50
E01030613,EV motorcycles,Number,0,1,2,4,6,8,10,12,14,17,19,21,23,25,27,28,30,31,31,32,33,33,33,33,34,34,34,34,34,34
E01030614,EV motorcycles,Number,1,1,2,4,6,8,10,12,15,17,20,22,24,26,28,29,30,31,32,33,34,34,34,34,35,35,35,35,35,35
E01030615,EV motorcycles,Number,0,1,2,3,4,6,8,9,11,13,15,16,18,19,20,22,23,23,24,25,25,25,25,26,26,26,26,26,26,26
E01030616,EV motorcycles,Number,1,1,2,4,6,8,11,13,16,18,21,23,25,27,29,31,32,33,34,35,35,36,36,36,37,37,37,37,37,37
E01030617,EV motorcycles,Number,0,1,2,4,5,7,9,11,14,16,18,20,22,24,25,27,28,29,30,30,31,31,31,32,32,32,32,32,32,32
E01030618,EV motorcycles,Number,1,2,4,6,9,12,16,20,23,27,31,34,38,41,43,46,48,49,51,52,53,53,54,54,54,55,55,55,55,55
E01030619,EV motorcycles,Number,0,1,2,3,5,7,8,10,12,14,16,18,20,21,23,24,25,26,27,27,28,28,28,29,29,29,29,29,29,29
E01030620,EV motorcycles,Number,0,1,2,4,6,7,10,12,14,16,18,21,23,24,26,27,29,30,31,31,32,32,32,33,33,33,33,33,33,33
E01030621,EV motorcycles,Number,0,1,2,3,5,7,9,11,13,15,17,19,21,22,24,25,26,27,28,28,29,29,29,30,30,30,30,30,30,30
E01030622,EV motorcycles,Number,0,1,2,3,5,6,8,10,12,14,16,17,19,21,22,23,24,25,26,26,27,27,27,28,28,28,28,28,28,28
E01030623,EV motorcycles,Number,0,1,2,4,6,8,10,12,14,17,19,21,23,25,27,28,30,31,31,32,33,33,33,33,34,34,34,34,34,34
E01030624,EV motorcycles,Number,0,1,2,3,4,6,8,9,11,13,15,16,18,19,20,22,23,23,24,25,25,25,25,26,26,26,26,26,26,26
E01030625,EV motorcycles,Number,0,1,1,2,3,4,5,7,8,9,11,12,13,14,15,16,17,17,18,18,18,18,19,19,19,19,19,19,19,19
E01030626,EV motorcycles,Number,0,1,1,2,4,5,6,8,9,11,12,14,15,16,17,18,19,20,20,21,21,21,22,22,22,22,22,22,22,22
E01030627,EV motorcycles,Number,0,1,2,3,5,7,8,10,12,14,16,18,20,21,23,24,25,26,27,27,28,28,28,29,29,29,29,29,29,29
E01030628,EV motorcycles,Number,1,3,5,8,13,17,22,27,33,38,43,48,53,57,61,64,67,69,71,73,74,75,75,76,76,76,77,77,77,77
E01030629,EV motorcycles,Number,1,2,3,5,7,10,12,15,18,21,24,27,29,32,34,36,37,39,40,41,41,42,42,42,43,43,43,43,43,43
E01030630,EV motorcycles,Number,0,1,2,4,6,7,10,12,14,16,18,21,23,24,26,27,29,30,31,31,32,32,32,33,33,33,33,33,33,33
E01030631,EV motorcycles,Number,1,3,5,8,13,17,22,27,32,37,43,47,52,56,60,63,66,68,70,72,73,74,74,75,75,75,76,76,76,76
E01030632,EV motorcycles,Number,1,2,3,6,9,12,15,18,22,26,29,32,36,38,41,43,45,47,48,49,50,50,51,51,51,52,52,52,52,52
E01030633,EV motorcycles,Number,1,2,3,6,9,11,15,18,22,25,29,32,35,38,40,42,44,46,47,48,49,49,50,50,50,51,51,51,51,51
E01030634,EV motorcycles,Number,1,2,3,6,9,11,15,18,22,25,29,32,35,38,40,42,44,46,47,48,49,49,50,50,50,51,51,51,51,51
E01030635,EV motorcycles,Number,1,2,3,5,7,10,13,16,19,22,25,27,30,33,35,37,38,40,41,42,42,43,43,43,44,44,44,44,44,44
E01030636,EV motorcycles,Number,1,1,2,4,6,8,11,13,16,18,21,23,25,27,29,31,32,33,34,35,35,36,36,36,37,37,37,37,37,37
E01030637,EV motorcycles,Number,0,1,2,3,5,7,9,11,13,15,17,19,21,22,24,25,26,27,28,28,29,29,29,30,30,30,30,30,30,30
E01030638,EV motorcycles,Number,1,2,3,5,8,10,13,16,19,22,25,28,31,33,35,37,39,40,42,42,43,44,44,44,45,45,45,45,45,45
E01030639,EV motorcycles,Number,0,1,2,3,5,7,9,11,13,15,17,19,21,23,24,26,27,28,29,29,30,30,30,31,31,31,31,31,31,31
E01030640,EV motorcycles,Number,1,1,3,4,7,9,12,14,17,20,22,25,27,30,32,33,35,36,37,38,38,39,39,39,40,40,40,40,40,40
E01030641,EV motorcycles,Number,1,2,3,5,7,10,13,16,19,22,25,27,30,33,35,37,38,40,41,42,42,43,43,43,44,44,44,44,44,44
E01030642,EV motorcycles,Number,1,2,3,5,7,10,12,15,18,21,24,27,29,32,34,36,37,39,40,41,41,42,42,42,43,43,43,43,43,43
E01030643,EV motorcycles,Number,0,1,2,3,5,7,9,11,13,15,17,19,21,23,24,26,27,28,29,29,30,30,30,31,31,31,31,31,31,31
E01030644,EV motorcycles,Number,1,2,4,7,10,13,17,21,25,29,33,37,40,44,47,49,51,53,55,56,57,57,58,58,58,59,59,59,59,59
E01030645,EV motorcycles,Number,0,1,2,4,6,7,10,12,14,16,18,21,23,24,26,27,29,30,31,31,32,32,32,33,33,33,33,33,33,33
E01030646,EV motorcycles,Number,1,3,5,8,12,17,21,26,31,36,41,46,51,55,58,62,64,67,68,70,71,72,72,73,73,73,74,74,74,74
E01030647,EV motorcycles,Number,1,2,4,7,10,13,17,21,25,30,34,37,41,44,47,50,52,54,55,57,58,58,59,59,59,60,60,60,60,60
E01030648,EV motorcycles,Number,1,2,3,5,7,9,12,15,18,21,24,26,29,31,33,35,36,38,39,40,40,41,41,41,42,42,42,42,42,42
E01030649,EV motorcycles,Number,1,2,3,6,9,12,15,19,22,26,30,33,36,39,42,44,46,48,49,50,51,51,52,52,52,53,53,53,53,53
E01030650,EV motorcycles,Number,0,1,2,3,5,7,9,11,13,15,17,19,21,22,24,25,26,27,28,28,29,29,29,30,30,30,30,30,30,30
E01030651,EV motorcycles,Number,1,2,4,6,9,13,16,20,24,28,31,35,38,41,44,47,49,50,52,53,54,54,55,55,55,56,56,56,56,56
E01030652,EV motorcycles,Number,1,2,3,5,8,11,14,17,20,23,26,29,32,35,37,39,41,42,43,44,45,46,46,46,47,47,47,47,47,47
E01030653,EV motorcycles,Number,0,1,2,3,5,7,8,10,12,14,16,18,20,21,23,24,25,26,27,27,28,28,28,29,29,29,29,29,29,29
E01030654,EV motorcycles,Number,1,1,3,4,7,9,12,14,17,20,22,25,27,30,32,33,35,36,37,38,38,39,39,39,40,40,40,40,40,40
E01030655,EV motorcycles,Number,1,1,3,5,7,9,12,15,17,20,23,26,28,30,32,34,36,37,38,39,39,40,40,40,41,41,41,41,41,41
E01030656,EV motorcycles,Number,1,1,2,4,6,9,11,13,16,19,21,24,26,28,30,32,33,34,35,36,36,37,37,37,38,38,38,38,38,38
E01030657,EV motorcycles,Number,1,2,3,5,7,10,12,15,18,21,24,27,29,32,34,36,37,39,40,41,41,42,42,42,43,43,43,43,43,43
E01030658,EV motorcycles,Number,0,1,2,4,5,7,9,12,14,16,18,20,22,24,26,27,28,29,30,31,31,32,32,32,32,33,33,33,33,33
E01030659,EV motorcycles,Number,1,1,3,4,7,9,11,14,16,19,22,24,27,29,31,32,34,35,36,37,37,38,38,38,39,39,39,39,39,39
E01030660,EV motorcycles,Number,1,2,4,6,9,13,16,20,24,28,31,35,38,41,44,47,49,50,52,53,54,54,55,55,55,56,56,56,56,56
E01030661,EV motorcycles,Number,1,2,4,6,9,12,16,20,23,27,31,34,38,41,43,46,48,49,51,52,53,53,54,54,54,55,55,55,55,55
E01030662,EV motorcycles,Number,1,1,3,4,7,9,11,14,16,19,22,24,27,29,31,32,34,35,36,37,37,38,38,38,39,39,39,39,39,39
E01030677,EV motorcycles,Number,0,1,2,3,5,6,8,10,12,14,16,18,20,21,23,24,25,26,27,27,28,28,28,28,29,29,29,29,29,29
E01030678,EV motorcycles,Number,0,1,2,3,5,7,9,11,13,15,17,19,21,23,24,26,27,28,29,29,30,30,30,31,31,31,31,31,31,31
E01030679,EV motorcycles,Number,1,2,3,5,8,10,13,16,19,22,25,28,31,33,35,37,39,40,42,42,43,44,44,44,45,45,45,45,45,45
E01030680,EV motorcycles,Number,1,1,2,4,6,8,10,12,15,17,20,22,24,26,28,29,30,31,32,33,34,34,34,34,35,35,35,35,35,35
E01030681,EV motorcycles,Number,1,2,4,7,10,13,17,21,25,29,33,37,40,44,47,49,51,53,55,56,57,57,58,58,58,59,59,59,59,59
E01030682,EV motorcycles,Number,0,1,2,3,5,7,9,11,13,15,17,19,21,23,24,26,27,28,29,29,30,30,30,31,31,31,31,31,31,31
E01030683,EV motorcycles,Number,1,2,3,5,7,9,12,15,18,21,24,26,29,31,33,35,36,38,39,40,40,41,41,41,42,42,42,42,42,42
E01030684,EV motorcycles,Number,0,1,2,4,6,8,10,12,14,17,19,21,23,25,27,28,30,31,31,32,33,33,33,33,34,34,34,34,34,34
E01030685,EV motorcycles,Number,0,0,0,0,0,0,1,1,1,1,1,1,1,1,1,2,2,2,2,2,2,2,2,2,2,2,2,2,2,2
E01030693,EV motorcycles,Number,0,1,1,2,4,5,6,8,9,11,12,14,15,16,17,18,19,20,20,21,21,21,22,22,22,22,22,22,22,22
E01030694,EV motorcycles,Number,1,2,3,5,8,11,14,17,20,23,26,29,32,35,37,39,41,42,43,44,45,46,46,46,47,47,47,47,47,47
E01030695,EV motorcycles,Number,0,1,2,3,5,7,9,11,13,15,17,19,21,23,24,26,27,28,29,29,30,30,30,31,31,31,31,31,31,31
E01030696,EV motorcycles,Number,1,2,3,6,9,11,15,18,22,25,29,32,35,38,40,42,44,46,47,48,49,49,50,50,50,51,51,51,51,51
E01030721,EV motorcycles,Number,1,2,4,7,11,15,19,23,27,32,36,40,44,48,51,54,56,58,60,61,62,63,64,64,64,65,65,65,65,65
E01030722,EV motorcycles,Number,0,0,1,1,2,3,4,5,6,7,8,8,9,10,11,11,12,12,12,13,13,13,13,13,13,13,13,13,13,13
E01030723,EV motorcycles,Number,1,1,2,4,6,8,10,13,15,18,20,22,25,27,28,30,31,32,33,34,35,35,35,35,36,36,36,36,36,36
E01030724,EV motorcycles,Number,1,2,3,5,8,10,13,16,19,23,26,29,31,34,36,38,40,41,43,43,44,45,45,45,46,46,46,46,46,46
E01030726,EV motorcycles,Number,0,0,0,1,1,2,2,3,3,4,4,4,5,5,6,6,6,7,7,7,7,7,7,7,7,7,7,7,7,7
E01030728,EV motorcycles,Number,0,0,0,1,1,1,2,2,2,3,3,3,4,4,4,5,5,5,5,5,5,5,5,5,6,6,6,6,6,6
E01030729,EV motorcycles,Number,1,1,2,4,6,8,10,12,15,17,20,22,24,26,28,29,30,31,32,33,34,34,34,34,35,35,35,35,35,35
E01030730,EV motorcycles,Number,1,3,5,8,12,16,21,26,31,36,41,45,50,54,58,61,63,66,67,69,70,71,71,72,72,72,73,73,73,73
E01030731,EV motorcycles,Number,0,1,2,3,5,7,9,11,13,15,17,19,21,22,24,25,26,27,28,28,29,29,29,30,30,30,30,30,30,30
E01030732,EV motorcycles,Number,1,2,3,5,8,11,14,17,20,23,26,29,32,35,37,39,41,42,43,44,45,45,46,46,46,47,47,47,47,47
E01030733,EV motorcycles,Number,1,2,4,6,10,13,17,21,25,29,32,36,40,43,46,48,50,52,54,55,56,56,57,57,57,58,58,58,58,58
E01030739,EV motorcycles,Number,1,2,3,5,7,9,12,15,18,21,24,26,29,31,33,35,36,38,39,40,40,41,41,41,42,42,42,42,42,42
E01030740,EV motorcycles,Number,0,0,0,0,1,1,1,1,2,2,2,2,3,3,3,3,3,3,4,4,4,4,4,4,4,4,4,4,4,4
E01030741,EV motorcycles,Number,0,0,1,1,1,2,2,3,3,4,5,5,6,6,7,7,7,7,8,8,8,8,8,8,8,8,8,8,8,8
E01030753,EV motorcycles,Number,0,0,0,0,0,0,0,0,0,0,0,0,0,0,0,0,0,0,0,0,0,0,0,0,0,0,0,0,0,0
E01030761,EV motorcycles,Number,1,2,4,6,9,12,16,20,23,27,31,34,38,41,43,46,48,49,51,52,53,53,54,54,54,55,55,55,55,55
E01030762,EV motorcycles,Number,1,1,2,4,6,8,10,13,15,18,20,22,25,27,28,30,31,32,33,34,35,35,35,35,36,36,36,36,36,36
E01030763,EV motorcycles,Number,0,0,0,0,0,0,0,0,0,0,0,0,0,0,0,0,0,0,0,0,0,0,0,0,0,0,0,0,0,0
E01030764,EV motorcycles,Number,0,0,0,1,1,1,2,2,3,3,4,4,4,5,5,5,6,6,6,6,6,6,6,6,6,6,7,7,7,7
E01030807,EV motorcycles,Number,0,0,0,0,0,0,0,0,0,0,0,0,0,0,0,0,0,0,0,0,0,0,0,0,0,0,0,0,0,0
E01030812,EV motorcycles,Number,1,2,3,6,9,11,15,18,22,25,29,32,35,38,40,42,44,46,47,48,49,49,50,50,50,51,51,51,51,51
E01030813,EV motorcycles,Number,1,1,3,4,7,9,12,14,17,20,22,25,27,30,32,33,35,36,37,38,38,39,39,39,40,40,40,40,40,40
E01030814,EV motorcycles,Number,0,1,1,2,3,4,6,7,8,10,11,12,14,15,16,17,17,18,18,19,19,19,20,20,20,20,20,20,20,20
E01030815,EV motorcycles,Number,1,3,5,8,12,16,21,25,30,35,40,44,49,52,56,59,62,64,66,67,68,69,70,70,70,71,71,71,71,71
E01030816,EV motorcycles,Number,1,2,4,7,11,15,19,24,28,33,37,42,46,50,53,56,58,60,62,63,64,65,66,66,66,67,67,67,67,67
E01030817,EV motorcycles,Number,1,2,4,7,10,13,17,21,25,29,33,37,40,44,47,49,51,53,55,56,57,57,58,58,58,59,59,59,59,59
E01030818,EV motorcycles,Number,0,1,2,4,5,7,9,11,14,16,18,20,22,24,25,27,28,29,30,30,31,31,31,32,32,32,32,32,32,32
E01030819,EV motorcycles,Number,1,3,5,8,12,16,21,25,30,35,40,44,49,52,56,59,62,64,66,67,68,69,70,70,70,71,71,71,71,71
E01030820,EV motorcycles,Number,1,3,5,8,12,17,21,26,31,36,41,46,51,55,58,62,64,67,68,70,71,72,72,73,73,73,74,74,74,74
E01030821,EV motorcycles,Number,1,3,6,10,15,20,25,31,37,43,49,55,60,65,69,73,76,79,81,83,84,85,86,87,87,87,88,88,88,88
E01030822,EV motorcycles,Number,1,2,4,7,11,15,20,24,29,33,38,42,46,50,54,57,59,61,63,64,65,66,67,67,67,68,68,68,68,68
E01030823,EV motorcycles,Number,1,3,5,9,14,18,23,29,34,40,45,50,55,60,64,67,70,73,75,76,78,79,79,80,80,80,81,81,81,81
E01030824,EV motorcycles,Number,0,1,2,3,5,7,9,11,13,15,17,19,21,23,24,26,27,28,29,29,30,30,30,31,31,31,31,31,31,31
E01030825,EV motorcycles,Number,0,1,2,3,5,6,8,10,11,13,15,17,18,20,21,22,23,24,25,25,26,26,26,27,27,27,27,27,27,27
E01030826,EV motorcycles,Number,1,2,3,5,8,10,13,16,19,22,25,28,31,33,35,37,39,40,42,42,43,44,44,44,45,45,45,45,45,45
E01030827,EV motorcycles,Number,1,3,5,9,13,18,23,28,33,38,44,49,53,58,61,65,68,70,72,74,75,76,76,77,77,77,78,78,78,78
E01030828,EV motorcycles,Number,1,1,3,4,7,9,11,14,16,19,22,24,27,29,31,32,34,35,36,37,37,38,38,38,39,39,39,39,39,39
E01030829,EV motorcycles,Number,0,1,2,4,6,8,10,12,14,17,19,21,23,25,27,28,30,31,31,32,33,33,33,33,34,34,34,34,34,34
E01030830,EV motorcycles,Number,0,1,2,3,5,7,8,10,12,14,16,18,20,21,23,24,25,26,27,27,28,28,28,29,29,29,29,29,29,29
E01030831,EV motorcycles,Number,1,1,2,4,6,8,10,13,15,18,20,22,25,27,28,30,31,32,33,34,35,35,35,35,36,36,36,36,36,36
E01030832,EV motorcycles,Number,0,1,2,3,4,6,8,9,11,13,15,16,18,19,20,22,23,23,24,25,25,25,25,26,26,26,26,26,26,26
E01030833,EV motorcycles,Number,1,1,3,5,7,9,12,15,17,20,23,26,28,30,32,34,36,37,38,39,39,40,40,40,41,41,41,41,41,41
E01030834,EV motorcycles,Number,1,2,4,7,10,13,17,21,25,30,34,37,41,44,47,50,52,54,55,57,58,58,59,59,59,60,60,60,60,60
E01030835,EV motorcycles,Number,0,1,2,3,4,5,7,8,10,11,13,14,16,17,18,19,20,21,21,22,22,22,23,23,23,23,23,23,23,23
E01030836,EV motorcycles,Number,0,1,2,3,4,5,7,8,10,11,13,14,16,17,18,19,20,21,21,22,22,22,23,23,23,23,23,23,23,23
E01030837,EV motorcycles,Number,1,1,2,4,6,8,11,13,16,18,21,23,25,27,29,31,32,33,34,35,35,36,36,36,37,37,37,37,37,37
E01030838,EV motorcycles,Number,0,1,2,4,6,7,10,12,14,16,18,21,23,24,26,27,29,30,31,31,32,32,32,33,33,33,33,33,33,33
E01030839,EV motorcycles,Number,0,1,1,2,4,5,6,8,9,11,12,14,15,16,17,18,19,20,20,21,21,21,22,22,22,22,22,22,22,22
E01030840,EV motorcycles,Number,0,1,2,4,5,7,9,11,14,16,18,20,22,24,25,27,28,29,30,30,31,31,31,32,32,32,32,32,32,32
E01030841,EV motorcycles,Number,0,1,1,2,3,4,5,7,8,9,11,12,13,14,15,16,17,17,18,18,18,18,19,19,19,19,19,19,19,19
E01030842,EV motorcycles,Number,1,2,3,6,9,12,15,18,22,26,29,32,36,38,41,43,45,47,48,49,50,50,51,51,51,52,52,52,52,52
E01030843,EV motorcycles,Number,1,2,3,6,9,12,15,19,22,26,30,33,36,39,42,44,46,48,49,50,51,51,52,52,52,53,53,53,53,53
E01030844,EV motorcycles,Number,0,1,2,4,6,7,10,12,14,16,18,21,23,24,26,27,29,30,31,31,32,32,32,33,33,33,33,33,33,33
E01030845,EV motorcycles,Number,1,1,2,4,6,8,11,13,16,18,21,23,25,27,29,31,32,33,34,35,35,36,36,36,37,37,37,37,37,37
E01030846,EV motorcycles,Number,1,1,2,4,6,8,11,13,16,18,21,23,25,27,29,31,32,33,34,35,35,36,36,36,37,37,37,37,37,37
E01030847,EV motorcycles,Number,0,1,2,3,5,6,8,10,12,14,16,17,19,21,22,23,24,25,26,26,27,27,27,28,28,28,28,28,28,28
E01030848,EV motorcycles,Number,1,2,3,5,7,10,12,15,18,21,24,27,29,32,34,36,37,39,40,41,41,42,42,42,43,43,43,43,43,43
E01030850,EV motorcycles,Number,1,2,4,6,9,12,16,20,23,27,31,34,38,41,43,46,48,49,51,52,53,53,54,54,54,55,55,55,55,55
E01030851,EV motorcycles,Number,1,2,3,6,9,11,15,18,22,25,29,32,35,38,40,42,44,46,47,48,49,49,50,50,50,51,51,51,51,51
E01030852,EV motorcycles,Number,1,2,3,5,7,10,13,16,19,22,25,27,30,33,35,37,38,40,41,42,42,43,43,43,44,44,44,44,44,44
E01030853,EV motorcycles,Number,1,2,4,6,10,13,16,20,24,28,32,35,39,42,45,47,50,51,53,54,55,55,56,56,56,57,57,57,57,57
E01030854,EV motorcycles,Number,1,1,3,4,7,9,11,14,16,19,22,24,27,29,31,32,34,35,36,37,37,38,38,38,39,39,39,39,39,39
E01030855,EV motorcycles,Number,0,1,2,3,5,6,8,10,12,14,16,17,19,21,22,23,24,25,26,26,27,27,27,28,28,28,28,28,28,28
E01030856,EV motorcycles,Number,0,1,1,2,4,5,6,8,9,11,12,14,15,16,17,18,19,20,20,21,21,21,22,22,22,22,22,22,22,22
E01030857,EV motorcycles,Number,1,1,2,4,6,8,11,13,16,18,21,23,25,27,29,31,32,33,34,35,35,36,36,36,37,37,37,37,37,37
E01030858,EV motorcycles,Number,1,2,3,5,8,11,14,17,20,23,26,29,32,35,37,39,41,42,43,44,45,46,46,46,47,47,47,47,47,47
E01030859,EV motorcycles,Number,1,1,3,4,7,9,11,14,16,19,22,24,27,29,31,32,34,35,36,37,37,38,38,38,39,39,39,39,39,39
E01030860,EV motorcycles,Number,1,2,3,5,7,10,12,15,18,21,24,27,29,32,34,36,37,39,40,41,41,42,42,42,43,43,43,43,43,43
E01030861,EV motorcycles,Number,1,1,2,4,6,8,10,12,15,17,20,22,24,26,28,29,30,31,32,33,34,34,34,34,35,35,35,35,35,35
E01030862,EV motorcycles,Number,2,4,7,12,19,25,33,40,48,56,63,70,77,83,89,94,98,102,104,107,108,110,111,111,112,112,113,113,113,113
E01030863,EV motorcycles,Number,1,2,4,7,11,15,19,24,28,33,37,42,46,50,53,56,58,60,62,63,64,65,66,66,66,67,67,67,67,67
E01030864,EV motorcycles,Number,1,1,3,5,7,9,12,15,17,20,23,26,28,30,32,34,36,37,38,39,39,40,40,41,41,41,41,41,41,41
E01030865,EV motorcycles,Number,1,2,3,5,7,10,13,16,19,22,25,27,30,33,35,37,38,40,41,42,42,43,43,43,44,44,44,44,44,44
E01030866,EV motorcycles,Number,1,2,3,5,8,11,14,17,20,24,27,30,33,35,38,40,42,43,44,45,46,47,47,47,48,48,48,48,48,48
E01030867,EV motorcycles,Number,1,2,4,7,11,14,18,23,27,31,35,39,43,47,50,53,55,57,59,60,61,62,62,62,63,63,63,63,63,63
E01030870,EV motorcycles,Number,1,2,4,6,9,12,16,20,23,27,31,34,38,41,43,46,48,49,51,52,53,53,54,54,54,55,55,55,55,55
E01030871,EV motorcycles,Number,1,2,3,5,8,10,13,16,19,23,26,29,31,34,36,38,40,41,43,43,44,45,45,45,46,46,46,46,46,46
E01030872,EV motorcycles,Number,1,1,3,5,7,9,12,15,17,20,23,26,28,30,32,34,36,37,38,39,39,40,40,40,41,41,41,41,41,41
E01030873,EV motorcycles,Number,1,2,3,5,8,10,13,16,19,23,26,29,31,34,36,38,40,41,43,43,44,45,45,45,46,46,46,46,46,46
E01030874,EV motorcycles,Number,1,2,3,5,7,10,13,16,19,22,25,27,30,33,35,37,38,40,41,42,42,43,43,43,44,44,44,44,44,44
E01030875,EV motorcycles,Number,1,2,4,7,11,15,19,23,27,32,36,40,44,48,51,54,56,58,60,61,62,63,64,64,64,65,65,65,65,65
E01030876,EV motorcycles,Number,0,1,2,3,4,5,7,9,10,12,13,15,16,18,19,20,21,22,22,23,23,23,23,24,24,24,24,24,24,24
E01030880,EV motorcycles,Number,1,3,5,8,13,17,22,27,32,37,43,47,52,56,60,63,66,68,70,72,73,74,74,75,75,75,76,76,76,76
E01030920,EV motorcycles,Number,0,0,0,0,0,0,0,0,0,0,0,0,0,0,0,0,0,0,0,0,0,0,0,0,0,0,0,0,0,0
E01030922,EV motorcycles,Number,0,0,0,0,0,0,0,0,0,0,0,0,0,0,0,0,0,0,0,0,0,0,0,0,0,0,0,0,0,0
E01030940,EV motorcycles,Number,1,2,3,6,9,12,15,18,22,26,29,32,36,38,41,43,45,47,48,49,50,50,51,51,51,52,52,52,52,52
E01030944,EV motorcycles,Number,0,1,1,2,4,5,6,7,9,10,12,13,14,16,17,17,18,19,19,20,20,20,21,21,21,21,21,21,21,21
E01030945,EV motorcycles,Number,0,1,2,3,4,6,8,9,11,13,15,16,18,19,20,22,23,23,24,25,25,25,25,26,26,26,26,26,26,26
E01030946,EV motorcycles,Number,1,1,2,4,6,9,11,13,16,19,21,24,26,28,30,32,33,34,35,36,36,37,37,37,38,38,38,38,38,38
E01030947,EV motorcycles,Number,1,1,2,4,6,8,10,12,15,17,20,22,24,26,28,29,30,31,32,33,34,34,34,34,35,35,35,35,35,35
E01030948,EV motorcycles,Number,1,2,3,6,9,12,15,19,22,26,30,33,36,39,42,44,46,48,49,50,51,51,52,52,52,53,53,53,53,53
E01030949,EV motorcycles,Number,1,2,4,7,10,13,17,21,25,30,34,37,41,44,47,50,52,54,55,57,58,58,59,59,59,60,60,60,60,60
E01030950,EV motorcycles,Number,1,1,2,4,6,8,10,12,15,17,20,22,24,26,28,29,30,31,32,33,34,34,34,34,35,35,35,35,35,35
E01030951,EV motorcycles,Number,1,1,2,4,6,8,11,13,16,18,21,23,25,27,29,31,32,33,34,35,35,36,36,36,37,37,37,37,37,37
E01030952,EV motorcycles,Number,0,1,1,2,4,5,6,7,9,10,12,13,14,16,17,17,18,19,19,20,20,20,21,21,21,21,21,21,21,21
E01030953,EV motorcycles,Number,1,1,2,4,6,8,11,13,16,18,21,23,25,27,29,31,32,33,34,35,35,36,36,36,37,37,37,37,37,37
E01030954,EV motorcycles,Number,1,2,3,5,7,9,12,15,18,21,24,26,29,31,33,35,36,38,39,40,40,41,41,41,42,42,42,42,42,42
E01030955,EV motorcycles,Number,0,1,1,2,3,4,6,7,8,10,11,12,14,15,16,17,17,18,18,19,19,19,20,20,20,20,20,20,20,20
E01030956,EV motorcycles,Number,0,1,2,3,5,7,8,10,12,14,16,18,20,21,23,24,25,26,27,27,28,28,28,29,29,29,29,29,29,29
E01030957,EV motorcycles,Number,0,1,1,2,4,5,6,7,9,10,12,13,14,16,17,17,18,19,19,20,20,20,21,21,21,21,21,21,21,21
E01030958,EV motorcycles,Number,1,2,3,5,8,11,14,17,20,24,27,30,33,35,38,40,42,43,44,45,46,47,47,47,48,48,48,48,48,48
E01030959,EV motorcycles,Number,0,1,1,2,3,4,6,7,8,10,11,12,14,15,16,17,17,18,18,19,19,19,20,20,20,20,20,20,20,20
E01030960,EV motorcycles,Number,0,1,2,3,5,6,8,10,11,13,15,17,18,20,21,22,23,24,25,25,26,26,26,27,27,27,27,27,27,27
E01030961,EV motorcycles,Number,1,3,5,8,12,17,21,26,31,36,41,46,51,55,58,62,64,67,68,70,71,72,72,73,73,73,74,74,74,74
E01030962,EV motorcycles,Number,0,1,2,3,5,7,8,10,12,14,16,18,20,21,23,24,25,26,27,27,28,28,28,29,29,29,29,29,29,29
E01030963,EV motorcycles,Number,0,1,2,3,5,7,8,10,12,14,16,18,20,21,23,24,25,26,27,27,28,28,28,29,29,29,29,29,29,29
E01030964,EV motorcycles,Number,1,2,3,5,8,10,13,16,19,22,25,28,31,33,35,37,39,40,42,42,43,44,44,44,45,45,45,45,45,45
E01030965,EV motorcycles,Number,1,2,3,5,8,10,13,16,19,23,26,29,31,34,36,38,40,41,43,43,44,45,45,45,46,46,46,46,46,46
E01030966,EV motorcycles,Number,0,1,2,3,5,6,8,10,12,14,16,17,19,21,22,23,24,25,26,26,27,27,27,28,28,28,28,28,28,28
E01030967,EV motorcycles,Number,0,1,2,3,5,6,8,10,12,14,16,17,19,21,22,23,24,25,26,26,27,27,27,28,28,28,28,28,28,28
E01030968,EV motorcycles,Number,0,1,2,3,5,7,9,11,13,15,17,19,21,23,24,26,27,28,29,29,30,30,30,31,31,31,31,31,31,31
E01030969,EV motorcycles,Number,0,1,2,3,4,5,7,9,10,12,13,15,16,18,19,20,21,22,22,23,23,23,23,24,24,24,24,24,24,24
E01030970,EV motorcycles,Number,0,1,1,2,4,5,6,7,9,10,12,13,14,16,17,17,18,19,19,20,20,20,21,21,21,21,21,21,21,21
E01030971,EV motorcycles,Number,1,2,3,6,9,11,15,18,22,25,29,32,35,38,40,42,44,46,47,48,49,49,50,50,50,51,51,51,51,51
E01030972,EV motorcycles,Number,1,1,3,4,7,9,12,14,17,20,22,25,27,30,32,33,35,36,37,38,38,39,39,39,40,40,40,40,40,40
E01030973,EV motorcycles,Number,1,3,5,8,13,17,22,27,32,37,42,47,51,55,59,62,65,67,69,71,72,73,73,74,74,74,75,75,75,75
E01030974,EV motorcycles,Number,1,2,4,6,9,12,16,19,23,27,30,34,37,40,43,45,47,49,50,51,52,52,53,53,53,54,54,54,54,54
E01030975,EV motorcycles,Number,0,1,2,3,4,6,8,9,11,13,15,17,18,20,21,22,23,24,25,25,25,26,26,26,26,26,27,27,27,27
E01030976,EV motorcycles,Number,0,1,2,3,5,7,9,11,13,15,17,19,21,22,24,25,26,27,28,28,29,29,29,30,30,30,30,30,30,30
E01030977,EV motorcycles,Number,1,2,3,6,9,11,15,18,22,25,29,32,35,38,40,42,44,46,47,48,49,49,50,50,50,51,51,51,51,51
E01030978,EV motorcycles,Number,0,1,2,3,5,6,8,10,12,14,16,17,19,21,22,23,24,25,26,26,27,27,27,28,28,28,28,28,28,28
E01030979,EV motorcycles,Number,1,1,2,4,6,8,10,12,15,17,20,22,24,26,28,29,30,31,32,33,34,34,34,34,35,35,35,35,35,35
E01030980,EV motorcycles,Number,1,2,4,7,11,15,20,24,29,33,38,42,46,50,54,57,59,61,63,64,65,66,67,67,67,68,68,68,68,68
E01030981,EV motorcycles,Number,0,1,1,2,3,4,5,6,8,9,10,11,12,13,14,15,16,16,17,17,17,17,18,18,18,18,18,18,18,18
E01030982,EV motorcycles,Number,1,2,3,5,8,10,13,16,19,22,25,28,31,33,35,37,39,40,42,42,43,44,44,44,45,45,45,45,45,45
E01030983,EV motorcycles,Number,0,1,1,2,4,5,6,8,9,11,12,14,15,16,17,18,19,20,20,21,21,21,22,22,22,22,22,22,22,22
E01030984,EV motorcycles,Number,1,4,7,11,17,23,29,36,43,50,57,63,70,75,80,85,89,92,94,96,98,99,100,100,101,101,102,102,102,102
E01030985,EV motorcycles,Number,0,1,1,2,3,3,4,5,6,7,8,9,10,11,12,12,13,13,14,14,14,15,15,15,15,15,15,15,15,15
E01030986,EV motorcycles,Number,0,1,2,4,6,7,10,12,14,16,18,21,23,24,26,27,29,30,31,31,32,32,32,33,33,33,33,33,33,33
E01030987,EV motorcycles,Number,1,2,4,6,10,13,17,21,25,29,32,36,40,43,46,48,50,52,54,55,56,56,57,57,57,58,58,58,58,58
E01030988,EV motorcycles,Number,1,1,2,4,6,8,10,12,15,17,20,22,24,26,28,29,30,31,32,33,34,34,34,34,35,35,35,35,35,35
E01030989,EV motorcycles,Number,1,2,3,5,7,9,12,15,18,21,24,26,29,31,33,35,36,38,39,40,40,41,41,41,42,42,42,42,42,42
E01030990,EV motorcycles,Number,0,1,1,2,4,5,6,8,9,11,12,14,15,16,17,18,19,20,20,21,21,21,22,22,22,22,22,22,22,22
E01030991,EV motorcycles,Number,1,1,2,4,6,8,10,13,15,18,20,22,25,27,28,30,31,32,33,34,35,35,35,35,36,36,36,36,36,36
E01030992,EV motorcycles,Number,0,1,2,3,4,5,7,9,10,12,13,15,16,18,19,20,21,22,22,23,23,23,23,24,24,24,24,24,24,24
E01030993,EV motorcycles,Number,1,1,2,4,6,8,10,12,15,17,20,22,24,26,28,29,30,31,32,33,34,34,34,34,35,35,35,35,35,35
E01030994,EV motorcycles,Number,1,1,2,4,6,8,11,13,16,18,21,23,25,27,29,31,32,33,34,35,35,36,36,36,37,37,37,37,37,37
E01030995,EV motorcycles,Number,1,2,3,5,8,11,14,17,21,24,27,31,33,36,39,41,43,44,45,46,47,48,48,48,48,49,49,49,49,49
E01030996,EV motorcycles,Number,0,1,2,3,5,7,9,11,13,15,17,19,21,23,24,26,27,28,29,29,30,30,30,31,31,31,31,31,31,31
E01030997,EV motorcycles,Number,0,1,2,4,6,8,10,12,14,17,19,21,23,25,27,28,30,31,31,32,33,33,33,33,34,34,34,34,34,34
E01030998,EV motorcycles,Number,0,1,2,3,5,6,8,10,12,14,16,17,19,21,22,23,24,25,26,26,27,27,27,28,28,28,28,28,28,28
E01030999,EV motorcycles,Number,1,1,3,4,7,9,12,14,17,20,22,25,27,30,32,33,35,36,37,38,38,39,39,39,40,40,40,40,40,40
E01031000,EV motorcycles,Number,1,1,3,4,7,9,11,14,16,19,22,24,27,29,31,32,34,35,36,37,37,38,38,38,39,39,39,39,39,39
E01031001,EV motorcycles,Number,1,2,4,6,9,12,16,20,23,27,31,34,38,41,43,46,48,49,51,52,53,53,54,54,54,55,55,55,55,55
E01031002,EV motorcycles,Number,1,1,3,5,7,9,12,15,17,20,23,26,28,30,32,34,36,37,38,39,39,40,40,40,41,41,41,41,41,41
E01031003,EV motorcycles,Number,0,1,2,3,5,7,9,11,13,15,17,19,21,23,24,26,27,28,29,29,30,30,30,31,31,31,31,31,31,31
E01031004,EV motorcycles,Number,1,2,3,6,9,11,15,18,22,25,29,32,35,38,40,42,44,46,47,48,49,49,50,50,50,51,51,51,51,51
E01031338,EV motorcycles,Number,0,1,1,2,4,5,6,7,9,10,12,13,14,16,17,17,18,19,19,20,20,20,21,21,21,21,21,21,21,21
E01031339,EV motorcycles,Number,0,1,2,4,6,8,10,12,14,17,19,21,23,25,27,28,30,31,31,32,33,33,33,33,34,34,34,34,34,34
E01031340,EV motorcycles,Number,0,1,2,3,5,6,8,10,11,13,15,17,18,20,21,22,23,24,25,25,26,26,26,27,27,27,27,27,27,27
E01031341,EV motorcycles,Number,1,2,3,5,7,10,13,16,19,22,25,27,30,33,35,37,38,40,41,42,42,43,43,43,44,44,44,44,44,44
E01031342,EV motorcycles,Number,1,2,3,5,8,11,14,17,21,24,27,31,33,36,39,41,43,44,45,46,47,48,48,48,48,49,49,49,49,49
E01031343,EV motorcycles,Number,1,1,3,4,7,9,12,14,17,20,22,25,27,30,32,33,35,36,37,38,38,39,39,39,40,40,40,40,40,40
E01031344,EV motorcycles,Number,1,2,3,6,9,12,15,19,22,26,30,33,36,39,42,44,46,48,49,50,51,51,52,52,52,53,53,53,53,53
E01031345,EV motorcycles,Number,1,2,5,8,12,15,20,25,29,34,39,43,47,51,54,57,60,62,64,65,66,67,68,68,68,69,69,69,69,69
E01031346,EV motorcycles,Number,1,2,4,7,11,14,19,23,27,31,36,40,44,47,50,53,56,58,59,60,61,62,63,63,63,64,64,64,64,64
E01031347,EV motorcycles,Number,1,2,3,5,7,10,13,16,19,22,25,27,30,33,35,37,38,40,41,42,42,43,43,43,44,44,44,44,44,44
E01031348,EV motorcycles,Number,2,5,9,15,22,30,38,47,56,65,74,83,91,98,105,111,116,120,123,126,128,129,130,131,132,132,133,133,133,133
E01031349,EV motorcycles,Number,1,2,4,6,9,12,16,19,23,27,30,34,37,40,43,45,47,49,50,51,52,52,53,53,53,54,54,54,54,54
E01031350,EV motorcycles,Number,1,1,2,4,6,8,10,12,15,17,20,22,24,26,28,29,30,31,32,33,34,34,34,34,35,35,35,35,35,35
E01031351,EV motorcycles,Number,1,2,3,5,7,9,12,15,18,21,24,26,29,31,33,35,36,38,39,40,40,41,41,41,42,42,42,42,42,42
E01031352,EV motorcycles,Number,1,2,3,5,7,10,13,16,19,22,25,27,30,33,35,37,38,40,41,42,42,43,43,43,44,44,44,44,44,44
E01031353,EV motorcycles,Number,1,2,3,5,8,10,13,16,19,22,25,28,31,33,35,37,39,40,42,42,43,44,44,44,45,45,45,45,45,45
E01031354,EV motorcycles,Number,1,2,4,7,10,13,17,21,25,29,33,37,40,44,47,49,51,53,55,56,57,57,58,58,58,59,59,59,59,59
E01031355,EV motorcycles,Number,1,2,4,7,11,14,19,23,27,31,36,40,44,47,50,53,56,58,59,60,61,62,63,63,63,64,64,64,64,64
E01031356,EV motorcycles,Number,1,3,5,8,12,16,21,26,30,35,40,45,49,53,57,60,63,65,67,68,69,70,70,71,71,71,72,72,72,72
E01031357,EV motorcycles,Number,1,2,4,6,10,13,17,21,25,29,32,36,40,43,46,48,50,52,54,55,56,56,57,57,57,58,58,58,58,58
E01031358,EV motorcycles,Number,1,2,4,7,10,13,17,21,25,30,34,37,41,44,47,50,52,54,55,57,58,58,59,59,59,60,60,60,60,60
E01031359,EV motorcycles,Number,1,2,3,5,7,10,13,16,19,22,25,27,30,33,35,37,38,40,41,42,42,43,43,43,44,44,44,44,44,44
E01031360,EV motorcycles,Number,1,2,3,5,8,10,13,16,19,22,25,28,31,33,35,37,39,40,42,42,43,44,44,44,45,45,45,45,45,45
E01031361,EV motorcycles,Number,1,2,4,7,10,14,18,22,26,30,35,39,42,46,49,52,54,56,57,59,59,60,61,61,61,62,62,62,62,62
E01031362,EV motorcycles,Number,1,2,4,7,11,15,19,23,27,32,36,40,44,48,51,54,56,58,60,61,62,63,64,64,64,65,65,65,65,65
E01031363,EV motorcycles,Number,1,2,4,6,9,13,16,20,24,28,31,35,38,41,44,47,49,50,52,53,54,54,55,55,55,56,56,56,56,56
E01031364,EV motorcycles,Number,1,1,2,4,6,8,11,13,16,18,21,23,25,27,29,31,32,33,34,35,35,36,36,36,37,37,37,37,37,37
E01031365,EV motorcycles,Number,1,1,3,4,7,9,11,14,16,19,22,24,27,29,31,32,34,35,36,37,37,38,38,38,39,39,39,39,39,39
E01031366,EV motorcycles,Number,1,2,3,5,8,11,14,17,20,23,26,29,32,35,37,39,41,42,43,44,45,46,46,46,47,47,47,47,47,47
E01031367,EV motorcycles,Number,0,1,2,4,6,7,10,12,14,16,18,21,23,24,26,27,29,30,31,31,32,32,32,33,33,33,33,33,33,33
E01031368,EV motorcycles,Number,1,1,3,5,7,9,12,15,17,20,23,26,28,30,32,34,36,37,38,39,39,40,40,40,41,41,41,41,41,41
E01031369,EV motorcycles,Number,0,1,1,2,3,4,5,7,8,9,11,12,13,14,15,16,17,17,18,18,18,18,19,19,19,19,19,19,19,19
E01031370,EV motorcycles,Number,1,2,3,5,8,11,14,17,21,24,27,31,33,36,39,41,43,44,45,46,47,48,48,48,48,49,49,49,49,49
E01031371,EV motorcycles,Number,1,1,3,4,7,9,11,14,16,19,22,24,27,29,31,32,34,35,36,37,37,38,38,38,39,39,39,39,39,39
E01031372,EV motorcycles,Number,1,1,3,4,7,9,11,14,16,19,22,24,27,29,31,32,34,35,36,37,37,38,38,38,39,39,39,39,39,39
E01031373,EV motorcycles,Number,1,2,3,6,9,11,15,18,22,25,29,32,35,38,40,42,44,46,47,48,49,49,50,50,50,51,51,51,51,51
E01031374,EV motorcycles,Number,1,2,3,5,7,9,12,15,18,21,24,26,29,31,33,35,36,38,39,40,40,41,41,41,42,42,42,42,42,42
E01031375,EV motorcycles,Number,1,1,2,4,6,9,11,13,16,19,21,24,26,28,30,32,33,34,35,36,36,37,37,37,38,38,38,38,38,38
E01031376,EV motorcycles,Number,1,2,3,5,8,10,13,16,19,22,25,28,31,33,35,37,39,40,42,42,43,44,44,44,45,45,45,45,45,45
E01031377,EV motorcycles,Number,1,2,3,6,9,11,15,18,22,25,29,32,35,38,40,42,44,46,47,48,49,49,50,50,50,51,51,51,51,51
E01031378,EV motorcycles,Number,1,2,4,7,11,14,18,22,27,31,35,39,43,47,50,52,55,57,58,59,60,61,62,62,62,63,63,63,63,63
E01031379,EV motorcycles,Number,1,1,3,5,7,9,12,15,17,20,23,26,28,30,32,34,36,37,38,39,39,40,40,40,41,41,41,41,41,41
E01031386,EV motorcycles,Number,1,2,3,5,8,11,14,17,20,23,26,29,32,35,37,39,41,43,44,45,45,46,46,47,47,47,47,47,47,47
E01031387,EV motorcycles,Number,1,2,4,6,9,12,16,19,23,27,30,34,37,40,43,45,47,49,50,51,52,52,53,53,53,54,54,54,54,54
E01031388,EV motorcycles,Number,1,3,5,9,14,18,24,29,35,40,46,51,56,61,65,68,71,74,76,77,79,80,80,81,81,81,82,82,82,82
E01031389,EV motorcycles,Number,1,2,3,5,8,11,14,17,20,23,26,29,32,35,37,39,41,42,43,44,45,46,46,46,47,47,47,47,47,47
E01031392,EV motorcycles,Number,0,0,0,0,0,0,0,0,0,0,0,0,0,0,0,0,0,0,0,0,0,0,0,0,0,0,0,0,0,0
E01031398,EV motorcycles,Number,1,2,3,5,8,10,13,16,19,22,25,28,31,33,35,37,39,40,42,42,43,44,44,44,45,45,45,45,45,45
E01031399,EV motorcycles,Number,1,1,2,4,6,9,11,13,16,19,21,24,26,28,30,32,33,34,35,36,36,37,37,37,38,38,38,38,38,38
E01031400,EV motorcycles,Number,0,1,2,3,5,7,9,11,13,15,17,19,21,23,24,26,27,28,29,29,30,30,30,31,31,31,31,31,31,31
E01031407,EV motorcycles,Number,0,1,2,3,5,7,9,11,13,15,17,19,21,23,24,26,27,28,29,29,30,30,30,31,31,31,31,31,31,31
E01031408,EV motorcycles,Number,1,2,4,7,10,14,18,22,26,30,35,39,42,46,49,52,54,56,57,59,59,60,61,61,61,62,62,62,62,62
E01031409,EV motorcycles,Number,1,2,3,5,8,10,13,16,19,22,25,28,31,33,35,37,39,40,42,42,43,44,44,44,45,45,45,45,45,45
E01031410,EV motorcycles,Number,0,1,2,3,5,7,9,11,13,15,17,19,21,23,24,26,27,28,29,29,30,30,30,31,31,31,31,31,31,31
E01031411,EV motorcycles,Number,0,1,2,3,5,7,9,11,13,15,17,19,21,22,24,25,26,27,28,28,29,29,29,30,30,30,30,30,30,30
E01031412,EV motorcycles,Number,1,2,3,5,7,10,13,16,19,22,25,27,30,33,35,37,38,40,41,42,42,43,43,43,44,44,44,44,44,44
E01031413,EV motorcycles,Number,1,1,3,4,7,9,11,14,16,19,22,24,27,29,31,32,34,35,36,37,37,38,38,38,39,39,39,39,39,39
E01031414,EV motorcycles,Number,1,2,3,5,7,10,13,16,19,22,25,27,30,33,35,37,38,40,41,42,42,43,43,43,44,44,44,44,44,44
E01031415,EV motorcycles,Number,0,1,2,3,4,6,8,9,11,13,15,16,18,19,20,22,23,23,24,25,25,25,25,26,26,26,26,26,26,26
E01031422,EV motorcycles,Number,1,2,3,5,7,10,13,16,19,22,25,27,30,33,35,37,38,40,41,42,42,43,43,43,44,44,44,44,44,44
E01031423,EV motorcycles,Number,1,2,3,5,8,11,14,17,21,24,27,31,33,36,39,41,43,44,45,46,47,48,48,48,48,49,49,49,49,49
E01031424,EV motorcycles,Number,0,1,2,3,4,6,7,9,11,12,14,16,17,18,20,21,22,22,23,24,24,24,24,25,25,25,25,25,25,25
E01031425,EV motorcycles,Number,1,2,4,7,11,15,19,24,28,33,37,42,46,50,53,56,58,60,62,63,64,65,66,66,66,67,67,67,67,67
E01031426,EV motorcycles,Number,1,1,3,4,7,9,12,14,17,20,22,25,27,30,32,33,35,36,37,38,38,39,39,39,40,40,40,40,40,40
E01031427,EV motorcycles,Number,1,1,2,4,6,8,10,13,15,18,20,22,25,27,28,30,31,32,33,34,35,35,35,35,36,36,36,36,36,36
E01031428,EV motorcycles,Number,0,1,2,4,5,7,9,11,14,16,18,20,22,24,25,27,28,29,30,30,31,31,31,32,32,32,32,32,32,32
E01031429,EV motorcycles,Number,1,1,2,4,6,8,10,13,15,18,20,22,25,27,28,30,31,32,33,34,35,35,35,35,36,36,36,36,36,36
E01031430,EV motorcycles,Number,1,1,2,4,6,8,11,13,16,18,21,23,25,27,29,31,32,33,34,35,35,36,36,36,37,37,37,37,37,37
E01031454,EV motorcycles,Number,1,2,3,5,7,9,12,15,18,21,24,26,29,31,33,35,36,38,39,40,40,41,41,41,42,42,42,42,42,42
E01031455,EV motorcycles,Number,0,1,2,3,4,5,7,8,10,11,13,14,16,17,18,19,20,21,21,22,22,22,23,23,23,23,23,23,23,23
E01031456,EV motorcycles,Number,0,1,2,3,5,6,8,10,11,13,15,17,18,20,21,22,23,24,25,25,26,26,26,27,27,27,27,27,27,27
E01031457,EV motorcycles,Number,0,1,2,3,5,7,8,10,12,14,16,18,20,21,23,24,25,26,27,27,28,28,28,29,29,29,29,29,29,29
E01031458,EV motorcycles,Number,1,2,3,5,8,10,13,16,19,23,26,29,31,34,36,38,40,41,43,43,44,45,45,45,46,46,46,46,46,46
E01031459,EV motorcycles,Number,1,2,4,7,11,15,19,23,27,32,36,40,44,48,51,54,56,58,60,61,62,63,64,64,64,65,65,65,65,65
E01031460,EV motorcycles,Number,0,1,2,4,6,8,10,12,14,17,19,21,23,25,27,28,30,31,31,32,33,33,33,33,34,34,34,34,34,34
E01031461,EV motorcycles,Number,1,2,3,5,7,9,12,15,18,21,24,26,29,31,33,35,36,38,39,40,40,41,41,41,42,42,42,42,42,42
E01031462,EV motorcycles,Number,1,3,5,8,12,16,20,25,30,34,39,44,48,52,55,58,61,63,65,66,67,68,69,69,69,70,70,70,70,70
E01031463,EV motorcycles,Number,1,2,4,7,10,14,18,22,26,30,35,39,42,46,49,52,54,56,57,59,59,60,61,61,61,62,62,62,62,62
E01031464,EV motorcycles,Number,0,1,2,3,5,6,8,10,12,14,16,17,19,21,22,23,24,25,26,26,27,27,27,28,28,28,28,28,28,28
E01031467,EV motorcycles,Number,1,2,3,5,7,9,12,15,18,20,23,26,28,31,33,35,36,37,38,39,40,40,41,41,41,41,42,42,42,42
E01031468,EV motorcycles,Number,1,2,4,7,10,14,18,22,26,30,34,38,42,45,48,51,53,55,56,57,58,59,60,60,60,60,61,61,61,61
E01031469,EV motorcycles,Number,1,2,4,7,10,13,17,21,25,29,33,37,40,44,47,49,51,53,55,56,57,57,58,58,58,59,59,59,59,59
E01031479,EV motorcycles,Number,0,0,0,0,0,0,0,0,0,0,0,0,0,0,0,0,0,0,0,0,0,0,0,0,0,0,0,0,0,0
E01031516,EV motorcycles,Number,0,0,0,0,0,0,0,0,0,0,0,0,0,0,0,0,0,0,0,0,0,0,0,0,0,0,0,0,0,0
E01031546,EV motorcycles,Number,0,1,1,2,4,5,6,8,9,11,12,14,15,16,17,18,19,20,20,21,21,21,22,22,22,22,22,22,22,22
E01031547,EV motorcycles,Number,0,1,1,2,4,5,6,8,9,11,12,14,15,16,17,18,19,20,20,21,21,21,22,22,22,22,22,22,22,22
E01031548,EV motorcycles,Number,0,1,2,3,4,5,7,9,10,12,13,15,16,18,19,20,21,22,22,23,23,23,23,24,24,24,24,24,24,24
E01031549,EV motorcycles,Number,0,1,2,4,6,8,10,12,14,17,19,21,23,25,27,28,30,31,31,32,33,33,33,33,34,34,34,34,34,34
E01031550,EV motorcycles,Number,0,1,2,3,4,5,7,9,10,12,13,15,16,18,19,20,21,22,22,23,23,23,23,24,24,24,24,24,24,24
E01031551,EV motorcycles,Number,0,1,2,3,4,5,7,8,10,11,13,14,16,17,18,19,20,21,21,22,22,22,23,23,23,23,23,23,23,23
E01031552,EV motorcycles,Number,0,1,1,2,4,5,6,8,9,11,12,14,15,16,17,18,19,20,20,21,21,21,22,22,22,22,22,22,22,22
E01031553,EV motorcycles,Number,1,1,3,4,7,9,11,14,16,19,22,24,27,29,31,32,34,35,36,37,37,38,38,38,39,39,39,39,39,39
E01031554,EV motorcycles,Number,0,1,2,4,5,7,9,11,14,16,18,20,22,24,25,27,28,29,30,30,31,31,31,32,32,32,32,32,32,32
E01031555,EV motorcycles,Number,0,1,1,2,3,4,5,6,7,8,9,10,11,12,13,13,14,14,15,15,15,16,16,16,16,16,16,16,16,16
E01031556,EV motorcycles,Number,0,1,2,4,6,8,10,12,14,17,19,21,23,25,27,28,30,31,31,32,33,33,33,33,34,34,34,34,34,34
E01031557,EV motorcycles,Number,1,3,5,8,13,17,22,27,32,37,42,47,51,55,59,62,65,67,69,71,72,73,73,74,74,74,75,75,75,75
E01031558,EV motorcycles,Number,0,1,1,2,3,4,5,6,8,9,10,11,12,13,14,15,16,16,17,17,17,17,18,18,18,18,18,18,18,18
E01031559,EV motorcycles,Number,0,1,2,3,4,5,7,9,10,12,13,15,16,18,19,20,21,22,22,23,23,23,23,24,24,24,24,24,24,24
E01031560,EV motorcycles,Number,1,2,3,6,9,12,15,18,22,26,29,32,36,38,41,43,45,47,48,49,50,50,51,51,51,52,52,52,52,52
E01031561,EV motorcycles,Number,1,1,3,4,7,9,11,14,16,19,22,24,27,29,31,32,34,35,36,37,37,38,38,38,39,39,39,39,39,39
E01031562,EV motorcycles,Number,0,1,1,2,3,4,5,6,8,9,10,11,12,13,14,15,16,16,17,17,17,17,18,18,18,18,18,18,18,18
E01031563,EV motorcycles,Number,1,1,2,4,6,8,11,13,16,18,21,23,25,27,29,31,32,33,34,35,35,36,36,36,37,37,37,37,37,37
E01031564,EV motorcycles,Number,1,2,3,5,7,10,12,15,18,21,24,27,29,32,34,36,37,39,40,41,41,42,42,42,43,43,43,43,43,43
E01031565,EV motorcycles,Number,0,1,2,4,6,8,10,12,14,17,19,21,23,25,27,28,30,31,31,32,33,33,33,33,34,34,34,34,34,34
E01031566,EV motorcycles,Number,1,1,2,4,6,8,11,13,16,18,21,23,25,27,29,31,32,33,34,35,35,36,36,36,37,37,37,37,37,37
E01031567,EV motorcycles,Number,1,1,2,4,6,9,11,13,16,19,21,24,26,28,30,32,33,34,35,36,36,37,37,37,38,38,38,38,38,38
E01031568,EV motorcycles,Number,1,1,2,4,6,8,10,13,15,18,20,22,25,27,28,30,31,32,33,34,35,35,35,35,36,36,36,36,36,36
E01031569,EV motorcycles,Number,0,1,2,4,5,7,9,11,14,16,18,20,22,24,25,27,28,29,30,30,31,31,31,32,32,32,32,32,32,32
E01031570,EV motorcycles,Number,1,2,3,5,7,9,12,15,18,21,24,26,29,31,33,35,36,38,39,40,40,41,41,41,42,42,42,42,42,42
E01031571,EV motorcycles,Number,1,1,2,4,6,8,11,13,16,18,21,23,25,27,29,31,32,33,34,35,35,36,36,36,37,37,37,37,37,37
E01031572,EV motorcycles,Number,0,1,2,3,5,6,8,10,12,14,16,17,19,21,22,23,24,25,26,26,27,27,27,28,28,28,28,28,28,28
E01031573,EV motorcycles,Number,0,1,2,4,6,8,10,12,14,17,19,21,23,25,27,28,30,31,31,32,33,33,33,33,34,34,34,34,34,34
E01031574,EV motorcycles,Number,1,2,3,5,7,9,12,15,18,21,24,26,29,31,33,35,36,38,39,40,40,41,41,41,42,42,42,42,42,42
E01031575,EV motorcycles,Number,1,1,2,4,6,8,11,13,16,18,21,23,25,27,29,31,32,33,34,35,35,36,36,36,37,37,37,37,37,37
E01031576,EV motorcycles,Number,0,0,0,1,1,2,2,2,3,3,4,4,5,5,6,6,6,6,6,7,7,7,7,7,7,7,7,7,7,7
E01031577,EV motorcycles,Number,0,0,1,1,2,2,3,4,5,5,6,7,8,8,9,9,10,10,10,10,11,11,11,11,11,11,11,11,11,11
E01031578,EV motorcycles,Number,1,2,3,5,8,10,13,16,19,23,26,29,31,34,36,38,40,41,43,43,44,45,45,45,46,46,46,46,46,46
E01031579,EV motorcycles,Number,1,2,3,5,8,10,13,16,19,22,25,28,31,33,35,37,39,40,42,42,43,44,44,44,45,45,45,45,45,45
E01031580,EV motorcycles,Number,1,2,3,5,8,10,13,16,19,22,25,28,31,33,35,37,39,40,42,42,43,44,44,44,45,45,45,45,45,45
E01031581,EV motorcycles,Number,0,1,2,3,5,6,8,10,12,14,16,17,19,21,22,23,24,25,26,26,27,27,27,28,28,28,28,28,28,28
E01031582,EV motorcycles,Number,1,2,3,5,7,9,12,15,18,21,24,26,29,31,33,35,36,38,39,40,40,41,41,41,42,42,42,42,42,42
E01031583,EV motorcycles,Number,1,3,6,10,15,20,25,31,37,43,49,54,59,64,69,72,76,78,80,82,83,84,85,86,86,86,87,87,87,87
E01031584,EV motorcycles,Number,0,1,2,3,5,7,9,11,13,15,17,19,21,22,24,25,26,27,28,28,29,29,29,30,30,30,30,30,30,30
E01031585,EV motorcycles,Number,0,1,2,3,5,7,9,11,13,15,17,19,21,23,24,26,27,28,29,29,30,30,30,31,31,31,31,31,31,31
E01031586,EV motorcycles,Number,0,1,2,3,5,7,9,11,13,15,17,19,21,22,24,25,26,27,28,28,29,29,29,30,30,30,30,30,30,30
E01031587,EV motorcycles,Number,1,3,5,8,13,17,22,27,33,38,43,48,53,57,61,64,67,69,71,73,74,75,75,76,76,76,77,77,77,77
E01031588,EV motorcycles,Number,1,1,2,4,6,8,11,13,16,18,21,23,25,27,29,31,32,33,34,35,35,36,36,36,37,37,37,37,37,37
E01031589,EV motorcycles,Number,1,1,2,4,6,9,11,13,16,19,21,24,26,28,30,32,33,34,35,36,36,37,37,37,38,38,38,38,38,38
E01031590,EV motorcycles,Number,1,1,2,4,6,8,10,13,15,18,20,22,25,27,28,30,31,32,33,34,35,35,35,35,36,36,36,36,36,36
E01031591,EV motorcycles,Number,1,1,2,4,6,8,11,13,16,18,21,23,25,27,29,31,32,33,34,35,35,36,36,36,37,37,37,37,37,37
E01031592,EV motorcycles,Number,1,2,3,5,7,10,13,16,19,22,25,27,30,33,35,37,38,40,41,42,42,43,43,43,44,44,44,44,44,44
E01031593,EV motorcycles,Number,0,1,2,3,5,6,8,10,11,13,15,17,18,20,21,22,23,24,25,25,26,26,26,27,27,27,27,27,27,27
E01031594,EV motorcycles,Number,0,1,2,3,5,7,9,11,13,15,17,19,21,22,24,25,26,27,28,28,29,29,29,30,30,30,30,30,30,30
E01031595,EV motorcycles,Number,0,1,2,3,4,6,7,9,11,12,14,16,17,18,20,21,22,22,23,24,24,24,24,25,25,25,25,25,25,25
E01031596,EV motorcycles,Number,1,1,3,4,7,9,12,14,17,20,22,25,27,30,32,33,35,36,37,38,38,39,39,39,40,40,40,40,40,40
E01031597,EV motorcycles,Number,0,1,2,4,5,7,9,11,14,16,18,20,22,24,25,27,28,29,30,30,31,31,31,32,32,32,32,32,32,32
E01031598,EV motorcycles,Number,0,1,2,3,5,6,8,10,11,13,15,17,18,20,21,22,23,24,25,25,26,26,26,27,27,27,27,27,27,27
E01031599,EV motorcycles,Number,0,1,2,3,5,7,8,10,12,14,16,18,20,21,23,24,25,26,27,27,28,28,28,29,29,29,29,29,29,29
E01031600,EV motorcycles,Number,1,1,3,4,7,9,11,14,16,19,22,24,27,29,31,32,34,35,36,37,37,38,38,38,39,39,39,39,39,39
E01031601,EV motorcycles,Number,0,1,2,4,6,7,10,12,14,16,18,21,23,24,26,27,29,30,31,31,32,32,32,33,33,33,33,33,33,33
E01031603,EV motorcycles,Number,0,1,2,3,5,7,9,11,13,15,17,19,21,23,24,26,27,28,29,29,30,30,30,31,31,31,31,31,31,31
E01031604,EV motorcycles,Number,0,1,2,3,4,6,7,9,11,12,14,16,17,18,20,21,22,22,23,24,24,24,24,25,25,25,25,25,25,25
E01031605,EV motorcycles,Number,0,1,2,3,4,6,7,9,11,12,14,16,17,18,20,21,22,22,23,24,24,24,24,25,25,25,25,25,25,25
E01031606,EV motorcycles,Number,0,1,2,3,5,7,9,11,13,15,17,19,21,23,24,26,27,28,29,29,30,30,30,31,31,31,31,31,31,31
E01031607,EV motorcycles,Number,0,1,2,3,5,7,9,11,13,15,17,19,21,23,24,26,27,28,29,29,30,30,30,31,31,31,31,31,31,31
E01031608,EV motorcycles,Number,1,2,3,5,8,11,14,17,20,23,26,29,32,35,37,39,41,42,43,44,45,46,46,46,47,47,47,47,47,47
E01031609,EV motorcycles,Number,0,1,2,3,5,6,8,10,11,13,15,17,18,20,21,22,23,24,25,25,26,26,26,27,27,27,27,27,27,27
E01031610,EV motorcycles,Number,0,1,2,3,4,6,8,9,11,13,15,16,18,19,20,22,23,23,24,25,25,25,25,26,26,26,26,26,26,26
E01031611,EV motorcycles,Number,1,3,5,9,13,18,23,28,33,39,44,49,54,58,62,65,68,70,72,74,75,76,77,77,78,78,78,78,78,78
E01031616,EV motorcycles,Number,1,2,4,6,10,13,16,20,24,28,32,35,39,42,45,47,50,51,53,54,55,55,56,56,56,57,57,57,57,57
E01031617,EV motorcycles,Number,1,3,6,10,16,21,27,33,40,46,53,59,64,69,74,78,82,85,87,89,90,91,92,93,93,93,94,94,94,94
E01031618,EV motorcycles,Number,1,2,4,6,9,12,16,19,23,27,30,34,37,40,43,45,47,49,50,51,52,52,53,53,53,54,54,54,54,54
E01031619,EV motorcycles,Number,1,3,5,8,13,17,22,27,32,37,42,47,51,56,59,63,65,68,70,71,72,73,74,74,74,75,75,75,75,75
E01031620,EV motorcycles,Number,1,2,3,6,9,12,15,19,22,26,30,33,36,39,42,44,46,48,49,50,51,51,52,52,52,53,53,53,53,53
E01031621,EV motorcycles,Number,1,3,5,8,12,16,21,25,30,35,40,44,49,52,56,59,62,64,66,67,68,69,70,70,70,71,71,71,71,71
E01031622,EV motorcycles,Number,1,3,5,9,13,18,23,28,33,38,44,49,53,58,61,65,68,70,72,74,75,76,76,77,77,77,78,78,78,78
E01031623,EV motorcycles,Number,1,3,5,8,12,16,21,25,30,35,40,44,49,52,56,59,62,64,66,67,68,69,70,70,70,71,71,71,71,71
E01031624,EV motorcycles,Number,2,4,7,11,17,23,30,37,44,51,58,65,71,77,82,86,90,94,96,98,100,101,102,102,103,103,104,104,104,104
E01031625,EV motorcycles,Number,1,3,5,8,13,17,22,27,32,37,42,47,51,55,59,62,65,67,69,71,72,73,73,74,74,74,75,75,75,75
E01031626,EV motorcycles,Number,0,1,2,3,5,7,8,10,12,14,16,18,20,21,23,24,25,26,27,27,28,28,28,29,29,29,29,29,29,29
E01031627,EV motorcycles,Number,1,2,4,7,11,14,19,23,27,31,36,40,44,47,50,53,56,58,59,60,61,62,63,63,63,64,64,64,64,64
E01031628,EV motorcycles,Number,1,2,4,7,11,14,19,23,27,31,36,40,44,47,50,53,56,58,59,60,61,62,63,63,63,64,64,64,64,64
E01031629,EV motorcycles,Number,1,3,5,8,13,17,22,27,32,37,42,47,51,55,59,62,65,67,69,71,72,73,73,74,74,74,75,75,75,75
E01031630,EV motorcycles,Number,1,1,2,4,6,8,11,13,16,18,21,23,25,27,29,31,32,33,34,35,35,36,36,36,37,37,37,37,37,37
E01031631,EV motorcycles,Number,1,2,4,6,9,12,16,19,23,27,30,34,37,40,43,45,47,49,50,51,52,52,53,53,53,54,54,54,54,54
E01031632,EV motorcycles,Number,1,3,5,8,12,16,21,26,31,36,41,45,50,54,58,61,63,66,67,69,70,71,71,72,72,72,73,73,73,73
E01031633,EV motorcycles,Number,1,2,4,7,11,14,19,23,27,31,36,40,44,47,50,53,56,58,59,60,61,62,63,63,63,64,64,64,64,64
E01031634,EV motorcycles,Number,1,2,3,5,8,10,13,16,19,23,26,29,31,34,36,38,40,41,43,43,44,45,45,45,46,46,46,46,46,46
E01031635,EV motorcycles,Number,1,2,3,6,9,12,15,18,22,26,29,32,36,38,41,43,45,47,48,49,50,50,51,51,51,52,52,52,52,52
E01031636,EV motorcycles,Number,1,2,3,5,8,10,13,16,19,23,26,29,31,34,36,38,40,41,43,43,44,45,45,45,46,46,46,46,46,46
E01031637,EV motorcycles,Number,1,2,4,7,11,15,20,24,29,33,38,42,46,50,54,57,59,61,63,64,65,66,67,67,67,68,68,68,68,68
E01031638,EV motorcycles,Number,1,2,3,6,9,12,15,19,22,26,30,33,36,39,42,44,46,48,49,50,51,51,52,52,52,53,53,53,53,53
E01031639,EV motorcycles,Number,1,1,2,4,6,8,10,12,15,17,20,22,24,26,28,29,30,31,32,33,34,34,34,34,35,35,35,35,35,35
E01031640,EV motorcycles,Number,1,1,2,4,6,8,10,13,15,18,20,22,25,27,28,30,31,32,33,34,35,35,35,35,36,36,36,36,36,36
E01031641,EV motorcycles,Number,0,1,2,4,5,7,9,11,14,16,18,20,22,24,25,27,28,29,30,30,31,31,31,32,32,32,32,32,32,32
E01031642,EV motorcycles,Number,1,3,5,9,14,19,24,29,35,41,46,52,57,61,65,69,72,75,77,78,80,81,81,82,82,82,83,83,83,83
E01031643,EV motorcycles,Number,1,2,3,5,7,10,13,16,19,22,25,27,30,33,35,37,38,40,41,42,42,43,43,43,44,44,44,44,44,44
E01031644,EV motorcycles,Number,1,1,3,4,7,9,11,14,16,19,22,24,27,29,31,32,34,35,36,37,37,38,38,38,39,39,39,39,39,39
E01031645,EV motorcycles,Number,1,2,4,6,9,13,16,20,24,28,31,35,38,41,44,47,49,50,52,53,54,54,55,55,55,56,56,56,56,56
E01031646,EV motorcycles,Number,1,1,2,4,6,8,10,13,15,18,20,22,25,27,28,30,31,32,33,34,35,35,35,35,36,36,36,36,36,36
E01031647,EV motorcycles,Number,0,1,2,3,4,6,8,9,11,13,15,16,18,19,20,22,23,23,24,25,25,25,25,26,26,26,26,26,26,26
E01031648,EV motorcycles,Number,0,1,2,3,5,7,9,11,13,15,17,19,21,23,24,26,27,28,29,29,30,30,30,31,31,31,31,31,31,31
E01031649,EV motorcycles,Number,0,1,2,3,4,6,8,9,11,13,15,16,18,19,20,22,23,23,24,25,25,25,25,26,26,26,26,26,26,26
E01031650,EV motorcycles,Number,0,1,1,2,4,5,6,8,9,11,12,14,15,16,17,18,19,20,20,21,21,21,22,22,22,22,22,22,22,22
E01031651,EV motorcycles,Number,0,1,2,3,5,6,8,10,12,14,16,17,19,21,22,23,24,25,26,26,27,27,27,28,28,28,28,28,28,28
E01031652,EV motorcycles,Number,0,1,2,3,5,7,9,11,13,15,17,19,21,23,24,26,27,28,29,29,30,30,30,31,31,31,31,31,31,31
E01031653,EV motorcycles,Number,1,2,3,5,7,10,12,15,18,21,24,27,29,32,34,36,37,39,40,41,41,42,42,42,43,43,43,43,43,43
E01031654,EV motorcycles,Number,1,1,2,4,6,8,11,13,16,18,21,23,25,27,29,31,32,33,34,35,35,36,36,36,37,37,37,37,37,37
E01031655,EV motorcycles,Number,0,1,2,4,5,7,9,11,14,16,18,20,22,24,25,27,28,29,30,30,31,31,31,32,32,32,32,32,32,32
E01031656,EV motorcycles,Number,0,1,2,3,5,7,9,11,13,15,17,19,21,23,24,26,27,28,29,29,30,30,30,31,31,31,31,31,31,31
E01031657,EV motorcycles,Number,0,0,0,1,1,2,2,2,3,3,4,4,5,5,5,6,6,6,6,6,7,7,7,7,7,7,7,7,7,7
E01031658,EV motorcycles,Number,1,3,6,9,14,19,25,31,36,42,48,54,59,64,68,72,75,77,79,81,82,83,84,85,85,85,86,86,86,86
E01031659,EV motorcycles,Number,0,0,0,0,0,0,0,0,0,1,1,1,1,1,1,1,1,1,1,1,1,1,1,1,1,1,1,1,1,1
E01031660,EV motorcycles,Number,1,2,4,7,10,13,17,21,25,29,33,37,40,44,47,49,51,53,55,56,57,57,58,58,58,59,59,59,59,59
E01031661,EV motorcycles,Number,1,3,5,9,14,18,23,29,34,40,45,50,55,60,64,67,70,73,75,76,78,79,79,80,80,80,81,81,81,81
E01031662,EV motorcycles,Number,1,2,3,6,9,11,15,18,22,25,29,32,35,38,40,42,44,46,47,48,49,49,50,50,50,51,51,51,51,51
E01031663,EV motorcycles,Number,1,3,5,9,14,18,24,29,35,40,46,51,56,61,65,68,71,74,76,77,79,80,80,81,81,81,82,82,82,82
E01031664,EV motorcycles,Number,1,2,4,7,10,14,18,22,26,30,35,39,42,46,49,52,54,56,57,59,59,60,61,61,61,62,62,62,62,62
E01031665,EV motorcycles,Number,0,1,2,3,5,7,8,10,12,14,16,18,20,21,23,24,25,26,27,27,28,28,28,29,29,29,29,29,29,29
E01031666,EV motorcycles,Number,1,1,2,4,6,9,11,13,16,19,21,24,26,28,30,32,33,34,35,36,36,37,37,37,38,38,38,38,38,38
E01031667,EV motorcycles,Number,0,1,2,4,6,7,10,12,14,16,18,21,23,24,26,27,29,30,31,31,32,32,32,33,33,33,33,33,33,33
E01031668,EV motorcycles,Number,0,1,2,3,5,6,8,10,12,14,16,17,19,21,22,23,24,25,26,26,27,27,27,28,28,28,28,28,28,28
E01031669,EV motorcycles,Number,0,1,2,4,5,7,9,11,14,16,18,20,22,24,25,27,28,29,30,30,31,31,31,32,32,32,32,32,32,32
E01031670,EV motorcycles,Number,0,1,2,4,6,7,10,12,14,16,18,21,23,24,26,27,29,30,31,31,32,32,32,33,33,33,33,33,33,33
E01031671,EV motorcycles,Number,1,1,2,4,6,9,11,13,16,19,21,24,26,28,30,32,33,34,35,36,36,37,37,37,38,38,38,38,38,38
E01031672,EV motorcycles,Number,0,1,2,3,4,6,7,9,11,12,14,16,17,18,20,21,22,22,23,24,24,24,24,25,25,25,25,25,25,25
E01031673,EV motorcycles,Number,1,2,3,6,8,11,14,18,21,25,28,31,34,37,39,42,43,45,46,47,48,49,49,49,49,50,50,50,50,50
E01031674,EV motorcycles,Number,0,0,0,0,0,0,0,0,0,0,0,0,0,0,0,0,0,0,0,0,0,0,0,0,0,0,0,0,0,0
E01031675,EV motorcycles,Number,0,0,0,0,0,0,0,1,1,1,1,1,1,1,1,1,1,1,1,1,1,1,1,1,1,1,2,2,2,2
E01031676,EV motorcycles,Number,3,7,13,22,34,46,59,72,86,100,114,126,139,150,160,169,176,183,188,192,195,197,199,200,201,202,203,203,203,203
E01031677,EV motorcycles,Number,1,2,4,6,9,12,16,20,23,27,31,34,38,41,43,46,48,49,51,52,53,53,54,54,54,55,55,55,55,55
E01031678,EV motorcycles,Number,1,2,4,6,10,13,16,20,24,28,32,35,39,42,45,47,50,51,53,54,55,55,56,56,56,57,57,57,57,57
E01031679,EV motorcycles,Number,1,1,2,4,6,9,11,14,16,19,21,24,26,28,30,32,33,34,35,36,37,37,37,38,38,38,38,38,38,38
E01031680,EV motorcycles,Number,1,2,3,5,8,11,14,17,20,24,27,30,33,35,38,40,42,43,44,45,46,47,47,47,48,48,48,48,48,48
E01031681,EV motorcycles,Number,0,1,2,3,5,7,9,11,13,15,17,19,21,23,24,26,27,28,29,29,30,30,30,31,31,31,31,31,31,31
E01031682,EV motorcycles,Number,0,1,2,3,4,6,8,9,11,13,15,16,18,19,20,22,23,23,24,25,25,25,25,26,26,26,26,26,26,26
E01031683,EV motorcycles,Number,1,2,4,7,10,13,17,21,25,30,34,37,41,44,47,50,52,54,55,57,58,58,59,59,59,60,60,60,60,60
E01031684,EV motorcycles,Number,1,2,3,6,9,11,15,18,22,25,29,32,35,38,40,42,44,46,47,48,49,49,50,50,50,51,51,51,51,51
E01031685,EV motorcycles,Number,1,2,3,5,7,10,13,16,19,22,25,27,30,33,35,37,38,40,41,42,42,43,43,43,44,44,44,44,44,44
E01031686,EV motorcycles,Number,1,1,3,4,7,9,12,14,17,20,22,25,27,30,32,33,35,36,37,38,38,39,39,39,40,40,40,40,40,40
E01031687,EV motorcycles,Number,1,3,5,9,14,18,23,29,34,40,45,50,55,60,64,67,70,73,75,76,78,79,79,80,80,80,81,81,81,81
E01031688,EV motorcycles,Number,0,1,2,4,6,8,10,12,14,17,19,21,23,25,27,28,30,31,31,32,33,33,33,33,34,34,34,34,34,34
E01031689,EV motorcycles,Number,0,1,1,2,3,4,6,7,8,10,11,12,14,15,16,17,17,18,18,19,19,19,20,20,20,20,20,20,20,20
E01031690,EV motorcycles,Number,1,2,3,5,7,10,12,15,18,21,24,27,29,32,34,36,37,39,40,41,41,42,42,42,43,43,43,43,43,43
E01031691,EV motorcycles,Number,0,1,2,3,4,5,7,9,10,12,13,15,16,18,19,20,21,22,22,23,23,23,23,24,24,24,24,24,24,24
E01031692,EV motorcycles,Number,2,4,8,14,21,28,36,44,52,61,69,77,85,92,98,103,108,112,115,117,119,120,121,122,123,123,124,124,124,124
E01031693,EV motorcycles,Number,1,2,3,6,8,11,14,18,21,25,28,31,34,37,39,42,43,45,46,47,48,49,49,49,49,50,50,50,50,50
E01031694,EV motorcycles,Number,1,2,3,5,8,11,14,17,20,24,27,30,33,35,38,40,42,43,44,45,46,47,47,47,48,48,48,48,48,48
E01031695,EV motorcycles,Number,1,1,2,4,6,8,10,12,15,17,20,22,24,26,28,29,30,31,32,33,34,34,34,34,35,35,35,35,35,35
E01031696,EV motorcycles,Number,1,2,4,7,10,14,18,22,26,30,35,39,42,46,49,52,54,56,57,59,59,60,61,61,61,62,62,62,62,62
E01031697,EV motorcycles,Number,1,1,2,4,6,8,11,13,16,18,21,23,25,27,29,31,32,33,34,35,35,36,36,36,37,37,37,37,37,37
E01031698,EV motorcycles,Number,1,2,4,7,10,13,17,21,25,30,34,37,41,44,47,50,52,54,55,57,58,58,59,59,59,60,60,60,60,60
E01031699,EV motorcycles,Number,1,1,3,5,7,9,12,15,17,20,23,26,28,30,32,34,36,37,38,39,39,40,40,40,41,41,41,41,41,41
E01031700,EV motorcycles,Number,1,1,2,4,6,8,11,13,16,18,21,23,25,27,29,31,32,33,34,35,35,36,36,36,37,37,37,37,37,37
E01031701,EV motorcycles,Number,1,2,3,6,9,12,15,19,22,26,30,33,36,39,42,44,46,48,49,50,51,51,52,52,52,53,53,53,53,53
E01031702,EV motorcycles,Number,1,1,2,4,6,8,10,12,15,17,20,22,24,26,28,29,30,31,32,33,34,34,34,34,35,35,35,35,35,35
E01031703,EV motorcycles,Number,1,1,3,4,7,9,12,14,17,20,22,25,27,30,32,33,35,36,37,38,38,39,39,39,40,40,40,40,40,40
E01031704,EV motorcycles,Number,1,2,3,6,9,12,15,18,22,26,29,32,36,38,41,43,45,47,48,49,50,50,51,51,51,52,52,52,52,52
E01031705,EV motorcycles,Number,0,1,2,3,5,7,9,11,13,15,17,19,21,22,24,25,26,27,28,28,29,29,29,30,30,30,30,30,30,30
E01031706,EV motorcycles,Number,1,2,4,6,10,13,17,21,25,29,32,36,40,43,46,48,50,52,54,55,56,56,57,57,57,58,58,58,58,58
E01031707,EV motorcycles,Number,0,1,2,3,5,6,8,10,11,13,15,17,18,20,21,22,23,24,25,25,26,26,26,27,27,27,27,27,27,27
E01031708,EV motorcycles,Number,1,1,3,4,7,9,12,14,17,20,22,25,27,30,32,33,35,36,37,38,38,39,39,39,40,40,40,40,40,40
E01031709,EV motorcycles,Number,0,1,2,3,4,6,8,9,11,13,15,16,18,19,20,22,23,23,24,25,25,25,25,26,26,26,26,26,26,26
E01031710,EV motorcycles,Number,1,2,3,5,7,10,13,16,19,22,25,27,30,33,35,37,38,40,41,42,42,43,43,43,44,44,44,44,44,44
E01031711,EV motorcycles,Number,1,3,5,8,13,17,22,27,32,37,43,47,52,56,60,63,66,68,70,72,73,74,74,75,75,75,76,76,76,76
E01031712,EV motorcycles,Number,1,1,3,4,7,9,11,14,16,19,22,24,27,29,31,32,34,35,36,37,37,38,38,38,39,39,39,39,39,39
E01031713,EV motorcycles,Number,1,2,3,5,8,10,13,16,19,22,25,28,31,33,35,37,39,40,42,42,43,44,44,44,45,45,45,45,45,45
E01031714,EV motorcycles,Number,1,2,4,7,11,15,19,24,28,33,37,42,46,50,53,56,58,60,62,63,64,65,66,66,66,67,67,67,67,67
E01031715,EV motorcycles,Number,0,1,2,3,5,7,9,11,13,15,17,19,21,22,24,25,26,27,28,28,29,29,29,30,30,30,30,30,30,30
E01031716,EV motorcycles,Number,1,1,2,4,6,8,10,12,15,17,20,22,24,26,28,29,30,31,32,33,34,34,34,34,35,35,35,35,35,35
E01031717,EV motorcycles,Number,0,1,2,4,5,7,9,11,14,16,18,20,22,24,25,27,28,29,30,30,31,31,31,32,32,32,32,32,32,32
E01031718,EV motorcycles,Number,1,3,5,8,13,17,22,27,33,38,43,48,53,57,61,64,67,69,71,73,74,75,75,76,76,76,77,77,77,77
E01031719,EV motorcycles,Number,1,2,3,6,9,12,15,18,22,26,29,32,36,38,41,43,45,47,48,49,50,50,51,51,51,52,52,52,52,52
E01031720,EV motorcycles,Number,1,2,3,5,8,10,13,16,19,22,25,28,31,33,35,37,39,40,42,42,43,44,44,44,45,45,45,45,45,45
E01031721,EV motorcycles,Number,1,3,6,10,15,20,26,32,38,44,50,56,62,67,71,75,78,81,83,85,86,87,88,89,89,89,90,90,90,90
E01031722,EV motorcycles,Number,1,2,3,6,9,12,15,18,22,26,29,32,36,38,41,43,45,47,48,49,50,50,51,51,51,52,52,52,52,52
E01031723,EV motorcycles,Number,2,5,9,14,22,29,38,47,55,64,73,82,90,97,103,109,114,118,121,124,126,127,128,129,130,130,131,131,131,131
E01031724,EV motorcycles,Number,0,1,2,3,5,7,9,11,13,15,17,19,21,22,24,25,26,27,28,28,29,29,29,30,30,30,30,30,30,30
E01031725,EV motorcycles,Number,1,2,3,5,7,10,13,16,19,22,25,27,30,33,35,37,38,40,41,42,42,43,43,43,44,44,44,44,44,44
E01031726,EV motorcycles,Number,1,2,3,5,7,10,13,16,19,22,25,27,30,33,35,37,38,40,41,42,42,43,43,43,44,44,44,44,44,44
E01031727,EV motorcycles,Number,1,2,4,7,11,14,19,23,27,31,36,40,44,47,50,53,56,58,59,60,61,62,63,63,63,64,64,64,64,64
E01031728,EV motorcycles,Number,1,3,5,8,12,16,21,25,30,35,40,44,49,52,56,59,62,64,66,67,68,69,70,70,70,71,71,71,71,71
E01031729,EV motorcycles,Number,1,2,4,7,11,14,18,22,27,31,35,39,43,47,50,52,55,57,58,59,60,61,62,62,62,63,63,63,63,63
E01031730,EV motorcycles,Number,1,2,4,6,9,12,16,19,23,27,30,34,37,40,43,45,47,49,50,51,52,52,53,53,53,54,54,54,54,54
E01031731,EV motorcycles,Number,1,2,4,7,11,15,19,24,28,33,37,42,46,50,53,56,58,60,62,63,64,65,66,66,66,67,67,67,67,67
E01031732,EV motorcycles,Number,1,2,3,5,7,9,12,15,18,21,24,26,29,31,33,35,36,38,39,40,40,41,41,41,42,42,42,42,42,42
E01031733,EV motorcycles,Number,0,1,2,4,6,7,10,12,14,16,18,21,23,24,26,27,29,30,31,31,32,32,32,33,33,33,33,33,33,33
E01031734,EV motorcycles,Number,1,2,3,5,8,10,13,16,19,23,26,29,31,34,36,38,40,41,43,43,44,45,45,45,46,46,46,46,46,46
E01031735,EV motorcycles,Number,1,1,3,4,7,9,11,14,16,19,22,24,27,29,31,32,34,35,36,37,37,38,38,38,39,39,39,39,39,39
E01031736,EV motorcycles,Number,1,2,4,6,9,12,16,19,23,27,30,34,37,40,43,45,47,49,50,51,52,52,53,53,53,54,54,54,54,54
E01031737,EV motorcycles,Number,0,1,2,4,6,7,10,12,14,16,18,21,23,24,26,27,29,30,31,31,32,32,32,33,33,33,33,33,33,33
E01031738,EV motorcycles,Number,1,1,2,4,6,8,11,13,16,18,21,23,25,27,29,31,32,33,34,35,35,36,36,36,37,37,37,37,37,37
E01031739,EV motorcycles,Number,1,1,3,5,7,9,12,15,17,20,23,26,28,30,32,34,36,37,38,39,39,40,40,40,41,41,41,41,41,41
E01031740,EV motorcycles,Number,0,1,2,3,5,7,9,11,13,15,17,19,21,23,24,26,27,28,29,29,30,30,30,31,31,31,31,31,31,31
E01031741,EV motorcycles,Number,1,1,2,4,6,8,11,13,16,18,21,23,25,27,29,31,32,33,34,35,35,36,36,36,37,37,37,37,37,37
E01031742,EV motorcycles,Number,0,1,2,3,4,6,7,9,11,12,14,16,17,18,20,21,22,22,23,24,24,24,24,25,25,25,25,25,25,25
E01031743,EV motorcycles,Number,1,1,3,4,7,9,11,14,16,19,22,24,27,29,31,32,34,35,36,37,37,38,38,38,39,39,39,39,39,39
E01031744,EV motorcycles,Number,1,1,3,4,7,9,12,14,17,20,22,25,27,30,32,33,35,36,37,38,38,39,39,39,40,40,40,40,40,40
E01031745,EV motorcycles,Number,0,1,2,4,5,7,9,11,14,16,18,20,22,24,25,27,28,29,30,30,31,31,31,32,32,32,32,32,32,32
E01031746,EV motorcycles,Number,1,1,2,4,6,9,11,13,16,19,21,24,26,28,30,32,33,34,35,36,36,37,37,37,38,38,38,38,38,38
E01031747,EV motorcycles,Number,1,1,2,4,6,9,11,13,16,19,21,24,26,28,30,32,33,34,35,36,36,37,37,37,38,38,38,38,38,38
E01031748,EV motorcycles,Number,1,2,3,6,9,11,15,18,22,25,29,32,35,38,40,42,44,46,47,48,49,49,50,50,50,51,51,51,51,51
E01031749,EV motorcycles,Number,1,1,3,4,7,9,11,14,16,19,22,24,27,29,31,32,34,35,36,37,37,38,38,38,39,39,39,39,39,39
E01031750,EV motorcycles,Number,0,1,1,2,3,4,5,6,8,9,10,11,12,13,14,15,16,16,17,17,17,17,18,18,18,18,18,18,18,18
E01031751,EV motorcycles,Number,1,2,3,5,8,10,13,16,19,22,25,28,31,33,35,37,39,40,42,42,43,44,44,44,45,45,45,45,45,45
E01031752,EV motorcycles,Number,1,1,3,5,7,9,12,15,17,20,23,26,28,30,32,34,36,37,38,39,39,40,40,40,41,41,41,41,41,41
E01031753,EV motorcycles,Number,0,1,1,2,4,5,6,8,9,11,12,14,15,16,17,18,19,20,20,21,21,21,22,22,22,22,22,22,22,22
E01031754,EV motorcycles,Number,1,1,2,4,6,9,11,13,16,19,21,24,26,28,30,32,33,34,35,36,36,37,37,37,38,38,38,38,38,38
E01031755,EV motorcycles,Number,0,1,2,4,6,7,10,12,14,16,18,21,23,24,26,27,29,30,31,31,32,32,32,33,33,33,33,33,33,33
E01031756,EV motorcycles,Number,1,3,5,8,12,17,21,26,31,36,41,46,51,55,58,62,64,67,68,70,71,72,72,73,73,73,74,74,74,74
E01031757,EV motorcycles,Number,0,1,2,4,6,7,10,12,14,16,18,21,23,24,26,27,29,30,31,31,32,32,32,33,33,33,33,33,33,33
E01031758,EV motorcycles,Number,0,1,2,3,5,7,9,11,13,15,17,19,21,23,24,26,27,28,29,29,30,30,30,31,31,31,31,31,31,31
E01031759,EV motorcycles,Number,1,2,3,6,9,12,15,19,22,26,30,33,36,39,42,44,46,48,49,50,51,51,52,52,52,53,53,53,53,53
E01031760,EV motorcycles,Number,1,1,3,4,7,9,11,14,16,19,22,24,27,29,31,32,34,35,36,37,37,38,38,38,39,39,39,39,39,39
E01031761,EV motorcycles,Number,0,1,2,3,5,7,9,11,13,15,17,19,21,23,24,26,27,28,29,29,30,30,30,31,31,31,31,31,31,31
E01031763,EV motorcycles,Number,1,2,3,5,7,10,12,15,18,21,24,27,29,32,34,36,37,39,40,41,41,42,42,42,43,43,43,43,43,43
E01031764,EV motorcycles,Number,1,1,2,4,6,8,10,13,15,18,20,22,25,27,28,30,31,32,33,34,35,35,35,35,36,36,36,36,36,36
E01031765,EV motorcycles,Number,1,3,6,10,15,20,26,32,38,44,50,56,62,67,71,75,78,81,83,85,86,87,88,89,89,89,90,90,90,90
E01031766,EV motorcycles,Number,1,2,3,5,8,10,13,16,19,23,26,29,31,34,36,38,40,41,43,43,44,45,45,45,46,46,46,46,46,46
E01031767,EV motorcycles,Number,2,4,7,12,18,24,31,38,46,53,60,67,74,80,85,90,94,97,100,102,104,105,106,106,107,107,108,108,108,108
E01031768,EV motorcycles,Number,0,1,2,3,5,7,9,11,13,15,17,19,21,22,24,25,26,27,28,28,29,29,29,30,30,30,30,30,30,30
E01031769,EV motorcycles,Number,1,2,3,5,7,9,12,15,18,21,24,26,29,31,33,35,36,38,39,40,40,41,41,41,42,42,42,42,42,42
E01031770,EV motorcycles,Number,1,2,4,6,10,13,17,21,25,29,32,36,40,43,46,48,50,52,54,55,56,56,57,57,57,58,58,58,58,58
E01031771,EV motorcycles,Number,1,2,4,6,9,12,16,20,23,27,31,34,38,41,43,46,48,49,51,52,53,53,54,54,54,55,55,55,55,55
E01031772,EV motorcycles,Number,0,1,2,4,6,7,10,12,14,16,18,21,23,24,26,27,29,30,31,31,32,32,32,33,33,33,33,33,33,33
E01031773,EV motorcycles,Number,0,1,2,3,5,7,9,11,13,15,17,19,21,23,24,26,27,28,29,29,30,30,30,31,31,31,31,31,31,31
E01031774,EV motorcycles,Number,1,2,4,7,10,13,17,21,25,30,34,37,41,44,47,50,52,54,55,57,58,58,59,59,59,60,60,60,60,60
E01031775,EV motorcycles,Number,0,1,2,3,4,5,7,9,10,12,13,15,16,18,19,20,21,22,22,23,23,23,23,24,24,24,24,24,24,24
E01031776,EV motorcycles,Number,0,1,2,3,5,7,9,11,13,15,17,19,21,23,24,26,27,28,29,29,30,30,30,31,31,31,31,31,31,31
E01031777,EV motorcycles,Number,1,2,4,6,9,13,16,20,24,28,31,35,38,41,44,47,49,50,52,53,54,54,55,55,55,56,56,56,56,56
E01031778,EV motorcycles,Number,0,1,2,3,5,7,9,11,13,15,17,19,21,22,24,25,26,27,28,28,29,29,29,30,30,30,30,30,30,30
E01031779,EV motorcycles,Number,0,1,1,2,3,4,5,7,8,9,11,12,13,14,15,16,17,17,18,18,18,18,19,19,19,19,19,19,19,19
E01031780,EV motorcycles,Number,0,1,2,3,5,7,9,11,13,15,17,19,21,23,24,26,27,28,29,29,30,30,30,31,31,31,31,31,31,31
E01031781,EV motorcycles,Number,1,2,3,6,8,11,14,18,21,25,28,31,34,37,39,42,43,45,46,47,48,49,49,49,49,50,50,50,50,50
E01031782,EV motorcycles,Number,1,2,4,7,11,15,19,23,28,32,37,41,45,49,52,55,57,59,61,62,63,64,65,65,65,66,66,66,66,66
E01031783,EV motorcycles,Number,0,1,2,4,6,7,10,12,14,16,18,21,23,24,26,27,29,30,31,31,32,32,32,33,33,33,33,33,33,33
E01031784,EV motorcycles,Number,1,2,4,7,11,15,19,24,28,33,37,42,46,50,53,56,58,60,62,63,64,65,66,66,66,67,67,67,67,67
E01031785,EV motorcycles,Number,0,1,2,4,6,7,10,12,14,16,18,21,23,24,26,27,29,30,31,31,32,32,32,33,33,33,33,33,33,33
E01031786,EV motorcycles,Number,1,2,3,6,8,11,14,18,21,25,28,31,34,37,39,42,43,45,46,47,48,49,49,49,49,50,50,50,50,50
E01031787,EV motorcycles,Number,0,1,2,3,4,5,7,9,10,12,13,15,16,18,19,20,21,22,22,23,23,23,23,24,24,24,24,24,24,24
E01031788,EV motorcycles,Number,0,1,2,3,5,7,9,11,13,15,17,19,21,23,24,26,27,28,29,29,30,30,30,31,31,31,31,31,31,31
E01031789,EV motorcycles,Number,1,2,3,5,7,10,12,15,18,21,24,27,29,32,34,36,37,39,40,41,41,42,42,42,43,43,43,43,43,43
E01031790,EV motorcycles,Number,0,1,2,3,5,6,8,10,12,14,16,17,19,21,22,23,24,25,26,26,27,27,27,28,28,28,28,28,28,28
E01031791,EV motorcycles,Number,0,1,2,4,6,7,10,12,14,16,18,21,23,24,26,27,29,30,31,31,32,32,32,33,33,33,33,33,33,33
E01031792,EV motorcycles,Number,0,1,2,3,5,6,8,10,11,13,15,17,18,20,21,22,23,24,25,25,26,26,26,27,27,27,27,27,27,27
E01031793,EV motorcycles,Number,0,1,2,3,5,7,9,11,13,15,17,19,21,23,24,26,27,28,29,29,30,30,30,31,31,31,31,31,31,31
E01031794,EV motorcycles,Number,1,2,3,5,7,10,13,16,19,22,25,27,30,33,35,37,38,40,41,42,42,43,43,43,44,44,44,44,44,44
E01031795,EV motorcycles,Number,1,2,4,7,10,14,18,22,26,30,34,38,42,45,48,51,53,55,56,58,58,59,60,60,60,61,61,61,61,61
E01031796,EV motorcycles,Number,0,1,1,2,3,4,5,7,8,9,11,12,13,14,15,16,17,17,18,18,18,18,19,19,19,19,19,19,19,19
E01031797,EV motorcycles,Number,1,2,4,7,10,13,17,21,25,29,33,37,40,44,47,49,51,53,55,56,57,57,58,58,58,59,59,59,59,59
E01031798,EV motorcycles,Number,1,2,3,5,7,10,12,15,18,21,24,27,29,32,34,36,37,39,40,41,41,42,42,42,43,43,43,43,43,43
E01031799,EV motorcycles,Number,1,2,3,5,8,11,14,17,21,24,27,31,33,36,39,41,43,44,45,46,47,48,48,48,48,49,49,49,49,49
E01031800,EV motorcycles,Number,1,1,2,4,6,8,10,13,15,18,20,22,25,27,28,30,31,32,33,34,35,35,35,35,36,36,36,36,36,36
E01031801,EV motorcycles,Number,0,1,2,3,5,7,8,10,12,14,16,18,20,21,23,24,25,26,27,27,28,28,28,29,29,29,29,29,29,29
E01031802,EV motorcycles,Number,0,1,2,3,5,6,8,10,12,14,16,17,19,21,22,23,24,25,26,26,27,27,27,28,28,28,28,28,28,28
E01031803,EV motorcycles,Number,1,2,3,6,9,12,15,19,22,26,30,33,36,39,42,44,46,48,49,50,51,51,52,52,52,53,53,53,53,53
E01031804,EV motorcycles,Number,1,1,2,4,6,8,11,13,16,18,21,23,25,27,29,31,32,33,34,35,35,36,36,36,37,37,37,37,37,37
E01031805,EV motorcycles,Number,1,2,4,6,9,12,16,20,23,27,31,34,38,41,43,46,48,49,51,52,53,53,54,54,54,55,55,55,55,55
E01031806,EV motorcycles,Number,1,1,3,5,7,9,12,15,17,20,23,26,28,30,32,34,36,37,38,39,39,40,40,40,41,41,41,41,41,41
E01031807,EV motorcycles,Number,0,1,2,3,5,6,8,10,11,13,15,17,18,20,21,22,23,24,25,25,26,26,26,27,27,27,27,27,27,27
E01031808,EV motorcycles,Number,0,1,2,3,5,7,8,10,12,14,16,18,20,21,23,24,25,26,27,27,28,28,28,29,29,29,29,29,29,29
E01031809,EV motorcycles,Number,0,1,2,3,5,6,8,10,12,14,16,17,19,21,22,23,24,25,26,26,27,27,27,28,28,28,28,28,28,28
E01031810,EV motorcycles,Number,0,1,2,4,5,7,9,11,14,16,18,20,22,24,25,27,28,29,30,30,31,31,31,32,32,32,32,32,32,32
E01031811,EV motorcycles,Number,0,1,1,2,4,5,6,8,9,11,12,14,15,16,17,18,19,20,20,21,21,21,22,22,22,22,22,22,22,22
E01031812,EV motorcycles,Number,0,1,2,3,5,6,8,10,11,13,15,17,18,20,21,22,23,24,25,25,26,26,26,27,27,27,27,27,27,27
E01031813,EV motorcycles,Number,1,2,3,5,7,10,13,16,19,22,25,27,30,33,35,37,38,40,41,42,42,43,43,43,44,44,44,44,44,44
E01031814,EV motorcycles,Number,1,1,2,4,6,9,11,13,16,19,21,24,26,28,30,32,33,34,35,36,36,37,37,37,38,38,38,38,38,38
E01031815,EV motorcycles,Number,0,1,2,3,5,6,8,10,12,14,16,17,19,21,22,23,24,25,26,26,27,27,27,28,28,28,28,28,28,28
E01031816,EV motorcycles,Number,1,1,2,4,6,8,10,12,15,17,20,22,24,26,28,29,30,31,32,33,34,34,34,34,35,35,35,35,35,35
E01031817,EV motorcycles,Number,1,2,4,6,9,12,16,20,23,27,31,34,38,41,43,46,48,49,51,52,53,53,54,54,54,55,55,55,55,55
E01031818,EV motorcycles,Number,1,2,4,7,11,14,19,23,27,31,36,40,44,47,50,53,56,58,59,60,61,62,63,63,63,64,64,64,64,64
E01031819,EV motorcycles,Number,1,3,5,8,12,16,21,25,30,35,40,44,49,52,56,59,62,64,66,67,68,69,70,70,70,71,71,71,71,71
E01031820,EV motorcycles,Number,1,3,6,9,14,19,25,30,36,42,48,53,58,63,67,71,74,76,79,80,82,82,83,84,84,84,85,85,85,85
E01031821,EV motorcycles,Number,1,2,4,7,11,15,19,24,28,33,37,42,46,50,53,56,58,60,62,63,64,65,66,66,66,67,67,67,67,67
E01031822,EV motorcycles,Number,1,1,3,4,7,9,12,14,17,20,22,25,27,30,32,33,35,36,37,38,38,39,39,39,40,40,40,40,40,40
E01031823,EV motorcycles,Number,1,2,3,5,8,10,13,16,19,23,26,29,31,34,36,38,40,41,43,43,44,45,45,45,46,46,46,46,46,46
E01031824,EV motorcycles,Number,0,1,2,3,5,7,9,11,13,15,17,19,21,23,24,26,27,28,29,29,30,30,30,31,31,31,31,31,31,31
E01031825,EV motorcycles,Number,1,2,3,5,8,11,14,17,20,24,27,30,33,35,38,40,42,43,44,45,46,47,47,47,48,48,48,48,48,48
E01031826,EV motorcycles,Number,1,2,3,5,7,10,12,15,18,21,24,27,29,32,34,36,37,39,40,41,41,42,42,42,43,43,43,43,43,43
E01031827,EV motorcycles,Number,1,2,3,5,8,10,13,16,19,22,25,28,31,33,35,37,39,40,42,42,43,44,44,44,45,45,45,45,45,45
E01031828,EV motorcycles,Number,1,2,4,7,10,14,18,22,26,30,34,38,42,45,48,51,53,55,56,58,58,59,60,60,60,61,61,61,61,61
E01031829,EV motorcycles,Number,1,2,4,6,9,12,16,20,23,27,31,34,38,41,43,46,48,49,51,52,53,53,54,54,54,55,55,55,55,55
E01031830,EV motorcycles,Number,1,2,3,6,9,12,15,19,22,26,30,33,36,39,42,44,46,48,49,50,51,51,52,52,52,53,53,53,53,53
E01031831,EV motorcycles,Number,0,1,2,3,5,6,8,10,12,14,16,17,19,21,22,23,24,25,26,26,27,27,27,28,28,28,28,28,28,28
E01031832,EV motorcycles,Number,0,1,2,4,6,7,10,12,14,16,18,21,23,24,26,27,29,30,31,31,32,32,32,33,33,33,33,33,33,33
E01031833,EV motorcycles,Number,0,1,2,4,5,7,9,11,14,16,18,20,22,24,25,27,28,29,30,30,31,31,31,32,32,32,32,32,32,32
E01031834,EV motorcycles,Number,1,1,2,4,6,8,10,12,15,17,20,22,24,26,28,29,30,31,32,33,34,34,34,34,35,35,35,35,35,35
E01031835,EV motorcycles,Number,0,1,2,3,4,6,7,9,11,12,14,16,17,18,20,21,22,22,23,24,24,24,24,25,25,25,25,25,25,25
E01031836,EV motorcycles,Number,1,2,3,5,8,11,14,17,20,23,26,29,32,35,37,39,41,42,43,44,45,46,46,46,47,47,47,47,47,47
E01031837,EV motorcycles,Number,1,2,3,5,7,10,13,16,19,22,25,27,30,33,35,37,38,40,41,42,42,43,43,43,44,44,44,44,44,44
E01031838,EV motorcycles,Number,1,1,2,4,6,8,10,13,15,18,20,22,25,27,28,30,31,32,33,34,35,35,35,35,36,36,36,36,36,36
E01031839,EV motorcycles,Number,1,1,3,4,7,9,11,14,16,19,22,24,27,29,31,32,34,35,36,37,37,38,38,38,39,39,39,39,39,39
E01031840,EV motorcycles,Number,1,1,3,4,7,9,11,14,16,19,22,24,27,29,31,32,34,35,36,37,37,38,38,38,39,39,39,39,39,39
E01032512,EV motorcycles,Number,0,1,1,2,3,4,5,6,7,8,9,10,11,12,13,13,14,14,15,15,15,16,16,16,16,16,16,16,16,16
E01032513,EV motorcycles,Number,0,1,1,2,3,4,5,6,8,9,10,11,12,13,14,15,16,16,17,17,17,17,18,18,18,18,18,18,18,18
E01032523,EV motorcycles,Number,1,1,2,4,6,9,11,13,16,19,21,24,26,28,30,32,33,34,35,36,36,37,37,37,38,38,38,38,38,38
E01032524,EV motorcycles,Number,1,2,3,5,8,11,14,17,20,24,27,30,33,35,38,40,42,43,44,45,46,47,47,47,48,48,48,48,48,48
E01032525,EV motorcycles,Number,1,2,4,7,11,15,20,24,29,33,38,42,46,50,54,57,59,61,63,64,65,66,67,67,67,68,68,68,68,68
E01032526,EV motorcycles,Number,1,2,4,7,10,14,18,22,26,30,35,39,42,46,49,52,54,56,57,59,59,60,61,61,61,62,62,62,62,62
E01032562,EV motorcycles,Number,0,1,1,2,3,4,5,7,8,9,11,12,13,14,15,16,17,17,18,18,18,18,19,19,19,19,19,19,19,19
E01032563,EV motorcycles,Number,0,1,1,2,3,4,6,7,8,10,11,12,14,15,16,17,17,18,18,19,19,19,20,20,20,20,20,20,20,20
E01032564,EV motorcycles,Number,0,0,1,1,2,3,3,4,5,6,7,7,8,9,9,10,10,11,11,11,12,12,12,12,12,12,12,12,12,12
E01032565,EV motorcycles,Number,0,1,1,2,3,4,5,7,8,9,11,12,13,14,15,16,17,17,18,18,18,18,19,19,19,19,19,19,19,19
E01032566,EV motorcycles,Number,0,1,2,3,5,7,9,11,13,15,17,19,21,22,24,25,26,27,28,28,29,29,29,30,30,30,30,30,30,30
E01032567,EV motorcycles,Number,0,1,1,2,2,3,4,5,6,7,8,9,10,10,11,12,12,13,13,13,13,14,14,14,14,14,14,14,14,14
E01032568,EV motorcycles,Number,0,1,1,2,3,4,5,7,8,9,11,12,13,14,15,16,17,17,18,18,18,18,19,19,19,19,19,19,19,19
E01032569,EV motorcycles,Number,0,1,2,3,5,7,8,10,12,14,16,18,20,21,23,24,25,26,27,27,28,28,28,29,29,29,29,29,29,29
E01032570,EV motorcycles,Number,1,2,4,7,11,15,20,24,29,33,38,42,46,50,54,57,59,61,63,64,65,66,67,67,67,68,68,68,68,68
E01032571,EV motorcycles,Number,2,4,7,12,18,24,31,38,45,52,59,66,72,78,84,88,92,95,98,100,102,103,104,104,105,105,106,106,106,106
E01032574,EV motorcycles,Number,0,1,1,2,2,3,4,5,6,7,8,9,10,10,11,12,12,13,13,13,13,14,14,14,14,14,14,14,14,14
E01032575,EV motorcycles,Number,0,1,1,2,4,5,6,7,9,10,12,13,14,16,17,17,18,19,19,20,20,20,21,21,21,21,21,21,21,21
E01032576,EV motorcycles,Number,0,1,1,2,3,4,5,6,7,8,9,10,11,12,13,13,14,14,15,15,15,16,16,16,16,16,16,16,16,16
E01032577,EV motorcycles,Number,0,1,1,2,3,4,6,7,8,10,11,12,14,15,16,17,17,18,18,19,19,19,20,20,20,20,20,20,20,20
E01032579,EV motorcycles,Number,0,0,1,1,2,3,4,5,5,6,7,8,9,10,10,11,11,12,12,12,12,13,13,13,13,13,13,13,13,13
E01032580,EV motorcycles,Number,0,0,1,1,2,2,3,4,4,5,6,6,7,7,8,8,9,9,9,9,10,10,10,10,10,10,10,10,10,10
E01032581,EV motorcycles,Number,0,1,1,2,3,4,5,7,8,9,11,12,13,14,15,16,17,17,18,18,18,18,19,19,19,19,19,19,19,19
E01032582,EV motorcycles,Number,0,1,1,2,3,4,5,6,7,8,9,10,11,12,13,13,14,14,15,15,15,16,16,16,16,16,16,16,16,16
E01032583,EV motorcycles,Number,0,1,1,2,4,5,6,8,9,11,12,14,15,16,17,18,19,20,20,21,21,21,22,22,22,22,22,22,22,22
E01032584,EV motorcycles,Number,0,1,1,2,2,3,4,5,6,7,8,9,10,10,11,12,12,13,13,13,13,14,14,14,14,14,14,14,14,14
E01032609,EV motorcycles,Number,0,1,2,3,4,6,8,9,11,13,15,16,18,19,21,22,23,23,24,25,25,25,25,26,26,26,26,26,26,26
E01032610,EV motorcycles,Number,0,0,0,0,0,0,0,0,0,0,0,0,0,0,0,0,0,0,0,0,0,0,0,0,0,0,0,0,0,0
E01032611,EV motorcycles,Number,1,2,3,5,8,10,13,16,19,22,25,28,31,33,35,37,39,40,42,42,43,44,44,44,45,45,45,45,45,45
E01032612,EV motorcycles,Number,0,1,2,4,6,8,10,12,14,17,19,21,23,25,27,28,30,31,31,32,33,33,33,33,34,34,34,34,34,34
E01032619,EV motorcycles,Number,1,2,3,5,7,10,13,16,19,22,25,27,30,33,35,37,38,40,41,42,42,43,43,43,44,44,44,44,44,44
E01032620,EV motorcycles,Number,2,4,7,12,18,24,31,38,45,53,60,67,73,79,84,89,93,96,99,101,103,104,105,105,106,106,107,107,107,107
E01032623,EV motorcycles,Number,0,1,2,3,5,6,8,10,11,13,15,17,18,20,21,22,23,24,25,25,26,26,26,27,27,27,27,27,27,27
E01032624,EV motorcycles,Number,0,1,2,3,5,7,9,11,13,15,17,19,21,23,24,26,27,28,29,29,30,30,30,31,31,31,31,31,31,31
E01032637,EV motorcycles,Number,0,0,0,0,0,0,0,0,0,0,0,0,0,0,0,0,0,0,0,0,0,0,0,0,0,0,0,0,0,0
E01032638,EV motorcycles,Number,0,1,1,2,3,4,5,6,7,8,10,11,12,13,13,14,15,15,16,16,16,16,17,17,17,17,17,17,17,17
E01032639,EV motorcycles,Number,1,1,3,4,7,9,12,14,17,20,22,25,27,30,32,33,35,36,37,38,38,39,39,39,40,40,40,40,40,40
E01032640,EV motorcycles,Number,0,1,1,2,3,4,6,7,8,10,11,12,14,15,16,17,17,18,18,19,19,19,20,20,20,20,20,20,20,20
E01032646,EV motorcycles,Number,0,1,2,3,4,5,7,8,10,11,13,14,16,17,18,19,20,21,21,22,22,22,23,23,23,23,23,23,23,23
E01032653,EV motorcycles,Number,1,1,3,5,7,9,12,15,17,20,23,26,28,30,32,34,36,37,38,39,39,40,40,40,41,41,41,41,41,41
E01032654,EV motorcycles,Number,1,3,5,8,12,16,21,26,30,35,40,45,49,53,57,60,63,65,67,68,69,70,70,71,71,71,72,72,72,72
E01032655,EV motorcycles,Number,1,2,4,7,10,13,17,21,25,30,34,37,41,44,47,50,52,54,55,57,58,58,59,59,59,60,60,60,60,60
E01032656,EV motorcycles,Number,1,2,4,6,9,13,16,20,24,28,31,35,38,41,44,47,49,50,52,53,54,54,55,55,55,56,56,56,56,56
E01032719,EV motorcycles,Number,0,1,1,2,3,4,5,7,8,9,11,12,13,14,15,16,17,17,18,18,18,18,19,19,19,19,19,19,19,19
E01032720,EV motorcycles,Number,0,1,1,2,3,4,6,7,8,10,11,12,14,15,16,17,17,18,18,19,19,19,20,20,20,20,20,20,20,20
E01032722,EV motorcycles,Number,1,1,2,4,6,8,11,13,16,18,21,23,25,27,29,31,32,33,34,35,35,36,36,36,37,37,37,37,37,37
E01032735,EV motorcycles,Number,1,1,2,4,6,8,10,13,15,18,20,22,25,27,28,30,31,32,33,34,35,35,35,35,36,36,36,36,36,36
E01032737,EV motorcycles,Number,0,1,2,3,4,6,7,9,11,12,14,16,17,18,20,21,22,22,23,24,24,24,24,25,25,25,25,25,25,25
E01032739,EV motorcycles,Number,0,1,1,2,3,4,5,6,7,8,10,11,12,13,13,14,15,15,16,16,16,16,17,17,17,17,17,17,17,17
E01032740,EV motorcycles,Number,1,1,2,4,6,8,11,13,16,18,21,23,25,27,29,31,32,33,34,35,35,36,36,36,37,37,37,37,37,37
E01032741,EV motorcycles,Number,0,1,1,2,3,4,5,6,7,8,10,11,12,13,13,14,15,15,16,16,16,16,17,17,17,17,17,17,17,17
E01032742,EV motorcycles,Number,0,0,1,1,2,2,3,4,4,5,6,6,7,7,8,8,9,9,9,9,10,10,10,10,10,10,10,10,10,10
E01032764,EV motorcycles,Number,1,2,3,5,7,10,12,15,18,21,24,27,29,32,34,36,37,39,40,41,41,42,42,42,43,43,43,43,43,43
E01032765,EV motorcycles,Number,0,1,1,2,3,4,5,6,7,8,10,11,12,13,13,14,15,15,16,16,16,16,17,17,17,17,17,17,17,17
E01032766,EV motorcycles,Number,0,1,1,2,3,4,5,6,7,8,9,10,11,12,13,13,14,14,15,15,15,16,16,16,16,16,16,16,16,16
E01032767,EV motorcycles,Number,0,1,1,2,3,4,5,6,7,8,10,11,12,13,13,14,15,15,16,16,16,16,17,17,17,17,17,17,17,17
E01032768,EV motorcycles,Number,0,1,1,2,3,4,6,7,8,10,11,12,14,15,16,17,17,18,18,19,19,19,20,20,20,20,20,20,20,20
E01032769,EV motorcycles,Number,1,2,4,7,10,14,18,22,26,30,34,38,42,45,48,51,53,55,56,58,58,59,60,60,60,61,61,61,61,61
E01032770,EV motorcycles,Number,0,0,0,1,1,2,2,2,3,3,4,4,5,5,6,6,6,6,6,7,7,7,7,7,7,7,7,7,7,7
E01032771,EV motorcycles,Number,0,1,1,2,3,3,4,5,6,7,8,9,10,11,12,12,13,13,14,14,14,15,15,15,15,15,15,15,15,15
E01032772,EV motorcycles,Number,0,1,1,2,3,4,5,6,7,8,10,11,12,13,13,14,15,15,16,16,16,16,17,17,17,17,17,17,17,17
E01032773,EV motorcycles,Number,0,0,1,1,2,2,3,3,4,4,5,6,6,7,7,7,8,8,8,8,9,9,9,9,9,9,9,9,9,9
E01032774,EV motorcycles,Number,0,0,1,1,2,2,3,4,4,5,6,6,7,7,8,8,9,9,9,9,10,10,10,10,10,10,10,10,10,10
E01032775,EV motorcycles,Number,0,0,1,1,1,2,2,3,3,4,4,5,5,6,6,7,7,7,7,8,8,8,8,8,8,8,8,8,8,8
E01032776,EV motorcycles,Number,0,0,1,1,2,2,3,4,4,5,6,6,7,7,8,8,9,9,9,9,10,10,10,10,10,10,10,10,10,10
E01032777,EV motorcycles,Number,0,0,1,1,2,2,3,4,4,5,6,6,7,7,8,8,9,9,9,9,10,10,10,10,10,10,10,10,10,10
E01032778,EV motorcycles,Number,1,1,2,4,6,8,10,13,15,18,20,22,25,27,28,30,31,32,33,34,35,35,35,35,36,36,36,36,36,36
E01032779,EV motorcycles,Number,0,1,1,2,3,4,5,6,7,8,9,10,11,12,13,13,14,14,15,15,15,16,16,16,16,16,16,16,16,16
E01032780,EV motorcycles,Number,0,1,1,2,4,5,6,7,9,10,12,13,14,16,17,17,18,19,19,20,20,20,21,21,21,21,21,21,21,21
E01032781,EV motorcycles,Number,0,0,1,1,2,2,3,4,5,5,6,7,8,8,9,9,10,10,10,10,11,11,11,11,11,11,11,11,11,11
E01032782,EV motorcycles,Number,0,0,1,1,2,2,3,4,5,5,6,7,8,8,9,9,10,10,10,10,11,11,11,11,11,11,11,11,11,11
E01032783,EV motorcycles,Number,0,0,1,1,1,2,2,3,3,4,4,5,5,6,6,7,7,7,7,8,8,8,8,8,8,8,8,8,8,8
E01032784,EV motorcycles,Number,0,0,1,1,2,2,3,4,4,5,6,6,7,7,8,8,9,9,9,9,10,10,10,10,10,10,10,10,10,10
E01032785,EV motorcycles,Number,0,1,2,3,5,6,8,10,12,14,16,17,19,21,22,23,24,25,26,26,27,27,27,28,28,28,28,28,28,28
E01032786,EV motorcycles,Number,0,0,1,1,2,3,3,4,5,6,7,7,8,9,9,10,10,11,11,11,12,12,12,12,12,12,12,12,12,12
E01032787,EV motorcycles,Number,0,1,2,3,4,5,7,8,10,11,13,14,16,17,18,19,20,21,21,22,22,22,23,23,23,23,23,23,23,23
E01032788,EV motorcycles,Number,0,1,2,3,5,6,8,10,12,14,16,17,19,21,22,23,24,25,26,26,27,27,27,28,28,28,28,28,28,28
E01032789,EV motorcycles,Number,0,1,1,2,3,4,5,7,8,9,11,12,13,14,15,16,17,17,18,18,18,18,19,19,19,19,19,19,19,19
E01032790,EV motorcycles,Number,0,1,2,3,4,6,8,9,11,13,15,16,18,19,20,22,23,23,24,25,25,25,25,26,26,26,26,26,26,26
E01032792,EV motorcycles,Number,0,0,1,1,2,3,3,4,5,6,7,7,8,9,9,10,10,11,11,11,12,12,12,12,12,12,12,12,12,12
E01032794,EV motorcycles,Number,0,1,1,2,3,4,5,6,7,8,9,10,11,12,13,13,14,14,15,15,15,16,16,16,16,16,16,16,16,16
E01032795,EV motorcycles,Number,0,1,1,2,3,4,6,7,8,10,11,12,14,15,16,17,17,18,18,19,19,19,20,20,20,20,20,20,20,20
E01032797,EV motorcycles,Number,0,1,1,2,3,3,4,5,6,7,8,9,10,11,12,12,13,13,14,14,14,15,15,15,15,15,15,15,15,15
E01032798,EV motorcycles,Number,1,2,4,6,9,12,16,20,23,27,31,34,38,41,43,46,48,49,51,52,53,53,54,54,54,55,55,55,55,55
E01032799,EV motorcycles,Number,0,1,1,2,3,4,5,6,7,8,9,10,11,12,13,13,14,14,15,15,15,16,16,16,16,16,16,16,16,16
E01032800,EV motorcycles,Number,0,1,1,2,4,5,6,7,9,10,12,13,14,16,17,17,18,19,19,20,20,20,21,21,21,21,21,21,21,21
E01032802,EV motorcycles,Number,0,1,1,2,4,5,6,8,9,11,12,14,15,16,17,18,19,20,20,21,21,21,22,22,22,22,22,22,22,22
E01032803,EV motorcycles,Number,0,1,1,2,3,3,4,5,6,7,8,9,10,11,12,12,13,13,14,14,14,15,15,15,15,15,15,15,15,15
E01032805,EV motorcycles,Number,1,1,3,4,7,9,12,14,17,20,22,25,27,30,32,33,35,36,37,38,38,39,39,39,40,40,40,40,40,40
E01032807,EV motorcycles,Number,0,0,1,1,2,3,4,5,5,6,7,8,9,10,10,11,11,12,12,12,12,13,13,13,13,13,13,13,13,13
E01032808,EV motorcycles,Number,0,0,0,1,1,1,2,2,3,3,3,4,4,4,5,5,5,5,6,6,6,6,6,6,6,6,6,6,6,6
E01032809,EV motorcycles,Number,1,2,4,6,9,12,16,19,23,27,30,34,37,40,43,45,47,49,50,51,52,52,53,53,53,54,54,54,54,54
E01032810,EV motorcycles,Number,1,2,3,5,7,10,12,15,18,21,24,27,29,32,34,36,37,39,40,41,41,42,42,42,43,43,43,43,43,43
E01032811,EV motorcycles,Number,0,1,1,2,4,5,6,8,9,11,12,14,15,16,17,18,19,20,20,21,21,21,22,22,22,22,22,22,22,22
E01032812,EV motorcycles,Number,1,2,4,7,11,14,19,23,27,31,36,40,44,47,50,53,56,58,59,60,61,62,63,63,63,64,64,64,64,64
E01032813,EV motorcycles,Number,1,1,2,4,6,8,10,12,15,17,20,22,24,26,28,29,30,31,32,33,34,34,34,34,35,35,35,35,35,35
E01032814,EV motorcycles,Number,1,3,5,8,13,17,22,27,32,37,42,47,51,55,59,62,65,67,69,71,72,73,73,74,74,74,75,75,75,75
E01032815,EV motorcycles,Number,0,1,1,2,3,4,5,6,7,8,9,10,11,12,13,13,14,14,15,15,15,16,16,16,16,16,16,16,16,16
E01032816,EV motorcycles,Number,1,2,4,6,9,13,16,20,24,28,31,35,38,41,44,47,49,50,52,53,54,54,55,55,55,56,56,56,56,56
E01032817,EV motorcycles,Number,0,1,1,2,3,4,6,7,8,10,11,12,14,15,16,17,17,18,18,19,19,19,20,20,20,20,20,20,20,20
E01032818,EV motorcycles,Number,0,1,2,3,4,6,8,9,11,13,15,16,18,19,20,22,23,23,24,25,25,25,25,26,26,26,26,26,26,26
E01032819,EV motorcycles,Number,0,1,2,4,6,8,10,12,14,17,19,21,23,25,27,28,30,31,31,32,33,33,33,33,34,34,34,34,34,34
E01032820,EV motorcycles,Number,1,2,3,5,8,11,14,17,21,24,27,31,33,36,39,41,43,44,45,46,47,48,48,48,48,49,49,49,49,49
E01032821,EV motorcycles,Number,0,1,2,3,5,7,9,11,13,15,17,19,21,22,24,25,26,27,28,28,29,29,29,30,30,30,30,30,30,30
E01032822,EV motorcycles,Number,1,1,3,4,7,9,12,14,17,20,22,25,27,30,32,33,35,36,37,38,38,39,39,39,40,40,40,40,40,40
E01032823,EV motorcycles,Number,1,1,2,4,6,9,11,13,16,19,21,24,26,28,30,32,33,34,35,36,36,37,37,37,38,38,38,38,38,38
E01032824,EV motorcycles,Number,1,2,3,6,9,11,15,18,22,25,29,32,35,38,40,42,44,46,47,48,49,49,50,50,50,51,51,51,51,51
E01032825,EV motorcycles,Number,1,2,4,7,11,14,18,22,27,31,35,39,43,47,50,52,55,57,58,59,60,61,62,62,62,63,63,63,63,63
E01032826,EV motorcycles,Number,1,2,3,5,8,11,14,17,21,24,27,31,33,36,39,41,43,44,45,46,47,48,48,48,48,49,49,49,49,49
E01032827,EV motorcycles,Number,1,2,4,7,11,14,19,23,27,31,36,40,44,47,50,53,56,58,59,60,61,62,63,63,63,64,64,64,64,64
E01032828,EV motorcycles,Number,0,1,2,3,5,7,9,11,13,15,17,19,21,22,24,25,26,27,28,28,29,29,29,30,30,30,30,30,30,30
E01032829,EV motorcycles,Number,1,1,3,5,7,9,12,15,17,20,23,26,28,30,32,34,36,37,38,39,39,40,40,40,41,41,41,41,41,41
E01032830,EV motorcycles,Number,1,3,5,9,14,18,24,29,35,40,46,51,56,61,65,68,71,74,76,77,79,80,80,81,81,81,82,82,82,82
E01032831,EV motorcycles,Number,0,1,2,3,4,6,7,9,11,12,14,16,17,18,20,21,22,22,23,24,24,24,24,25,25,25,25,25,25,25
E01032832,EV motorcycles,Number,1,1,2,4,6,8,11,13,16,18,21,23,25,27,29,31,32,33,34,35,35,36,36,36,37,37,37,37,37,37
E01032833,EV motorcycles,Number,0,1,1,2,3,4,5,7,8,9,11,12,13,14,15,16,17,17,18,18,18,18,19,19,19,19,19,19,19,19
E01032834,EV motorcycles,Number,0,0,0,1,1,2,2,2,3,3,4,4,5,5,6,6,6,6,6,7,7,7,7,7,7,7,7,7,7,7
E01032835,EV motorcycles,Number,0,1,2,4,6,7,10,12,14,16,18,21,23,24,26,27,29,30,31,31,32,32,32,33,33,33,33,33,33,33
E01032836,EV motorcycles,Number,0,1,2,3,4,6,7,9,11,12,14,16,17,18,20,21,22,22,23,24,24,24,24,25,25,25,25,25,25,25
E01032837,EV motorcycles,Number,1,1,2,4,6,8,10,12,15,17,20,22,24,26,28,29,30,31,32,33,34,34,34,34,35,35,35,35,35,35
E01032838,EV motorcycles,Number,0,1,1,2,4,5,6,8,9,11,12,14,15,16,17,18,19,20,20,21,21,21,22,22,22,22,22,22,22,22
E01032839,EV motorcycles,Number,0,1,1,2,3,4,6,7,8,10,11,12,14,15,16,17,17,18,18,19,19,19,20,20,20,20,20,20,20,20
E01032955,EV motorcycles,Number,0,0,1,1,2,3,4,5,5,6,7,8,9,10,10,11,11,12,12,12,12,13,13,13,13,13,13,13,13,13
E01032956,EV motorcycles,Number,0,1,2,3,5,7,9,11,13,15,17,19,21,23,24,26,27,28,29,29,30,30,30,31,31,31,31,31,31,31
E01032957,EV motorcycles,Number,0,1,2,3,5,7,9,11,13,15,17,19,21,22,24,25,26,27,28,28,29,29,29,30,30,30,30,30,30,30
E01032958,EV motorcycles,Number,1,1,3,4,7,9,12,14,17,20,22,25,27,30,32,33,35,36,37,38,38,39,39,39,40,40,40,40,40,40
E01032959,EV motorcycles,Number,1,2,3,5,8,11,14,17,20,24,27,30,33,35,38,40,42,43,44,45,46,47,47,47,48,48,48,48,48,48
E01032961,EV motorcycles,Number,0,1,1,2,4,5,6,7,9,10,12,13,14,16,17,17,18,19,19,20,20,20,21,21,21,21,21,21,21,21
E01032962,EV motorcycles,Number,0,1,2,3,4,6,7,9,11,12,14,16,17,18,20,21,22,22,23,24,24,24,24,25,25,25,25,25,25,25
E01033022,EV motorcycles,Number,0,1,1,2,3,4,5,6,7,8,9,10,11,12,13,13,14,14,15,15,15,16,16,16,16,16,16,16,16,16
E01033023,EV motorcycles,Number,1,2,3,5,7,10,12,15,18,21,24,27,29,32,34,36,37,39,40,41,41,42,42,42,43,43,43,43,43,43
E01033024,EV motorcycles,Number,1,1,2,4,6,8,10,13,15,18,20,22,25,27,28,30,31,32,33,34,35,35,35,35,36,36,36,36,36,36
E01033025,EV motorcycles,Number,0,1,2,4,5,7,9,11,14,16,18,20,22,24,25,27,28,29,30,30,31,31,31,32,32,32,32,32,32,32
E01033026,EV motorcycles,Number,1,2,3,5,7,10,13,16,19,22,25,27,30,33,35,37,38,40,41,42,42,43,43,43,44,44,44,44,44,44
E01033027,EV motorcycles,Number,0,1,2,3,5,6,8,10,12,14,16,17,19,21,22,23,24,25,26,26,27,27,27,28,28,28,28,28,28,28
E01033028,EV motorcycles,Number,0,1,1,2,3,3,4,5,6,7,8,9,10,11,12,12,13,13,14,14,14,15,15,15,15,15,15,15,15,15
E01033029,EV motorcycles,Number,0,1,2,3,4,5,7,9,10,12,13,15,16,18,19,20,21,22,22,23,23,23,23,24,24,24,24,24,24,24
E01033036,EV motorcycles,Number,1,2,3,6,9,11,15,18,22,25,29,32,35,38,40,42,44,46,47,48,49,49,50,50,50,51,51,51,51,51
E01033037,EV motorcycles,Number,0,1,2,3,5,6,8,10,11,13,15,17,18,20,21,22,23,24,25,25,26,26,26,27,27,27,27,27,27,27
E01033038,EV motorcycles,Number,0,1,2,4,6,8,10,12,14,17,19,21,23,25,27,28,30,31,31,32,33,33,33,33,34,34,34,34,34,34
E01033039,EV motorcycles,Number,0,1,1,2,3,4,5,7,8,9,11,12,13,14,15,16,17,17,18,18,18,18,19,19,19,19,19,19,19,19
E01033040,EV motorcycles,Number,1,2,3,6,8,11,14,18,21,25,28,31,34,37,39,42,43,45,46,47,48,49,49,49,49,50,50,50,50,50
E01033041,EV motorcycles,Number,1,2,3,6,9,12,15,19,22,26,30,33,36,39,42,44,46,48,49,50,51,51,52,52,52,53,53,53,53,53
E01033042,EV motorcycles,Number,1,3,5,8,12,16,21,26,30,35,40,45,49,53,57,60,63,65,67,68,69,70,70,71,71,71,72,72,72,72
E01033043,EV motorcycles,Number,0,1,1,2,4,5,6,8,9,11,12,14,15,16,17,18,19,20,20,21,21,21,22,22,22,22,22,22,22,22
E01033044,EV motorcycles,Number,0,1,2,3,4,6,8,9,11,13,15,16,18,19,20,22,23,23,24,25,25,25,25,26,26,26,26,26,26,26
E01033045,EV motorcycles,Number,0,1,2,3,4,5,7,8,10,11,13,14,16,17,18,19,20,21,21,22,22,22,23,23,23,23,23,23,23,23
E01033046,EV motorcycles,Number,0,1,1,2,3,4,5,6,7,8,10,11,12,13,13,14,15,15,16,16,16,16,17,17,17,17,17,17,17,17
E01033047,EV motorcycles,Number,0,1,1,2,3,4,5,6,8,9,10,11,12,13,14,15,16,16,17,17,17,17,18,18,18,18,18,18,18,18
E01033048,EV motorcycles,Number,0,1,1,2,4,5,6,8,9,11,12,14,15,16,17,18,19,20,20,21,21,21,22,22,22,22,22,22,22,22
E01033049,EV motorcycles,Number,0,0,0,1,1,2,2,2,3,3,4,4,5,5,6,6,6,6,6,7,7,7,7,7,7,7,7,7,7,7
E01033050,EV motorcycles,Number,0,1,2,3,5,7,9,11,13,15,17,19,21,22,24,25,26,27,28,28,29,29,29,30,30,30,30,30,30,30
E01033051,EV motorcycles,Number,1,2,5,8,12,15,20,25,29,34,39,43,47,51,54,57,60,62,64,65,66,67,68,68,68,69,69,69,69,69
E01033052,EV motorcycles,Number,1,2,4,7,10,14,18,22,26,30,34,38,42,45,48,51,53,55,56,58,58,59,60,60,60,61,61,61,61,61
E01033053,EV motorcycles,Number,1,2,3,5,8,10,13,16,19,22,25,28,31,33,35,37,39,40,42,42,43,44,44,44,45,45,45,45,45,45
E01033054,EV motorcycles,Number,0,1,2,3,4,6,8,9,11,13,15,16,18,19,20,22,23,23,24,25,25,25,25,26,26,26,26,26,26,26
E01033055,EV motorcycles,Number,1,1,3,4,7,9,11,14,16,19,22,24,27,29,31,32,34,35,36,37,37,38,38,38,39,39,39,39,39,39
E01033056,EV motorcycles,Number,1,1,3,5,7,9,12,15,17,20,23,26,28,30,32,34,36,37,38,39,39,40,40,40,41,41,41,41,41,41
E01033057,EV motorcycles,Number,2,4,8,13,19,26,33,41,49,57,64,72,79,85,91,96,100,103,106,109,110,112,113,113,114,114,115,115,115,115
E01033063,EV motorcycles,Number,0,1,1,2,2,3,4,5,6,7,8,9,10,10,11,12,12,13,13,13,13,14,14,14,14,14,14,14,14,14
E01033064,EV motorcycles,Number,0,1,1,2,3,4,5,6,7,8,10,11,12,13,13,14,15,15,16,16,16,16,17,17,17,17,17,17,17,17
E01033085,EV motorcycles,Number,0,1,1,2,3,4,5,7,8,9,11,12,13,14,15,16,17,17,18,18,18,18,19,19,19,19,19,19,19,19
E01033086,EV motorcycles,Number,0,0,1,1,2,2,3,3,4,4,5,6,6,7,7,7,8,8,8,8,9,9,9,9,9,9,9,9,9,9
E01033087,EV motorcycles,Number,1,3,5,8,13,17,22,27,32,37,43,47,52,56,60,63,66,68,70,72,73,74,74,75,75,75,76,76,76,76
E01033088,EV motorcycles,Number,0,1,2,3,4,5,7,9,10,12,13,15,16,18,19,20,21,22,22,23,23,23,23,24,24,24,24,24,24,24
E01033089,EV motorcycles,Number,0,1,2,3,5,7,9,11,13,15,17,19,21,23,24,26,27,28,29,29,30,30,30,31,31,31,31,31,31,31
E01033090,EV motorcycles,Number,0,1,2,3,5,6,8,10,12,14,16,17,19,21,22,23,24,25,26,26,27,27,27,28,28,28,28,28,28,28
E01033091,EV motorcycles,Number,1,2,3,5,7,10,13,16,19,22,25,27,30,33,35,37,38,40,41,42,42,43,43,43,44,44,44,44,44,44
E01033092,EV motorcycles,Number,0,1,2,3,4,5,7,9,10,12,13,15,16,18,19,20,21,22,22,23,23,23,23,24,24,24,24,24,24,24
E01033093,EV motorcycles,Number,1,2,4,6,9,13,16,20,24,28,31,35,38,41,44,47,49,50,52,53,54,54,55,55,55,56,56,56,56,56
E01033098,EV motorcycles,Number,0,0,1,1,2,3,4,5,5,6,7,8,9,10,10,11,11,12,12,12,12,13,13,13,13,13,13,13,13,13
E01033099,EV motorcycles,Number,0,1,2,4,6,8,10,12,14,17,19,21,23,25,27,28,30,31,31,32,33,33,33,33,34,34,34,34,34,34
E01033100,EV motorcycles,Number,15,37,66,112,170,228,294,361,429,500,569,632,695,751,801,845,883,914,939,959,974,986,995,1001,1006,1009,1016,1016,1016,1016
E01033101,EV motorcycles,Number,1,2,4,7,10,13,17,21,25,30,34,37,41,44,47,50,52,54,55,57,58,58,59,59,59,60,60,60,60,60
E01033111,EV motorcycles,Number,1,1,2,4,6,9,11,13,16,19,21,24,26,28,30,32,33,34,35,36,36,37,37,37,38,38,38,38,38,38
E01033112,EV motorcycles,Number,0,0,1,1,2,3,3,4,5,6,7,7,8,9,9,10,10,11,11,11,12,12,12,12,12,12,12,12,12,12
E01033113,EV motorcycles,Number,0,1,2,3,5,6,8,10,11,13,15,17,18,20,21,22,23,24,25,25,26,26,26,27,27,27,27,27,27,27
E01033114,EV motorcycles,Number,0,1,2,3,4,6,7,9,11,12,14,16,17,18,20,21,22,22,23,24,24,24,24,25,25,25,25,25,25,25
E01033115,EV motorcycles,Number,0,1,2,3,4,5,7,8,10,11,13,14,16,17,18,19,20,21,21,22,22,22,23,23,23,23,23,23,23,23
E01033116,EV motorcycles,Number,1,3,5,8,13,17,22,27,32,37,43,47,52,56,60,63,66,68,70,72,73,74,74,75,75,75,76,76,76,76
E01033117,EV motorcycles,Number,0,1,1,2,4,5,6,7,9,10,12,13,14,16,17,17,18,19,19,20,20,20,21,21,21,21,21,21,21,21
E01033118,EV motorcycles,Number,1,3,5,8,13,17,22,27,32,37,42,47,51,55,59,62,65,67,69,71,72,73,73,74,74,74,75,75,75,75
E01033119,EV motorcycles,Number,1,2,5,8,12,15,20,25,29,34,39,43,47,51,54,57,60,62,64,65,66,67,68,68,68,69,69,69,69,69
E01033120,EV motorcycles,Number,0,1,2,3,4,6,8,9,11,13,15,16,18,19,20,22,23,23,24,25,25,25,25,26,26,26,26,26,26,26
E01033121,EV motorcycles,Number,1,1,2,4,6,8,10,12,15,17,20,22,24,26,28,29,30,31,32,33,34,34,34,34,35,35,35,35,35,35
E01033122,EV motorcycles,Number,1,1,2,4,6,9,11,13,16,19,21,24,26,28,30,32,33,34,35,36,36,37,37,37,38,38,38,38,38,38
E01033123,EV motorcycles,Number,1,2,3,5,8,11,14,17,21,24,27,31,33,36,39,41,43,44,45,46,47,48,48,48,48,49,49,49,49,49
E01033124,EV motorcycles,Number,0,0,0,0,0,0,0,0,0,0,0,0,0,0,0,0,0,0,0,0,0,0,0,0,0,0,0,0,0,0
E01033125,EV motorcycles,Number,0,0,1,1,2,3,4,5,5,6,7,8,9,10,10,11,11,12,12,12,12,13,13,13,13,13,13,13,13,13
E01033126,EV motorcycles,Number,0,1,1,2,3,4,6,7,8,10,11,12,14,15,16,17,17,18,18,19,19,19,20,20,20,20,20,20,20,20
E01033127,EV motorcycles,Number,1,1,3,4,7,9,12,14,17,20,22,25,27,30,32,33,35,36,37,38,38,39,39,39,40,40,40,40,40,40
E01033128,EV motorcycles,Number,0,1,2,3,4,6,8,9,11,13,15,16,18,19,20,22,23,23,24,25,25,25,25,26,26,26,26,26,26,26
E01033129,EV motorcycles,Number,0,1,2,3,4,6,7,9,11,12,14,16,17,18,20,21,22,22,23,24,24,24,24,25,25,25,25,25,25,25
E01033130,EV motorcycles,Number,0,1,1,2,3,4,5,6,7,8,10,11,12,13,13,14,15,15,16,16,16,16,17,17,17,17,17,17,17,17
E01033131,EV motorcycles,Number,1,2,3,5,7,9,12,15,18,21,24,26,29,31,33,35,36,38,39,40,40,41,41,41,42,42,42,42,42,42
E01033132,EV motorcycles,Number,1,1,2,4,6,8,10,13,15,18,20,22,25,27,28,30,31,32,33,34,35,35,35,35,36,36,36,36,36,36
E01033133,EV motorcycles,Number,0,1,2,3,4,6,8,9,11,13,15,16,18,19,20,22,23,23,24,25,25,25,25,26,26,26,26,26,26,26
E01033135,EV motorcycles,Number,0,0,1,1,2,3,4,5,5,6,7,8,9,10,10,11,11,12,12,12,12,13,13,13,13,13,13,13,13,13
E01033137,EV motorcycles,Number,0,1,2,4,5,7,9,11,14,16,18,20,22,24,25,27,28,29,30,30,31,31,31,32,32,32,32,32,32,32
E01033138,EV motorcycles,Number,1,4,7,11,17,22,29,36,42,49,56,62,68,74,79,83,87,90,92,94,96,97,98,99,99,99,100,100,100,100
E01033139,EV motorcycles,Number,0,1,2,3,5,6,8,10,11,13,15,17,18,20,21,22,23,24,25,25,26,26,26,27,27,27,27,27,27,27
E01033140,EV motorcycles,Number,1,1,2,4,6,8,10,12,15,17,20,22,24,26,28,29,30,31,32,33,34,34,34,34,35,35,35,35,35,35
E01033141,EV motorcycles,Number,0,1,2,3,5,7,8,10,12,14,16,18,20,21,23,24,25,26,27,27,28,28,28,29,29,29,29,29,29,29
E01033142,EV motorcycles,Number,1,2,3,5,8,11,14,17,21,24,27,31,33,36,39,41,43,44,45,46,47,48,48,48,48,49,49,49,49,49
E01033143,EV motorcycles,Number,1,3,5,9,14,18,24,29,35,40,46,51,56,61,65,68,71,74,76,77,79,80,80,81,81,81,82,82,82,82
E01033144,EV motorcycles,Number,1,2,3,5,7,10,13,16,19,22,25,27,30,33,35,37,38,40,41,42,42,43,43,43,44,44,44,44,44,44
E01033145,EV motorcycles,Number,1,1,3,5,7,9,12,15,17,20,23,26,28,30,32,34,36,37,38,39,39,40,40,40,41,41,41,41,41,41
E01033146,EV motorcycles,Number,0,0,1,1,1,2,2,3,3,4,4,5,5,6,6,7,7,7,7,8,8,8,8,8,8,8,8,8,8,8
E01033148,EV motorcycles,Number,0,1,2,3,4,6,7,9,11,12,14,16,17,18,20,21,22,22,23,24,24,24,24,25,25,25,25,25,25,25
E01033150,EV motorcycles,Number,0,0,1,1,2,3,3,4,5,6,7,7,8,9,9,10,10,11,11,11,12,12,12,12,12,12,12,12,12,12
E01033151,EV motorcycles,Number,0,0,1,1,2,3,3,4,5,6,7,7,8,9,9,10,10,11,11,11,12,12,12,12,12,12,12,12,12,12
E01033153,EV motorcycles,Number,0,1,1,2,3,4,5,6,7,8,9,10,11,12,13,13,14,14,15,15,15,16,16,16,16,16,16,16,16,16
E01033173,EV motorcycles,Number,1,2,3,5,7,9,12,15,18,21,24,26,29,31,33,35,36,38,39,40,40,41,41,41,42,42,42,42,42,42
E01033174,EV motorcycles,Number,1,2,4,6,9,12,16,20,23,27,31,34,38,41,43,46,48,49,51,52,53,53,54,54,54,55,55,55,55,55
E01033175,EV motorcycles,Number,0,1,2,3,4,5,7,8,10,11,13,14,16,17,18,19,20,21,21,22,22,22,23,23,23,23,23,23,23,23
E01033176,EV motorcycles,Number,1,2,3,5,8,11,14,17,20,23,26,29,32,35,37,39,41,42,43,44,45,46,46,46,47,47,47,47,47,47
E01033177,EV motorcycles,Number,0,1,2,3,4,6,8,9,11,13,15,16,18,19,20,22,23,23,24,25,25,25,25,26,26,26,26,26,26,26
E01033178,EV motorcycles,Number,1,2,3,5,8,10,13,16,19,22,25,28,31,33,35,37,39,40,42,42,43,44,44,44,45,45,45,45,45,45
E01033179,EV motorcycles,Number,1,2,3,6,9,11,15,18,22,25,29,32,35,38,40,42,44,46,47,48,49,49,50,50,50,51,51,51,51,51
E01033180,EV motorcycles,Number,0,1,2,3,4,5,7,9,10,12,13,15,16,18,19,20,21,22,22,23,23,23,23,24,24,24,24,24,24,24
E01033181,EV motorcycles,Number,0,1,2,3,5,7,9,11,13,15,17,19,21,23,24,26,27,28,29,29,30,30,30,31,31,31,31,31,31,31
E01033182,EV motorcycles,Number,0,1,2,3,5,6,8,10,12,14,16,17,19,21,22,23,24,25,26,26,27,27,27,28,28,28,28,28,28,28
E01033188,EV motorcycles,Number,0,1,2,4,5,7,9,11,14,16,18,20,22,24,25,27,28,29,30,30,31,31,31,32,32,32,32,32,32,32
E01033189,EV motorcycles,Number,1,2,4,7,11,15,19,23,27,32,36,40,44,48,51,54,56,58,60,61,62,63,64,64,64,65,65,65,65,65
E01033190,EV motorcycles,Number,0,1,1,2,4,5,6,7,9,10,12,13,14,16,17,17,18,19,19,20,20,20,21,21,21,21,21,21,21,21
E01033191,EV motorcycles,Number,0,1,2,3,5,7,9,11,13,15,17,19,21,22,24,25,26,27,28,28,29,29,29,30,30,30,30,30,30,30
E01033192,EV motorcycles,Number,0,1,2,3,4,5,7,8,10,11,13,14,16,17,18,19,20,21,21,22,22,22,23,23,23,23,23,23,23,23
E01033193,EV motorcycles,Number,1,2,3,6,9,11,15,18,22,25,29,32,35,38,40,42,44,46,47,48,49,49,50,50,50,51,51,51,51,51
E01033194,EV motorcycles,Number,1,3,5,8,12,16,20,25,30,34,39,44,48,52,55,58,61,63,65,66,67,68,69,69,69,70,70,70,70,70
E01033207,EV motorcycles,Number,0,1,2,3,5,6,8,10,11,13,15,17,18,20,21,22,23,24,25,25,26,26,26,27,27,27,27,27,27,27
E01033208,EV motorcycles,Number,0,1,1,2,3,3,4,5,6,7,8,9,10,11,12,12,13,13,14,14,14,15,15,15,15,15,15,15,15,15
E01033209,EV motorcycles,Number,0,1,1,2,4,5,6,7,9,10,12,13,14,16,17,17,18,19,19,20,20,20,21,21,21,21,21,21,21,21
E01033210,EV motorcycles,Number,1,3,6,10,16,21,27,33,40,46,53,59,64,69,74,78,82,85,87,89,90,91,92,93,93,93,94,94,94,94
E01033211,EV motorcycles,Number,0,0,1,1,2,3,3,4,5,6,7,7,8,9,9,10,10,11,11,11,12,12,12,12,12,12,12,12,12,12
E01033212,EV motorcycles,Number,0,1,2,4,5,7,9,11,14,16,18,20,22,24,25,27,28,29,30,30,31,31,31,32,32,32,32,32,32,32
E01033213,EV motorcycles,Number,1,2,4,6,9,13,16,20,24,28,31,35,38,41,44,47,49,50,52,53,54,54,55,55,55,56,56,56,56,56
E01033214,EV motorcycles,Number,1,2,4,7,10,14,18,22,26,30,34,38,42,45,48,51,53,55,56,58,58,59,60,60,60,61,61,61,61,61
E01033215,EV motorcycles,Number,0,1,1,2,3,4,5,6,7,8,9,10,11,12,13,13,14,14,15,15,15,16,16,16,16,16,16,16,16,16
E01033308,EV motorcycles,Number,0,1,1,2,4,5,6,7,9,10,12,13,14,16,17,17,18,19,19,20,20,20,21,21,21,21,21,21,21,21
E01033310,EV motorcycles,Number,0,1,2,3,5,6,8,10,11,13,15,17,18,20,21,22,23,24,25,25,26,26,26,27,27,27,27,27,27,27
E01033311,EV motorcycles,Number,0,1,2,3,5,7,9,11,13,15,17,19,21,22,24,25,26,27,28,28,29,29,29,30,30,30,30,30,30,30
E01033313,EV motorcycles,Number,0,1,2,3,4,6,7,9,11,12,14,16,17,18,20,21,22,22,23,24,24,24,24,25,25,25,25,25,25,25
E01033314,EV motorcycles,Number,0,1,1,2,3,4,6,7,8,10,11,12,14,15,16,17,17,18,18,19,19,19,20,20,20,20,20,20,20,20
E01033316,EV motorcycles,Number,1,2,4,7,10,13,17,21,25,30,34,37,41,44,47,50,52,54,55,57,58,58,59,59,59,60,60,60,60,60
E01033317,EV motorcycles,Number,1,2,3,5,7,10,12,15,18,21,24,27,29,32,34,36,37,39,40,41,41,42,42,42,43,43,43,43,43,43
E01033319,EV motorcycles,Number,1,2,3,5,8,11,14,17,20,24,27,30,33,35,38,40,42,43,44,45,46,47,47,47,48,48,48,48,48,48
E01033320,EV motorcycles,Number,0,1,2,3,4,5,7,9,10,12,13,15,16,18,19,20,21,22,22,23,23,23,23,24,24,24,24,24,24,24
E01033322,EV motorcycles,Number,0,0,1,1,2,2,3,4,4,5,6,6,7,7,8,8,9,9,9,9,10,10,10,10,10,10,10,10,10,10
E01033324,EV motorcycles,Number,0,0,0,0,0,0,0,0,0,0,0,0,0,0,0,0,0,0,0,0,0,0,0,0,0,0,0,0,0,0
E01033325,EV motorcycles,Number,0,1,2,3,4,5,7,8,10,11,13,14,16,17,18,19,20,21,21,22,22,22,23,23,23,23,23,23,23,23
E01033327,EV motorcycles,Number,0,1,2,4,6,8,10,12,14,17,19,21,23,25,27,28,30,31,31,32,33,33,33,33,34,34,34,34,34,34
E01033328,EV motorcycles,Number,0,0,1,1,2,3,3,4,5,6,7,7,8,9,9,10,10,11,11,11,12,12,12,12,12,12,12,12,12,12
E01033329,EV motorcycles,Number,0,1,2,3,5,6,8,10,12,14,16,17,19,21,22,23,24,25,26,26,27,27,27,28,28,28,28,28,28,28
E01033341,EV motorcycles,Number,0,0,1,1,2,3,4,5,5,6,7,8,9,10,10,11,11,12,12,12,12,13,13,13,13,13,13,13,13,13
E01033424,EV motorcycles,Number,1,3,5,8,13,17,22,27,33,38,43,48,53,57,61,64,67,69,71,73,74,75,75,76,76,76,77,77,77,77
E01033425,EV motorcycles,Number,0,1,2,4,6,7,10,12,14,16,18,21,23,24,26,27,29,30,31,31,32,32,32,33,33,33,33,33,33,33
E01033426,EV motorcycles,Number,0,1,2,3,5,6,8,10,11,13,15,17,18,20,21,22,23,24,25,25,26,26,26,27,27,27,27,27,27,27
E01033427,EV motorcycles,Number,0,1,2,4,6,7,10,12,14,16,18,21,23,24,26,27,29,30,31,31,32,32,32,33,33,33,33,33,33,33
E01033428,EV motorcycles,Number,0,1,2,3,5,7,8,10,12,14,16,18,20,21,23,24,25,26,27,27,28,28,28,29,29,29,29,29,29,29
E01033429,EV motorcycles,Number,1,3,5,9,14,19,24,30,36,41,47,52,57,62,66,70,73,76,78,79,81,82,82,83,83,83,84,84,84,84
E01033430,EV motorcycles,Number,0,1,2,3,5,7,9,11,13,15,17,19,21,23,24,26,27,28,29,29,30,30,30,31,31,31,31,31,31,31
E01033431,EV motorcycles,Number,0,1,1,2,4,5,6,7,9,10,12,13,14,16,17,17,18,19,19,20,20,20,21,21,21,21,21,21,21,21
E01033432,EV motorcycles,Number,2,4,7,12,18,24,30,37,44,52,59,65,72,78,83,87,91,94,97,99,101,102,103,103,104,104,105,105,105,105
E01033433,EV motorcycles,Number,2,4,8,13,20,27,35,43,51,59,67,75,82,89,95,100,104,108,111,113,115,116,117,118,119,119,120,120,120,120
E01033434,EV motorcycles,Number,0,0,1,1,2,2,3,4,5,5,6,7,8,8,9,9,10,10,10,10,11,11,11,11,11,11,11,11,11,11
E01033435,EV motorcycles,Number,0,1,2,3,5,7,8,10,12,14,16,18,20,21,23,24,25,26,27,27,28,28,28,29,29,29,29,29,29,29
E01033436,EV motorcycles,Number,0,1,2,3,5,7,9,11,13,15,17,19,21,22,24,25,26,27,28,28,29,29,29,30,30,30,30,30,30,30
E01033437,EV motorcycles,Number,0,1,2,3,5,6,8,10,12,14,16,17,19,21,22,23,24,25,26,26,27,27,27,28,28,28,28,28,28,28
E01033438,EV motorcycles,Number,0,1,1,2,4,5,6,7,9,10,12,13,14,16,17,17,18,19,19,20,20,20,21,21,21,21,21,21,21,21
E01033439,EV motorcycles,Number,1,1,2,4,6,9,11,13,16,19,21,24,26,28,30,32,33,34,35,36,36,37,37,37,38,38,38,38,38,38
E01033440,EV motorcycles,Number,0,1,2,4,5,7,9,11,14,16,18,20,22,24,25,27,28,29,30,30,31,31,31,32,32,32,32,32,32,32
E01033441,EV motorcycles,Number,0,1,2,3,5,6,8,10,12,14,16,17,19,21,22,23,24,25,26,26,27,27,27,28,28,28,28,28,28,28
E01033442,EV motorcycles,Number,1,1,3,4,7,9,12,14,17,20,22,25,27,30,32,33,35,36,37,38,38,39,39,39,40,40,40,40,40,40
E01033443,EV motorcycles,Number,0,1,2,3,5,7,8,10,12,14,16,18,20,21,23,24,25,26,27,27,28,28,28,29,29,29,29,29,29,29
E01033444,EV motorcycles,Number,0,1,2,3,5,6,8,10,11,13,15,17,18,20,21,22,23,24,25,25,26,26,26,27,27,27,27,27,27,27
E01033445,EV motorcycles,Number,1,2,3,6,9,11,15,18,22,25,29,32,35,38,40,42,44,46,47,48,49,49,50,50,50,51,51,51,51,51
E01033446,EV motorcycles,Number,2,4,8,13,19,26,33,41,49,57,64,72,79,85,91,96,100,103,106,109,110,112,113,113,114,114,115,115,115,115
E01033447,EV motorcycles,Number,1,2,3,5,7,10,13,16,19,22,25,27,30,33,35,37,38,40,41,42,42,43,43,43,44,44,44,44,44,44
E01033448,EV motorcycles,Number,1,2,4,6,10,13,17,21,25,29,32,36,40,43,46,48,50,52,54,55,56,56,57,57,57,58,58,58,58,58
E01033449,EV motorcycles,Number,1,3,5,9,14,18,24,29,35,40,46,51,56,61,65,68,71,74,76,77,79,80,80,81,81,81,82,82,82,82
E01033450,EV motorcycles,Number,1,2,4,7,10,14,18,22,26,30,34,38,42,45,48,51,53,55,56,58,58,59,60,60,60,61,61,61,61,61
E01033451,EV motorcycles,Number,0,1,2,4,6,8,10,12,14,17,19,21,23,25,27,28,30,31,31,32,33,33,33,33,34,34,34,34,34,34
E01033452,EV motorcycles,Number,1,1,2,4,6,8,11,13,16,18,21,23,25,27,29,31,32,33,34,35,35,36,36,36,37,37,37,37,37,37
E01033453,EV motorcycles,Number,3,8,14,23,35,47,61,75,89,103,118,131,144,155,166,175,182,189,194,198,201,204,206,207,208,209,210,210,210,210
E01033454,EV motorcycles,Number,0,1,2,3,5,7,9,11,13,15,17,19,21,23,24,26,27,28,29,29,30,30,30,31,31,31,31,31,31,31
E01033455,EV motorcycles,Number,0,1,2,4,6,8,10,12,14,17,19,21,23,25,27,28,30,31,31,32,33,33,33,33,34,34,34,34,34,34
E01033456,EV motorcycles,Number,0,1,2,3,4,5,7,9,10,12,13,15,16,18,19,20,21,22,22,23,23,23,23,24,24,24,24,24,24,24
E01033457,EV motorcycles,Number,0,1,2,3,5,7,9,11,13,15,17,19,21,22,24,25,26,27,28,28,29,29,29,30,30,30,30,30,30,30
E01033458,EV motorcycles,Number,0,1,2,3,5,6,8,10,11,13,15,17,18,20,21,22,23,24,25,25,26,26,26,27,27,27,27,27,27,27
E01033459,EV motorcycles,Number,1,2,3,5,7,10,12,15,18,21,24,27,29,32,34,36,37,39,40,41,41,42,42,42,43,43,43,43,43,43
E01033460,EV motorcycles,Number,0,1,2,4,5,7,9,11,14,16,18,20,22,24,25,27,28,29,30,30,31,31,31,32,32,32,32,32,32,32
E01033461,EV motorcycles,Number,0,1,2,3,5,6,8,10,11,13,15,17,18,20,21,22,23,24,25,25,26,26,26,27,27,27,27,27,27,27
E01033462,EV motorcycles,Number,0,1,2,3,5,7,9,11,13,15,17,19,21,22,24,25,26,27,28,28,29,29,29,30,30,30,30,30,30,30
E01033463,EV motorcycles,Number,1,1,2,4,6,9,11,13,16,19,21,24,26,28,30,32,33,34,35,36,36,37,37,37,38,38,38,38,38,38
E01033464,EV motorcycles,Number,1,2,3,5,8,11,14,17,20,24,27,30,33,35,38,40,42,43,44,45,46,47,47,47,48,48,48,48,48,48
E01033485,EV motorcycles,Number,1,2,3,5,8,10,13,16,19,22,25,28,31,33,35,37,39,40,42,42,43,44,44,44,45,45,45,45,45,45
E01033486,EV motorcycles,Number,0,0,1,1,2,3,4,5,5,6,7,8,9,10,10,11,11,12,12,12,12,13,13,13,13,13,13,13,13,13
E01033487,EV motorcycles,Number,0,1,1,2,2,3,4,5,6,7,8,9,10,10,11,12,12,13,13,13,13,14,14,14,14,14,14,14,14,14
E01033488,EV motorcycles,Number,0,0,0,1,1,1,2,2,3,3,3,4,4,4,5,5,5,5,6,6,6,6,6,6,6,6,6,6,6,6
E01033489,EV motorcycles,Number,0,0,1,1,2,3,3,4,5,6,7,7,8,9,9,10,10,11,11,11,12,12,12,12,12,12,12,12,12,12
E01033490,EV motorcycles,Number,0,1,1,2,3,4,5,6,7,8,10,11,12,13,13,14,15,15,16,16,16,16,17,17,17,17,17,17,17,17
E01033491,EV motorcycles,Number,0,1,2,3,4,6,7,9,11,12,14,16,17,18,20,21,22,22,23,24,24,24,24,25,25,25,25,25,25,25
E01033492,EV motorcycles,Number,0,1,1,2,3,4,5,6,7,8,10,11,12,13,13,14,15,15,16,16,16,16,17,17,17,17,17,17,17,17
E01033493,EV motorcycles,Number,0,1,1,2,3,4,5,6,7,8,10,11,12,13,13,14,15,15,16,16,16,16,17,17,17,17,17,17,17,17
E01033494,EV motorcycles,Number,0,0,1,1,2,2,3,4,4,5,6,6,7,7,8,8,9,9,9,9,10,10,10,10,10,10,10,10,10,10
E01033538,EV motorcycles,Number,1,4,6,11,17,22,29,35,42,49,55,62,68,73,78,82,86,89,92,93,95,96,97,98,98,98,99,99,99,99
E01033539,EV motorcycles,Number,1,2,4,6,9,12,16,20,23,27,31,34,38,41,43,46,48,49,51,52,53,53,54,54,54,55,55,55,55,55
E01033540,EV motorcycles,Number,1,2,3,6,9,12,15,18,22,26,29,32,36,38,41,43,45,47,48,49,50,50,51,51,51,52,52,52,52,52
E01033541,EV motorcycles,Number,1,1,3,4,7,9,11,14,16,19,22,24,27,29,31,32,34,35,36,37,37,38,38,38,39,39,39,39,39,39
E01033568,EV motorcycles,Number,0,1,2,3,4,6,7,9,11,12,14,16,17,18,20,21,22,22,23,24,24,24,24,25,25,25,25,25,25,25
E01033569,EV motorcycles,Number,0,1,2,3,4,5,7,9,10,12,13,15,16,18,19,20,21,22,22,23,23,23,23,24,24,24,24,24,24,24
E01033570,EV motorcycles,Number,0,1,1,3,4,5,7,8,10,11,13,14,16,17,18,19,20,21,21,22,22,22,22,23,23,23,23,23,23,23
E01033571,EV motorcycles,Number,1,2,3,5,8,10,13,16,19,22,25,28,31,33,35,37,39,40,42,42,43,44,44,44,45,45,45,45,45,45
E01033572,EV motorcycles,Number,1,2,3,6,8,11,14,18,21,25,28,31,34,37,39,42,43,45,46,47,48,49,49,49,49,50,50,50,50,50
E01033573,EV motorcycles,Number,1,1,2,4,6,8,10,13,15,18,20,22,25,27,28,30,31,32,33,34,35,35,35,35,36,36,36,36,36,36
E01033574,EV motorcycles,Number,0,0,0,0,0,0,0,0,0,0,0,0,0,0,0,0,0,0,0,0,0,0,0,0,0,0,0,0,0,0
E01033575,EV motorcycles,Number,0,0,1,1,2,2,3,3,4,4,5,6,6,7,7,7,8,8,8,8,9,9,9,9,9,9,9,9,9,9
E01033576,EV motorcycles,Number,0,1,2,3,4,6,8,9,11,13,15,16,18,19,20,22,23,23,24,25,25,25,25,26,26,26,26,26,26,26
E01033577,EV motorcycles,Number,1,2,3,5,7,10,12,15,18,21,24,27,29,32,34,36,37,39,40,41,41,42,42,42,43,43,43,43,43,43
E01033578,EV motorcycles,Number,0,1,2,3,5,7,8,10,12,14,16,18,20,21,23,24,25,26,27,27,28,28,28,29,29,29,29,29,29,29
E01033579,EV motorcycles,Number,0,1,2,3,5,7,9,11,13,15,17,19,21,22,24,25,26,27,28,28,29,29,29,30,30,30,30,30,30,30
E01033580,EV motorcycles,Number,0,1,2,3,4,5,7,8,10,11,13,14,16,17,18,19,20,21,21,22,22,22,23,23,23,23,23,23,23,23
E01033581,EV motorcycles,Number,0,1,1,2,2,3,4,5,6,7,8,9,10,10,11,12,12,13,13,13,13,14,14,14,14,14,14,14,14,14
E01033582,EV motorcycles,Number,0,1,2,3,4,5,7,9,10,12,13,15,16,18,19,20,21,22,22,23,23,23,23,24,24,24,24,24,24,24
E01033583,EV motorcycles,Number,1,2,4,7,11,15,20,24,29,33,38,42,46,50,54,57,59,61,63,64,65,66,67,67,67,68,68,68,68,68
E01033584,EV motorcycles,Number,0,1,2,3,4,5,7,9,10,12,13,15,16,18,19,20,21,22,22,23,23,23,23,24,24,24,24,24,24,24
E01033585,EV motorcycles,Number,0,1,1,2,3,4,6,7,8,10,11,12,14,15,16,17,17,18,18,19,19,19,20,20,20,20,20,20,20,20
E01033586,EV motorcycles,Number,0,1,2,4,6,7,10,12,14,16,18,21,23,24,26,27,29,30,31,31,32,32,32,33,33,33,33,33,33,33
E01033587,EV motorcycles,Number,0,1,2,3,4,6,7,9,11,12,14,16,17,18,20,21,22,22,23,24,24,24,24,25,25,25,25,25,25,25
E01033588,EV motorcycles,Number,0,0,1,1,2,2,3,4,4,5,6,6,7,7,8,8,9,9,9,9,10,10,10,10,10,10,10,10,10,10
E01033589,EV motorcycles,Number,0,1,1,2,3,4,5,6,8,9,10,11,12,13,14,15,16,16,17,17,17,17,18,18,18,18,18,18,18,18
E01033590,EV motorcycles,Number,0,0,1,1,1,2,2,3,3,4,4,5,5,6,6,7,7,7,7,8,8,8,8,8,8,8,8,8,8,8
E01033591,EV motorcycles,Number,0,1,1,2,3,4,5,6,7,8,9,10,11,12,13,13,14,14,15,15,15,16,16,16,16,16,16,16,16,16
E01033592,EV motorcycles,Number,0,1,2,4,5,7,9,11,14,16,18,20,22,24,25,27,28,29,30,30,31,31,31,32,32,32,32,32,32,32
E01033593,EV motorcycles,Number,0,0,1,1,2,2,3,4,5,5,6,7,8,8,9,9,10,10,10,10,11,11,11,11,11,11,11,11,11,11
E01033594,EV motorcycles,Number,0,1,1,2,3,4,5,7,8,9,11,12,13,14,15,16,17,17,18,18,18,18,19,19,19,19,19,19,19,19
E01033595,EV motorcycles,Number,0,1,2,3,5,6,8,10,11,13,15,17,18,20,21,22,23,24,25,25,26,26,26,27,27,27,27,27,27,27
E01033596,EV motorcycles,Number,0,1,1,2,3,4,5,6,7,8,9,10,11,12,13,13,14,14,15,15,15,16,16,16,16,16,16,16,16,16
E01033597,EV motorcycles,Number,0,1,1,2,3,4,5,6,8,9,10,11,12,13,14,15,16,16,17,17,17,17,18,18,18,18,18,18,18,18
E01033598,EV motorcycles,Number,0,0,1,1,2,3,4,5,5,6,7,8,9,10,10,11,11,12,12,12,12,13,13,13,13,13,13,13,13,13
E01033599,EV motorcycles,Number,0,1,1,2,3,4,6,7,8,10,11,12,14,15,16,17,17,18,18,19,19,19,20,20,20,20,20,20,20,20
E01033600,EV motorcycles,Number,0,1,1,2,3,4,6,7,8,10,11,12,14,15,16,17,17,18,18,19,19,19,20,20,20,20,20,20,20,20
E01033601,EV motorcycles,Number,0,1,1,2,2,3,4,5,6,7,8,9,10,10,11,12,12,13,13,13,13,14,14,14,14,14,14,14,14,14
E01033602,EV motorcycles,Number,0,1,1,2,4,5,6,8,9,11,12,14,15,16,17,18,19,20,20,21,21,21,22,22,22,22,22,22,22,22
E01033603,EV motorcycles,Number,0,0,1,1,2,3,4,5,5,6,7,8,9,10,10,11,11,12,12,12,12,13,13,13,13,13,13,13,13,13
E01033604,EV motorcycles,Number,0,1,1,2,2,3,4,5,6,7,8,9,10,10,11,12,12,13,13,13,13,14,14,14,14,14,14,14,14,14
E01033605,EV motorcycles,Number,0,1,1,2,3,4,5,6,7,8,10,11,12,13,13,14,15,15,16,16,16,16,17,17,17,17,17,17,17,17
E01033606,EV motorcycles,Number,0,0,1,1,1,2,2,3,3,4,4,5,5,6,6,7,7,7,7,8,8,8,8,8,8,8,8,8,8,8
E01033607,EV motorcycles,Number,0,1,2,3,5,6,8,10,12,14,16,17,19,21,22,23,24,25,26,26,27,27,27,28,28,28,28,28,28,28
E01033608,EV motorcycles,Number,0,1,1,2,4,5,6,7,9,10,12,13,14,16,17,17,18,19,19,20,20,20,21,21,21,21,21,21,21,21
E01033609,EV motorcycles,Number,1,2,4,7,11,15,19,23,27,32,36,40,44,48,51,54,56,58,60,61,62,63,64,64,64,65,65,65,65,65
E01033610,EV motorcycles,Number,0,1,1,2,3,4,5,6,7,8,9,10,11,12,13,13,14,14,15,15,15,16,16,16,16,16,16,16,16,16
E01033611,EV motorcycles,Number,0,1,1,2,2,3,4,5,6,7,8,9,10,10,11,12,12,13,13,13,13,14,14,14,14,14,14,14,14,14
E01033612,EV motorcycles,Number,0,1,1,2,3,4,5,6,7,8,9,10,11,12,13,13,14,14,15,15,15,16,16,16,16,16,16,16,16,16
E01033613,EV motorcycles,Number,0,1,1,2,2,3,4,5,6,7,8,9,10,10,11,12,12,13,13,13,13,14,14,14,14,14,14,14,14,14
E01033614,EV motorcycles,Number,0,1,2,3,4,6,8,9,11,13,15,16,18,19,20,22,23,23,24,25,25,25,25,26,26,26,26,26,26,26
E01033698,EV motorcycles,Number,0,0,0,0,0,0,0,0,0,0,0,0,0,0,0,0,0,0,0,0,0,0,0,0,0,0,0,0,0,0
E01033699,EV motorcycles,Number,0,1,1,2,3,4,5,6,7,8,9,10,11,12,13,13,14,14,15,15,15,16,16,16,16,16,16,16,16,16
E01033700,EV motorcycles,Number,0,1,2,3,4,5,7,8,10,11,13,14,16,17,18,19,20,21,21,22,22,22,23,23,23,23,23,23,23,23
E01033701,EV motorcycles,Number,0,1,2,3,5,7,9,11,13,15,17,19,21,23,24,26,27,28,29,29,30,30,30,31,31,31,31,31,31,31
E01033702,EV motorcycles,Number,0,1,2,3,4,5,7,9,10,12,13,15,16,18,19,20,21,22,22,23,23,23,23,24,24,24,24,24,24,24
E01033703,EV motorcycles,Number,0,1,1,2,3,4,5,6,7,8,10,11,12,13,13,14,15,15,16,16,16,16,17,17,17,17,17,17,17,17
E01033704,EV motorcycles,Number,0,1,2,3,4,5,7,8,10,11,13,14,16,17,18,19,20,21,21,22,22,22,23,23,23,23,23,23,23,23
E01033705,EV motorcycles,Number,0,0,1,1,2,2,3,3,4,4,5,6,6,7,7,7,8,8,8,8,9,9,9,9,9,9,9,9,9,9
E01033706,EV motorcycles,Number,0,1,2,3,4,6,7,9,11,12,14,16,17,18,20,21,22,22,23,24,24,24,24,25,25,25,25,25,25,25
E01033707,EV motorcycles,Number,0,0,1,1,1,2,2,3,3,4,4,5,5,6,6,7,7,7,7,8,8,8,8,8,8,8,8,8,8,8
E01033708,EV motorcycles,Number,0,1,1,2,4,5,6,7,9,10,12,13,14,16,17,17,18,19,19,20,20,20,21,21,21,21,21,21,21,21
E01033709,EV motorcycles,Number,0,1,1,2,3,3,4,5,6,7,8,9,10,11,12,12,13,13,14,14,14,15,15,15,15,15,15,15,15,15
E01033710,EV motorcycles,Number,0,0,1,1,2,2,3,4,4,5,6,6,7,7,8,8,9,9,9,9,10,10,10,10,10,10,10,10,10,10
E01033711,EV motorcycles,Number,0,0,1,1,2,3,4,5,5,6,7,8,9,10,10,11,11,12,12,12,12,13,13,13,13,13,13,13,13,13
E01033712,EV motorcycles,Number,0,0,1,1,2,3,3,4,5,6,7,7,8,9,9,10,10,11,11,11,12,12,12,12,12,12,12,12,12,12
E01033713,EV motorcycles,Number,0,0,1,1,2,3,3,4,5,6,7,7,8,9,9,10,10,11,11,11,12,12,12,12,12,12,12,12,12,12
E01033719,EV motorcycles,Number,0,0,0,1,1,2,2,2,3,3,4,4,5,5,6,6,6,6,6,7,7,7,7,7,7,7,7,7,7,7
E01033720,EV motorcycles,Number,1,2,3,5,7,9,12,15,18,21,24,26,29,31,33,35,36,38,39,40,40,41,41,41,42,42,42,42,42,42
E01033721,EV motorcycles,Number,0,1,1,2,4,5,6,8,9,11,12,14,15,16,17,18,19,20,20,21,21,21,22,22,22,22,22,22,22,22
E01033722,EV motorcycles,Number,0,1,1,2,4,5,6,7,9,10,12,13,14,16,17,17,18,19,19,20,20,20,21,21,21,21,21,21,21,21
E01033723,EV motorcycles,Number,1,2,4,6,10,13,16,20,24,28,32,35,39,42,45,47,50,51,53,54,55,55,56,56,56,57,57,57,57,57
E01033726,EV motorcycles,Number,1,3,5,8,12,16,21,26,30,35,40,45,49,53,57,60,63,65,67,68,69,70,70,71,71,71,72,72,72,72
E01033727,EV motorcycles,Number,0,1,1,2,3,4,5,7,8,9,11,12,13,14,15,16,17,17,18,18,18,18,19,19,19,19,19,19,19,19
E01033728,EV motorcycles,Number,0,1,1,2,3,4,5,7,8,9,11,12,13,14,15,16,17,17,18,18,18,18,19,19,19,19,19,19,19,19
E01033729,EV motorcycles,Number,0,1,2,3,5,7,9,11,13,15,17,19,21,23,24,26,27,28,29,29,30,30,30,31,31,31,31,31,31,31
E01033730,EV motorcycles,Number,0,1,2,3,5,6,8,10,12,14,16,17,19,21,22,23,24,25,26,26,27,27,27,28,28,28,28,28,28,28
E01033731,EV motorcycles,Number,0,1,2,3,5,6,8,10,11,13,15,17,18,20,21,22,23,24,25,25,26,26,26,27,27,27,27,27,27,27
E01033732,EV motorcycles,Number,0,0,0,0,0,0,0,0,0,0,0,0,0,0,0,0,0,0,0,0,0,0,0,0,0,0,0,0,0,0
E01033733,EV motorcycles,Number,0,1,2,3,4,6,7,9,11,12,14,16,17,18,20,21,22,22,23,24,24,24,24,25,25,25,25,25,25,25
E01033734,EV motorcycles,Number,0,1,1,2,2,3,4,5,6,7,8,9,10,10,11,12,12,13,13,13,13,14,14,14,14,14,14,14,14,14
E01033735,EV motorcycles,Number,0,0,1,1,2,2,3,4,5,5,6,7,8,8,9,9,10,10,10,10,11,11,11,11,11,11,11,11,11,11
E01033736,EV motorcycles,Number,0,1,2,3,4,6,7,9,11,12,14,16,17,18,20,21,22,22,23,24,24,24,24,25,25,25,25,25,25,25
E01033737,EV motorcycles,Number,0,1,1,2,3,4,5,7,8,9,11,12,13,14,15,16,17,17,18,18,18,18,19,19,19,19,19,19,19,19
E01033738,EV motorcycles,Number,0,1,1,2,3,4,6,7,8,10,11,12,14,15,16,17,17,18,18,19,19,19,20,20,20,20,20,20,20,20
E01033739,EV motorcycles,Number,0,0,1,1,2,2,3,4,4,5,6,6,7,7,8,8,9,9,9,9,10,10,10,10,10,10,10,10,10,10
E01033740,EV motorcycles,Number,0,0,1,1,1,2,2,3,3,4,4,5,5,6,6,7,7,7,7,8,8,8,8,8,8,8,8,8,8,8
E01033741,EV motorcycles,Number,0,1,2,3,4,6,7,9,11,12,14,16,17,18,20,21,22,22,23,24,24,24,24,25,25,25,25,25,25,25
E01033742,EV motorcycles,Number,0,1,1,2,4,5,6,7,9,10,12,13,14,16,17,17,18,19,19,20,20,20,21,21,21,21,21,21,21,21
E01033743,EV motorcycles,Number,0,0,1,1,1,2,2,3,3,4,4,5,5,6,6,7,7,7,7,8,8,8,8,8,8,8,8,8,8,8
E01033744,EV motorcycles,Number,0,1,1,2,3,4,5,6,7,8,10,11,12,13,13,14,15,15,16,16,16,16,17,17,17,17,17,17,17,17
E01033745,EV motorcycles,Number,0,1,2,3,4,6,8,9,11,13,15,16,18,19,20,22,23,23,24,25,25,25,25,26,26,26,26,26,26,26
E01033746,EV motorcycles,Number,0,0,1,1,2,2,3,4,4,5,6,6,7,7,8,8,9,9,9,9,10,10,10,10,10,10,10,10,10,10
